"","Account","Type","Date","Num","Name","Memo","Split","Debit","Credit","Balance"
"2","Company Checking Account","Check","2018-01-01","5001","Kuver Property","Janaury Rent","Rent",NA,583.75,11765.25
"3","Company Checking Account","Check","2018-01-01","5000","Online Accounting","Set up QuickBooks file","Accounting Fees",NA,225,11540.25
"4","Company Checking Account","Deposit","2018-01-01",NA,NA,"Deposit","-SPLIT-",31349,NA,42889.25
"5","Company Checking Account","Check","2018-01-05","5002","Deborah Wood (Owner)","Petty Cash","Petty Cash Account",NA,500,42389.25
"6","Company Checking Account","Check","2018-01-08","5003","Gas & Electic Company","ACCT# 098703","Utilities",NA,65.08,42324.17
"7","Company Checking Account","Paycheck","2018-01-15","3001","King, Vicki",NA,"-SPLIT-",NA,167.72,42156.45
"8","Company Checking Account","Check","2018-01-15","5007","Automobile Loan Company","Car lease","Car Lease",NA,563,41593.45
"9","Company Checking Account","Paycheck","2018-01-15","3003","Bolinski, Rafal",NA,"-SPLIT-",NA,310.78,41282.67
"10","Company Checking Account","Paycheck","2018-01-15","3004","Deen, Jeannette",NA,"-SPLIT-",NA,218.96,41063.71
"11","Company Checking Account","Check","2018-01-22","5011","Office Supply Store","Acct# 27804","Supplies",NA,634.21,40429.5
"12","Company Checking Account","Check","2018-01-22","5010","Local Phone Company","6503221414","Telephone",NA,253,40176.5
"13","Company Checking Account","Check","2018-01-22","5008","Cell Phone Company","Cell","Telephone",NA,101.18,40075.32
"14","Company Checking Account","Check","2018-01-22","5009","Fisse Fast Package Delivery","ACCT# 256044025","Postage and Delivery",NA,78,39997.32
"15","Company Checking Account","Check","2018-01-25","5013","Gretton Insurance Co.","WC Policy # 87023 Jan07","-SPLIT-",NA,231.84,39765.48
"16","Company Checking Account","Check","2018-01-25","5014","Payroll Service Co."," Payroll","Payroll Service Fees",NA,127.08,39638.4
"17","Company Checking Account","Check","2018-01-25","5015","Pace Shipping Supplies","Acct# 45980","Office Equipment",NA,25,39613.4
"18","Company Checking Account","Check","2018-01-25","5017","Health Insurance Co.","Employee Health Insurance Policy#258BVF4","-SPLIT-",NA,543.83,39069.57
"19","Company Checking Account","Check","2018-01-25","5016","Deborah Wood (Owner)","13103 Exp Report","Travel",NA,55.23,39014.34
"20","Company Checking Account","Check","2018-01-25","5012","King, Vicki",NA,"Meals and Entertainment",NA,55,38959.34
"21","Company Checking Account","Check","2018-01-25","5018","Novello Lights Magazine","Q1 07 Ad","Advertising Expense",NA,500,38459.34
"22","Company Checking Account","Check","2018-01-26","5019","Deborah Wood (Owner)","Owners Draw","Deborah Wood Draws",NA,10500,27959.34
"23","Company Checking Account","Check","2018-01-29","5020","Credit Card","ACCT# 3786401297855001","QuickBooks Credit Card",NA,95.71,27863.63
"24","Company Checking Account","Check","2018-01-29","5021","Gretton Insurance Co.","Liability Ins. Policy#203654","Prepaid Insurance",NA,6875,20988.63
"25","Company Checking Account","Deposit","2018-01-30",NA,NA,"Deposit","-SPLIT-",3064,NA,24052.63
"26","Company Checking Account","Check","2018-01-31","5024","Jeff's Janitorial","Jan07","Maintenance/Janitorial",NA,200,23852.63
"27","Company Checking Account","Check","2018-01-31","5025","Lawson Professional Seminars, Inc.","Spring Seminar #407","Conferences and Seminars",NA,1000,22852.63
"28","Company Checking Account","Check","2018-01-31","5026","Gretton Insurance Co.","Policy # 14B09 Jan07","General Liability Insurance",NA,230,22622.63
"29","Company Checking Account","Check","2018-01-31","5027","Professional Association","07 Annual dues","Dues and Subscriptions",NA,500,22122.63
"30","Company Checking Account","Check","2018-01-31","5028","Professional Association","07 Annual dues","Dues and Subscriptions",NA,350,21772.63
"31","Company Checking Account","Check","2018-01-31","5022","Automobile Insurance Company","Auto Insurance Policy # 14906","Insurance-Auto",NA,120,21652.63
"32","Company Checking Account","Check","2018-01-31","5023","Jonathan Graham (reimbursments)","13103 Expense Report","-SPLIT-",NA,223.15,21429.48
"33","Company Checking Account","Check","2018-02-01","5029","Kuver Property","February Rent","Rent",NA,583.75,20845.73
"34","Company Checking Account","Paycheck","2018-02-01","3004","King, Vicki",NA,"-SPLIT-",NA,117.72,20728.01
"35","Company Checking Account","Paycheck","2018-02-01","3005","Bolinski, Rafal",NA,"-SPLIT-",NA,310.78,20417.23
"36","Company Checking Account","Paycheck","2018-02-01","3006","Deen, Jeannette",NA,"-SPLIT-",NA,218.96,20198.27
"37","Company Checking Account","Check","2018-02-05","5031","Local Bank","Interest on Line of Credit Jan 07","Interest Expense",NA,100.13,20098.14
"38","Company Checking Account","Check","2018-02-05","5030","Gretton Insurance Co.","Feb 07 WC Policy # 87023, Gen Liab. #14B09","-SPLIT-",NA,461.84,19636.3
"39","Company Checking Account","Check","2018-02-07","5032","Gas & Electic Company","ACCT# 098703","Utilities",NA,55.08,19581.22
"40","Company Checking Account","Transfer","2018-02-09",NA,NA,"Funds Transfer","Line of Credit",NA,10000,9581.22
"41","Company Checking Account","Paycheck","2018-02-15","3006","King, Vicki",NA,"-SPLIT-",NA,217.72,9363.5
"42","Company Checking Account","Check","2018-02-15","5037","Automobile Loan Company","Car lease","Car Lease",NA,563,8800.5
"43","Company Checking Account","Liability Check","2018-02-15","5036","Sec125 Administrator","Acct#  870547","SEC125 Payable",NA,50,8750.5
"44","Company Checking Account","Paycheck","2018-02-15","3007","Bolinski, Rafal",NA,"-SPLIT-",NA,310.78,8439.72
"45","Company Checking Account","Paycheck","2018-02-15","3008","Deen, Jeannette",NA,"-SPLIT-",NA,218.96,8220.76
"46","Company Checking Account","Deposit","2018-02-15",NA,NA,"Deposit","Undeposited Funds",2381,NA,10601.76
"47","Company Checking Account","Liability Check","2018-02-15","5347","Local Bank","55-5555555","-SPLIT-",NA,600.59,10001.17
"48","Company Checking Account","Deposit","2018-02-17",NA,NA,"Deposit","Undeposited Funds",21330,NA,31331.17
"49","Company Checking Account","Bill Pmt -Check","2018-02-20","3063","Paulsen's Lighting",NA,"Accounts Payable",NA,2520,28811.17
"50","Company Checking Account","Check","2018-02-22","5044","Office Supply Store","Acct# 27804","Supplies",NA,223.56,28587.61
"51","Company Checking Account","Check","2018-02-22","5041","Local Phone Company","6503221414","Telephone",NA,221.47,28366.14
"52","Company Checking Account","Check","2018-02-22","5038","Deborah Wood (Owner)","Petty Cash","-SPLIT-",NA,457.98,27908.16
"53","Company Checking Account","Check","2018-02-22","5040","Legal Firm","ACCT#400259","Legal Fees",NA,400,27508.16
"54","Company Checking Account","Check","2018-02-22","5042","Lincoln Office Equip.",NA,"Office Equipment",NA,450,27058.16
"55","Company Checking Account","Check","2018-02-22","5043","City of Bayshore","business license","Business License & Fees",NA,354,26704.16
"56","Company Checking Account","Check","2018-02-22","5039","County of Middlefield","Personal Property Tax","Business License & Fees",NA,356.23,26347.93
"57","Company Checking Account","Check","2018-02-22","5045","Postmaster","postage","Postage and Delivery",NA,54,26293.93
"58","Company Checking Account","Check","2018-02-22","5046","Fisse Fast Package Delivery","ACCT# 256044025","Postage and Delivery",NA,78,26215.93
"59","Company Checking Account","Check","2018-02-23","5047","Cell Phone Company","Cell","Telephone",NA,98.67,26117.26
"60","Company Checking Account","Check","2018-02-26","5048","Health Insurance Co.","Employee Health Insurance Policy#258BVF4","-SPLIT-",NA,543.83,25573.43
"61","Company Checking Account","Check","2018-02-26","5049","Pace Shipping Supplies","Acct# 45980","Office Equipment",NA,25,25548.43
"62","Company Checking Account","Check","2018-02-26","5050","Payroll Service Co.","Feb Payroll","Payroll Service Fees",NA,132,25416.43
"63","Company Checking Account","Check","2018-02-26","5051","Deborah Wood (Owner)","Owner's Draw","Deborah Wood Draws",NA,12250,13166.43
"64","Company Checking Account","Check","2018-02-28","5053","Jeff's Janitorial","Monthly Fees","Maintenance/Janitorial",NA,200,12966.43
"65","Company Checking Account","Check","2018-02-28","5056","Automobile Insurance Company","Auto Insurance Policy # 14906","Insurance-Auto",NA,120,12846.43
"66","Company Checking Account","Check","2018-02-28","5054","Credit Card","ACCT# 3786401297855001","QuickBooks Credit Card",NA,56,12790.43
"67","Company Checking Account","Bill Pmt -Check","2018-02-28","5052","Fisse Fast Package Delivery","ACCT# 256044025","Accounts Payable",NA,134,12656.43
"68","Company Checking Account","Bill Pmt -Check","2018-02-28","5057","Printing Shop","Inv#","Accounts Payable",NA,255,12401.43
"69","Company Checking Account","Bill Pmt -Check","2018-02-28","5058","Fisse Fast Package Delivery","ACCT# 256044025","Accounts Payable",NA,197,12204.43
"70","Company Checking Account","Bill Pmt -Check","2018-02-28","5055","Printing Shop","Inv#","Accounts Payable",NA,156,12048.43
"71","Company Checking Account","Bill Pmt -Check","2018-02-28","5238","Fisse Fast Package Delivery","ACCT# 256044025","Accounts Payable",NA,164,11884.43
"72","Company Checking Account","Deposit","2018-02-28",NA,NA,"Deposit","-SPLIT-",14072.35,NA,25956.78
"73","Company Checking Account","Check","2018-03-01","5059","Kuver Property","March  Rent","Rent",NA,583.75,25373.03
"74","Company Checking Account","Paycheck","2018-03-01","3008","King, Vicki",NA,"-SPLIT-",NA,117.72,25255.31
"75","Company Checking Account","Paycheck","2018-03-01","3009","Bolinski, Rafal",NA,"-SPLIT-",NA,310.78,24944.53
"76","Company Checking Account","Paycheck","2018-03-01","3010","Deen, Jeannette",NA,"-SPLIT-",NA,218.96,24725.57
"77","Company Checking Account","Check","2018-03-05","5060","Local Bank","Interest on Line of Credit Feb 07","Interest Expense",NA,80.47,24645.1
"78","Company Checking Account","Check","2018-03-05","5061","Gretton Insurance Co.","Mar 07 WC Policy # 87023, Gen Liab. #14B09","-SPLIT-",NA,461.84,24183.26
"79","Company Checking Account","Transfer","2018-03-05",NA,NA,"Funds Transfer","Line of Credit",50000,NA,74183.26
"80","Company Checking Account","Bill Pmt -Check","2018-03-05","3064","Foster Lighting",NA,"Accounts Payable",NA,4470,69713.26
"81","Company Checking Account","Bill Pmt -Check","2018-03-05","3065","Hall Lighting & Accessories",NA,"Accounts Payable",NA,6747.5,62965.76
"82","Company Checking Account","Bill Pmt -Check","2018-03-05","3066","Paulsen's Lighting",NA,"Accounts Payable",NA,12812.5,50153.26
"83","Company Checking Account","Bill Pmt -Check","2018-03-05","3067","Peacock Bulb Manufacturing Company",NA,"Accounts Payable",NA,9142.5,41010.76
"84","Company Checking Account","Check","2018-03-08","5062","Gas & Electic Company","ACCT# 098703","Utilities",NA,48.08,40962.68
"85","Company Checking Account","Paycheck","2018-03-15","3010","King, Vicki",NA,"-SPLIT-",NA,217.72,40744.96
"86","Company Checking Account","Check","2018-03-15","5066","Automobile Loan Company","Car lease","Car Lease",NA,563,40181.96
"87","Company Checking Account","Liability Check","2018-03-15","5065","Sec125 Administrator","Acct#  870547","SEC125 Payable",NA,100,40081.96
"88","Company Checking Account","Paycheck","2018-03-15","3011","Bolinski, Rafal",NA,"-SPLIT-",NA,310.78,39771.18
"89","Company Checking Account","Paycheck","2018-03-15","3012","Deen, Jeannette",NA,"-SPLIT-",NA,218.96,39552.22
"90","Company Checking Account","Liability Check","2018-03-15","5348","Local Bank","55-5555555","-SPLIT-",NA,1231.22,38321
"91","Company Checking Account","Deposit","2018-03-17",NA,NA,"Deposit","-SPLIT-",10731,NA,49052
"92","Company Checking Account","Bill Pmt -Check","2018-03-20","3068","Foster Lighting",NA,"Accounts Payable",NA,8450,40602
"93","Company Checking Account","Bill Pmt -Check","2018-03-20","3069","Paulsen's Lighting",NA,"Accounts Payable",NA,3886,36716
"94","Company Checking Account","Check","2018-03-22","5069","Office Supply Store","Acct# 27804","Supplies",NA,452.13,36263.87
"95","Company Checking Account","Check","2018-03-22","5068","Cell Phone Company","Cell","Telephone",NA,101.57,36162.3
"96","Company Checking Account","Check","2018-03-22","5070","Local Phone Company","6503221414","Telephone",NA,211.56,35950.74
"97","Company Checking Account","Check","2018-03-22","5071","Fisse Fast Package Delivery","ACCT# 256044025","Postage and Delivery",NA,78,35872.74
"98","Company Checking Account","Check","2018-03-26","5073","Health Insurance Co.","Employee Health Insurance Policy#258BVF4","-SPLIT-",NA,543.83,35328.91
"99","Company Checking Account","Check","2018-03-26","5072","Pace Shipping Supplies","Acct# 45980","Office Equipment",NA,25,35303.91
"100","Company Checking Account","Check","2018-03-26","5074","Payroll Service Co.","March Payroll","Payroll Service Fees",NA,135.6,35168.31
"101","Company Checking Account","Check","2018-03-26","5075","Deborah Wood (Owner)","Owner's Draw","Deborah Wood Draws",NA,10000,25168.31
"102","Company Checking Account","Check","2018-03-30","5077","Jeff's Janitorial","Monthly Fees","Maintenance/Janitorial",NA,200,24968.31
"103","Company Checking Account","Check","2018-03-30","5076","Automobile Insurance Company","Auto Insurance Policy # 14906","Insurance-Auto",NA,120,24848.31
"104","Company Checking Account","Check","2018-03-30","5078","Credit Card","ACCT# 3786401297855001","QuickBooks Credit Card",NA,682.23,24166.08
"105","Company Checking Account","Deposit","2018-03-31",NA,NA,"Deposit","-SPLIT-",19958.45,NA,44124.53
"106","Company Checking Account","Check","2018-04-02","5079","Kuver Property","April Rent","Rent",NA,583.75,43540.78
"107","Company Checking Account","Paycheck","2018-04-02","3012","King, Vicki",NA,"-SPLIT-",NA,117.72,43423.06
"108","Company Checking Account","Paycheck","2018-04-02","3013","Bolinski, Rafal",NA,"-SPLIT-",NA,310.78,43112.28
"109","Company Checking Account","Paycheck","2018-04-02","3014","Deen, Jeannette",NA,"-SPLIT-",NA,218.96,42893.32
"110","Company Checking Account","Check","2018-04-04","5081","Local Bank","Interest on Line of Credit Mar 07","Interest Expense",NA,81.56,42811.76
"111","Company Checking Account","Check","2018-04-04","5080","Gretton Insurance Co.","Apr 07 WC Policy # 87023, Gen Liab. #14B09","-SPLIT-",NA,461.84,42349.92
"112","Company Checking Account","Bill Pmt -Check","2018-04-05","3070","Foster Lighting","Cust ID#0987-01A","Accounts Payable",NA,705,41644.92
"113","Company Checking Account","Bill Pmt -Check","2018-04-05","3071","Paulsen's Lighting",NA,"Accounts Payable",NA,20950,20694.92
"114","Company Checking Account","Check","2018-04-09","5082","Gas & Electic Company","ACCT# 098703","Utilities",NA,25.12,20669.8
"115","Company Checking Account","Paycheck","2018-04-15","3015","Bolinski, Rafal",NA,"-SPLIT-",NA,310.78,20359.02
"116","Company Checking Account","Paycheck","2018-04-15","3016","Deen, Jeannette",NA,"-SPLIT-",NA,218.96,20140.06
"117","Company Checking Account","Deposit","2018-04-15",NA,NA,"Deposit","-SPLIT-",3111,NA,23251.06
"118","Company Checking Account","Liability Check","2018-04-15","5349","Local Bank","55-5555555","-SPLIT-",NA,1201.2,22049.86
"119","Company Checking Account","Paycheck","2018-04-16","3014","King, Vicki",NA,"-SPLIT-",NA,130.64,21919.22
"120","Company Checking Account","Check","2018-04-16","5087","Automobile Loan Company","Car lease","Car Lease",NA,563,21356.22
"121","Company Checking Account","Liability Check","2018-04-16","5086","Sec125 Administrator","Acct#  870547","SEC125 Payable",NA,100,21256.22
"122","Company Checking Account","Check","2018-04-20","5088","Novello Lights Magazine","Q2 07 Ad","Advertising Expense",NA,500,20756.22
"123","Company Checking Account","Check","2018-04-23","5090","Office Supply Store","Acct# 27804","Supplies",NA,120,20636.22
"124","Company Checking Account","Check","2018-04-23","5091","Cell Phone Company","Cell","Telephone",NA,100.23,20535.99
"125","Company Checking Account","Check","2018-04-23","5094","Local Phone Company","6503221414","Telephone",NA,203.56,20332.43
"126","Company Checking Account","Check","2018-04-23","5093","Jonathan Graham (reimbursments)","3103 Expense Report","-SPLIT-",NA,115.63,20216.8
"127","Company Checking Account","Check","2018-04-23","5089","King, Vicki",NA,"-SPLIT-",NA,54.12,20162.68
"128","Company Checking Account","Check","2018-04-23","5095","Deborah Wood (Owner)","33103 Exp Report","-SPLIT-",NA,1249.54,18913.14
"129","Company Checking Account","Check","2018-04-23","5096","Jeff's Janitorial","supplies","Maintenance/Janitorial",NA,157,18756.14
"130","Company Checking Account","Check","2018-04-23","5097","Fisse Fast Package Delivery","ACCT# 256044025","Postage and Delivery",NA,78,18678.14
"131","Company Checking Account","Check","2018-04-23","5092","Department of Automobiles","Auto Registration","Registration & License",NA,546,18132.14
"132","Company Checking Account","Check","2018-04-25","5099","Health Insurance Co.","Employee Health Insurance Policy#258BVF4","-SPLIT-",NA,543.83,17588.31
"133","Company Checking Account","Check","2018-04-25","5098","Pace Shipping Supplies","Acct# 45980","Office Equipment",NA,25,17563.31
"134","Company Checking Account","Check","2018-04-25","5100","Deborah Wood (Owner)","Owner's Draw","Deborah Wood Draws",NA,11750,5813.31
"135","Company Checking Account","Check","2018-04-26","5101","Payroll Service Co.","April Payroll","Payroll Service Fees",NA,142,5671.31
"136","Company Checking Account","Check","2018-04-30","5106","Jeff's Janitorial","Monthly Fees","Maintenance/Janitorial",NA,200,5471.31
"137","Company Checking Account","Check","2018-04-30","5104","Automobile Insurance Company","Auto Insurance Policy # 14906","Insurance-Auto",NA,120,5351.31
"138","Company Checking Account","Check","2018-04-30","5105","Credit Card","ACCT# 3786401297855001","QuickBooks Credit Card",NA,143.75,5207.56
"139","Company Checking Account","Bill Pmt -Check","2018-04-30","5102","Fisse Fast Package Delivery","ACCT# 256044025","Accounts Payable",NA,164,5043.56
"140","Company Checking Account","Bill Pmt -Check","2018-04-30","5103","Printing Shop","Inv#","Accounts Payable",NA,285,4758.56
"141","Company Checking Account","Deposit","2018-04-30",NA,NA,"Deposit","Undeposited Funds",3025,NA,7783.56
"142","Company Checking Account","Check","2018-05-01","5107","Kuver Property","May Rent","Rent",NA,583.75,7199.81
"143","Company Checking Account","Paycheck","2018-05-01","3016","King, Vicki",NA,"-SPLIT-",NA,30.64,7169.17
"144","Company Checking Account","Paycheck","2018-05-01","3017","Bolinski, Rafal",NA,"-SPLIT-",NA,310.78,6858.39
"145","Company Checking Account","Paycheck","2018-05-01","3018","Deen, Jeannette",NA,"-SPLIT-",NA,218.96,6639.43
"146","Company Checking Account","Deposit","2018-05-01",NA,NA,"Deposit","-SPLIT-",34194.85,NA,40834.28
"147","Company Checking Account","Check","2018-05-04","5109","Local Bank","Interest on Line of Credit Apr 07","Interest Expense",NA,82.98,40751.3
"148","Company Checking Account","Check","2018-05-04","5108","Gretton Insurance Co.","May 07 WC Policy # 87023, Gen Liab. #14B09","-SPLIT-",NA,461.84,40289.46
"149","Company Checking Account","Check","2018-05-08","5110","Gas & Electic Company","ACCT# 098703","Utilities",NA,22.1,40267.36
"150","Company Checking Account","Liability Check","2018-05-13","5350","Local Bank","55-5555555","-SPLIT-",NA,1122.37,39144.99
"151","Company Checking Account","Liability Check","2018-05-13","5351","Local Bank","55-5555555","-SPLIT-",NA,1015.63,38129.36
"152","Company Checking Account","Check","2018-05-15","5115","Lawson Professional Seminars, Inc.","Summer Seminar #707","Conferences and Seminars",NA,350,37779.36
"153","Company Checking Account","Paycheck","2018-05-15","3018","King, Vicki",NA,"-SPLIT-",NA,30.64,37748.72
"154","Company Checking Account","Check","2018-05-15","5116","Automobile Loan Company","Car lease","Car Lease",NA,563,37185.72
"155","Company Checking Account","Liability Check","2018-05-15","5114","Sec125 Administrator","Acct#  870547","SEC125 Payable",NA,100,37085.72
"156","Company Checking Account","Transfer","2018-05-15",NA,NA,"Funds Transfer","Line of Credit",25000,NA,62085.72
"157","Company Checking Account","Paycheck","2018-05-15","3019","Bolinski, Rafal",NA,"-SPLIT-",NA,310.78,61774.94
"158","Company Checking Account","Paycheck","2018-05-15","3020","Deen, Jeannette",NA,"-SPLIT-",NA,218.96,61555.98
"159","Company Checking Account","Deposit","2018-05-16",NA,NA,"Deposit","-SPLIT-",10525,NA,72080.98
"160","Company Checking Account","Bill Pmt -Check","2018-05-20","3072","Foster Lighting",NA,"Accounts Payable",NA,5550,66530.98
"161","Company Checking Account","Bill Pmt -Check","2018-05-20","3073","Hall Lighting & Accessories",NA,"Accounts Payable",NA,6747.5,59783.48
"162","Company Checking Account","Bill Pmt -Check","2018-05-20","3074","Paulsen's Lighting",NA,"Accounts Payable",NA,7925,51858.48
"163","Company Checking Account","Check","2018-05-22","5120","Cell Phone Company","Cell","Telephone",NA,107.45,51751.03
"164","Company Checking Account","Check","2018-05-22","5117","Local Phone Company","6503221414","Telephone",NA,197.25,51553.78
"165","Company Checking Account","Check","2018-05-22","5118","Deborah Wood (Owner)","Petty Cash","-SPLIT-",NA,482.57,51071.21
"166","Company Checking Account","Check","2018-05-22","5119","Accounting Firm","2006 Tax Returns","Accounting Fees",NA,1554,49517.21
"167","Company Checking Account","Check","2018-05-22","5121","Fisse Fast Package Delivery","ACCT# 256044025","Postage and Delivery",NA,78,49439.21
"168","Company Checking Account","Check","2018-05-23","5122","Office Supply Store","Acct# 27804","Supplies",NA,327.16,49112.05
"169","Company Checking Account","Check","2018-05-25","5125","Health Insurance Co.","Employee Health Insurance Policy#258BVF4","-SPLIT-",NA,543.83,48568.22
"170","Company Checking Account","Check","2018-05-25","5126","Pace Shipping Supplies","Acct# 45980","Office Equipment",NA,25,48543.22
"171","Company Checking Account","Check","2018-05-25","5127","Payroll Service Co.","Payroll  Fee","Payroll Service Fees",NA,129,48414.22
"172","Company Checking Account","Check","2018-05-25","5124","Deborah Wood (Owner)","Owner's Draw","Deborah Wood Draws",NA,12000,36414.22
"173","Company Checking Account","Check","2018-05-31","5131","Jeff's Janitorial","Monthly Fees","Maintenance/Janitorial",NA,200,36214.22
"174","Company Checking Account","Check","2018-05-31","5133","Automobile Insurance Company","Auto Insurance Policy # 14906","Insurance-Auto",NA,120,36094.22
"175","Company Checking Account","Check","2018-05-31","5132","Credit Card","ACCT# 3786401297855001","QuickBooks Credit Card",NA,65,36029.22
"176","Company Checking Account","Check","2018-05-31","5134","Jonathan Graham (reimbursments)","Seminar Travel","Travel",NA,191,35838.22
"177","Company Checking Account","Bill Pmt -Check","2018-05-31","5129","Fisse Fast Package Delivery","ACCT# 256044025","Accounts Payable",NA,164,35674.22
"178","Company Checking Account","Bill Pmt -Check","2018-05-31","5130","Printing Shop","Inv#","Accounts Payable",NA,160,35514.22
"179","Company Checking Account","Check","2018-06-01","5135","Kuver Property","June Rent","Rent",NA,583.75,34930.47
"180","Company Checking Account","Paycheck","2018-06-01","3020","King, Vicki",NA,"-SPLIT-",NA,130.64,34799.83
"181","Company Checking Account","Paycheck","2018-06-01","3021","Bolinski, Rafal",NA,"-SPLIT-",NA,310.78,34489.05
"182","Company Checking Account","Paycheck","2018-06-01","3022","Deen, Jeannette",NA,"-SPLIT-",NA,218.96,34270.09
"183","Company Checking Account","Deposit","2018-06-02",NA,NA,"Deposit","-SPLIT-",14735.85,NA,49005.94
"184","Company Checking Account","Check","2018-06-04","5136","Local Bank","Interest on Line of Credit May 07","Interest Expense",NA,125.89,48880.05
"185","Company Checking Account","Check","2018-06-04","5137","Gretton Insurance Co.","June 07 WC Policy # 87023, Gen Liab. #14B09","-SPLIT-",NA,461.84,48418.21
"186","Company Checking Account","Bill Pmt -Check","2018-06-05","3075","Foster Lighting",NA,"Accounts Payable",NA,2840,45578.21
"187","Company Checking Account","Check","2018-06-12","5139","Gas & Electic Company","ACCT# 098703","Utilities",NA,22.07,45556.14
"188","Company Checking Account","Paycheck","2018-06-15","3022","King, Vicki",NA,"-SPLIT-",NA,30.64,45525.5
"189","Company Checking Account","Check","2018-06-15","5142","Automobile Loan Company","Car lease","Car Lease",NA,563,44962.5
"190","Company Checking Account","Liability Check","2018-06-15","5143","Sec125 Administrator","Acct#  870547","SEC125 Payable",NA,100,44862.5
"191","Company Checking Account","Paycheck","2018-06-15","3023","Bolinski, Rafal",NA,"-SPLIT-",NA,310.78,44551.72
"192","Company Checking Account","Paycheck","2018-06-15","3024","Deen, Jeannette",NA,"-SPLIT-",NA,218.96,44332.76
"193","Company Checking Account","Deposit","2018-06-16",NA,NA,"Deposit","-SPLIT-",18433.45,NA,62766.21
"194","Company Checking Account","Check","2018-06-22","5148","Local Phone Company","6503221414","Telephone",NA,221.32,62544.89
"195","Company Checking Account","Check","2018-06-22","5144","Electronics Manufacturer","New laptop computer","Computer & Office Equipment",NA,2500,60044.89
"196","Company Checking Account","Check","2018-06-22","5145","Lincoln Office Equip.",NA,"Office Equipment",NA,350,59694.89
"197","Company Checking Account","Check","2018-06-22","5146","Fisse Fast Package Delivery","ACCT# 256044025","Postage and Delivery",NA,78,59616.89
"198","Company Checking Account","Check","2018-06-22","5147","Mullen Travel","Air Fare for Convention","-SPLIT-",NA,2500,57116.89
"199","Company Checking Account","Check","2018-06-25","5151","Health Insurance Co.","Employee Health Insurance Policy#258BVF4","-SPLIT-",NA,543.83,56573.06
"200","Company Checking Account","Check","2018-06-25","5153","Pace Shipping Supplies","Acct# 45980","Office Equipment",NA,25,56548.06
"201","Company Checking Account","Check","2018-06-25","5149","Office Supply Store","Acct# 27804","Supplies",NA,123.54,56424.52
"202","Company Checking Account","Check","2018-06-25","5150","Cell Phone Company","Cell","Telephone",NA,101.78,56322.74
"203","Company Checking Account","Check","2018-06-25","5152","Payroll Service Co.","Payroll  Fee","Payroll Service Fees",NA,123.08,56199.66
"204","Company Checking Account","Check","2018-06-25","5154","Deborah Wood (Owner)","Owner's Draw","Deborah Wood Draws",NA,11250,44949.66
"205","Company Checking Account","Transfer","2018-06-25",NA,NA,"Funds Transfer","Line of Credit",25000,NA,69949.66
"206","Company Checking Account","Check","2018-06-29","5157","Jeff's Janitorial","Monthly Fees","Maintenance/Janitorial",NA,200,69749.66
"207","Company Checking Account","Check","2018-06-29","5158","Automobile Insurance Company","Auto Insurance Policy # 14906","Insurance-Auto",NA,120,69629.66
"208","Company Checking Account","Check","2018-06-29","5159","Credit Card","ACCT# 3786401297855001","QuickBooks Credit Card",NA,23.6,69606.06
"209","Company Checking Account","Bill Pmt -Check","2018-06-29","5155","Fisse Fast Package Delivery","ACCT# 256044025","Accounts Payable",NA,148,69458.06
"210","Company Checking Account","Bill Pmt -Check","2018-06-29","5156","Printing Shop","Inv#","Accounts Payable",NA,1000,68458.06
"211","Company Checking Account","Deposit","2018-06-30",NA,NA,"Deposit","-SPLIT-",8533.8,NA,76991.86
"212","Company Checking Account","Paycheck","2018-07-01","3025","Bolinski, Rafal",NA,"-SPLIT-",NA,310.78,76681.08
"213","Company Checking Account","Paycheck","2018-07-01","3026","Deen, Jeannette",NA,"-SPLIT-",NA,218.96,76462.12
"214","Company Checking Account","Check","2018-07-02","5160","Kuver Property","July Rent","Rent",NA,583.75,75878.37
"215","Company Checking Account","Paycheck","2018-07-02","3024","King, Vicki",NA,"-SPLIT-",NA,30.64,75847.73
"216","Company Checking Account","Check","2018-07-03","5161","Local Bank","Interest on Line of Credit Jun 07","Interest Expense",NA,156.65,75691.08
"217","Company Checking Account","Check","2018-07-03","5162","Gretton Insurance Co.","July 07 WC Policy # 87023, Gen Liab. #14B09","-SPLIT-",NA,461.84,75229.24
"218","Company Checking Account","Bill Pmt -Check","2018-07-05","3076","Foster Lighting",NA,"Accounts Payable",NA,3150,72079.24
"219","Company Checking Account","Bill Pmt -Check","2018-07-05","3077","Paulsen's Lighting",NA,"Accounts Payable",NA,3625,68454.24
"220","Company Checking Account","Check","2018-07-12","5164","Gas & Electic Company","ACCT# 098703","Utilities",NA,28.47,68425.77
"221","Company Checking Account","Paycheck","2018-07-15","3027","Bolinski, Rafal",NA,"-SPLIT-",NA,310.78,68114.99
"222","Company Checking Account","Paycheck","2018-07-15","3028","Deen, Jeannette",NA,"-SPLIT-",NA,218.96,67896.03
"223","Company Checking Account","Liability Check","2018-07-15","5352","Local Bank","55-5555555","-SPLIT-",NA,1043.54,66852.49
"224","Company Checking Account","Liability Check","2018-07-16","5167","Sec125 Administrator","Acct#  870547","SEC125 Payable",NA,100,66752.49
"225","Company Checking Account","Paycheck","2018-07-17","3026","King, Vicki",NA,"-SPLIT-",NA,30.64,66721.85
"226","Company Checking Account","Transfer","2018-07-20",NA,NA,"Funds Transfer","Line of Credit",NA,10000,56721.85
"227","Company Checking Account","Check","2018-07-23","5176","Novello Lights Magazine","Q3 07 Ad","Advertising Expense",NA,500,56221.85
"228","Company Checking Account","Check","2018-07-23","5175","Office Supply Store","Acct# 27804","Supplies",NA,78.65,56143.2
"229","Company Checking Account","Check","2018-07-23","5168","Cell Phone Company","Cell","Telephone",NA,105.45,56037.75
"230","Company Checking Account","Check","2018-07-23","5169","Local Phone Company","6503221414","Telephone",NA,219.45,55818.3
"231","Company Checking Account","Check","2018-07-23","5170","Jonathan Graham (reimbursments)","63003 Expense Report","-SPLIT-",NA,239.21,55579.09
"232","Company Checking Account","Check","2018-07-23","5171","King, Vicki",NA,"-SPLIT-",NA,63.58,55515.51
"233","Company Checking Account","Check","2018-07-23","5172","Deborah Wood (Owner)","63003 Exp Report","-SPLIT-",NA,208.47,55307.04
"234","Company Checking Account","Check","2018-07-23","5173","Jeff's Janitorial","supplies","Maintenance/Janitorial",NA,127.5,55179.54
"235","Company Checking Account","Check","2018-07-23","5174","Fisse Fast Package Delivery","ACCT# 256044025","Postage and Delivery",NA,78,55101.54
"236","Company Checking Account","Check","2018-07-25","5180","Health Insurance Co.","Employee Health Insurance Policy#258BVF4","-SPLIT-",NA,543.83,54557.71
"237","Company Checking Account","Check","2018-07-25","5181","Pace Shipping Supplies","Acct# 45980","Office Equipment",NA,25,54532.71
"238","Company Checking Account","Check","2018-07-25","5183","Payroll Service Co.","Payroll  Fee","Payroll Service Fees",NA,124.08,54408.63
"239","Company Checking Account","Check","2018-07-25","5178","Electronics & Computer Store","Computer repair","Computer Repairs",NA,390,54018.63
"240","Company Checking Account","Check","2018-07-25","5179","Deborah Wood (Owner)","Owner's Draw","Deborah Wood Draws",NA,10000,44018.63
"241","Company Checking Account","Check","2018-07-26","5184","Automobile Loan Company","Car lease","Car Lease",NA,563,43455.63
"242","Company Checking Account","Check","2018-07-31","5188","Jeff's Janitorial","Monthly Fees","Maintenance/Janitorial",NA,200,43255.63
"243","Company Checking Account","Check","2018-07-31","5187","Automobile Insurance Company","Auto Insurance Policy # 14906","Insurance-Auto",NA,120,43135.63
"244","Company Checking Account","Check","2018-07-31","5186","Credit Card","ACCT# 3786401297855001","QuickBooks Credit Card",NA,122.11,43013.52
"245","Company Checking Account","Bill Pmt -Check","2018-07-31","5185","Fisse Fast Package Delivery","ACCT# 256044025","Accounts Payable",NA,152,42861.52
"246","Company Checking Account","Bill Pmt -Check","2018-07-31","5189","Printing Shop","Inv#","Accounts Payable",NA,675,42186.52
"247","Company Checking Account","Check","2018-08-01","5190","Kuver Property","Aug Rent","Rent",NA,583.75,41602.77
"248","Company Checking Account","Transfer","2018-08-01",NA,NA,"Funds Transfer","Line of Credit",5000,NA,46602.77
"249","Company Checking Account","Paycheck","2018-08-01","3029","Bolinski, Rafal",NA,"-SPLIT-",NA,310.78,46291.99
"250","Company Checking Account","Paycheck","2018-08-01","3030","Deen, Jeannette",NA,"-SPLIT-",NA,218.96,46073.03
"251","Company Checking Account","Deposit","2018-08-01",NA,NA,"Deposit","-SPLIT-",21363.6,NA,67436.63
"252","Company Checking Account","Check","2018-08-03","5191","Local Bank","Interest on Line of Credit July 07","Interest Expense",NA,113.25,67323.38
"253","Company Checking Account","Check","2018-08-03","5192","Gretton Insurance Co.","Aug 07 WC Policy # 87023, Gen Liab. #14B09","-SPLIT-",NA,461.84,66861.54
"254","Company Checking Account","Paycheck","2018-08-03","3028","King, Vicki",NA,"-SPLIT-",NA,30.64,66830.9
"255","Company Checking Account","Check","2018-08-07","5193","Gas & Electic Company","ACCT# 098703","Utilities",NA,29.47,66801.43
"256","Company Checking Account","Check","2018-08-15","5198","Lawson Professional Seminars, Inc.","Fall Seminar #907","Conferences and Seminars",NA,350,66451.43
"257","Company Checking Account","Check","2018-08-15","5197","Automobile Loan Company","Car lease","Car Lease",NA,563,65888.43
"258","Company Checking Account","Liability Check","2018-08-15","5199","Sec125 Administrator","Acct#  870547","SEC125 Payable",NA,100,65788.43
"259","Company Checking Account","Paycheck","2018-08-15","3031","Bolinski, Rafal",NA,"-SPLIT-",NA,310.78,65477.65
"260","Company Checking Account","Paycheck","2018-08-15","3032","Deen, Jeannette",NA,"-SPLIT-",NA,219.93,65257.72
"261","Company Checking Account","Liability Check","2018-08-15","5353","Local Bank","55-5555555","-SPLIT-",NA,1122.75,64134.97
"262","Company Checking Account","Paycheck","2018-08-17","3030","King, Vicki",NA,"-SPLIT-",NA,130.64,64004.33
"263","Company Checking Account","Deposit","2018-08-18",NA,NA,"Deposit","-SPLIT-",26755.9,NA,90760.23
"264","Company Checking Account","Check","2018-08-20","5200","Winkon Public Relations","Annual Campaign","Marketing Expense",NA,4500,86260.23
"265","Company Checking Account","Bill Pmt -Check","2018-08-20","3078","Foster Lighting",NA,"Accounts Payable",NA,845,85415.23
"266","Company Checking Account","Check","2018-08-22","5202","Office Supply Store","Acct# 27804","Supplies",NA,125.47,85289.76
"267","Company Checking Account","Check","2018-08-22","5203","Local Phone Company","6503221414","Telephone",NA,213.56,85076.2
"268","Company Checking Account","Check","2018-08-22","5209","Deborah Wood (Owner)","Petty Cash","-SPLIT-",NA,462.12,84614.08
"269","Company Checking Account","Check","2018-08-22","5201","Professional Subscriptions","Professional Journal","Dues and Subscriptions",NA,350,84264.08
"270","Company Checking Account","Check","2018-08-22","5204","Professional Subscriptions","Professional Journal","Dues and Subscriptions",NA,350,83914.08
"271","Company Checking Account","Check","2018-08-22","5205","Professional Subscriptions","Professional Journal","Dues and Subscriptions",NA,350,83564.08
"272","Company Checking Account","Check","2018-08-22","5206","Professional Association","Registration for Fall Convention","-SPLIT-",NA,3000,80564.08
"273","Company Checking Account","Check","2018-08-22","5207","Postmaster","postage","Postage and Delivery",NA,54,80510.08
"274","Company Checking Account","Check","2018-08-22","5208","Fisse Fast Package Delivery","ACCT# 256044025","Postage and Delivery",NA,78,80432.08
"275","Company Checking Account","Check","2018-08-23","5210","Cell Phone Company","Cell","Telephone",NA,99.63,80332.45
"276","Company Checking Account","Check","2018-08-24","5213","Health Insurance Co.","Employee Health Insurance Policy#258BVF4","-SPLIT-",NA,543.83,79788.62
"277","Company Checking Account","Check","2018-08-24","5211","Pace Shipping Supplies","Acct# 45980","Office Equipment",NA,25,79763.62
"278","Company Checking Account","Check","2018-08-24","5212","Payroll Service Co.","Payroll  Fee","Payroll Service Fees",NA,123.08,79640.54
"279","Company Checking Account","Check","2018-08-27","5214","Deborah Wood (Owner)","Owner's Draw","Deborah Wood Draws",NA,12000,67640.54
"280","Company Checking Account","Check","2018-08-31","5215","Jeff's Janitorial","Monthly Fees","Maintenance/Janitorial",NA,200,67440.54
"281","Company Checking Account","Check","2018-08-31","5219","Automobile Insurance Company","Auto Insurance Policy # 14906","Insurance-Auto",NA,120,67320.54
"282","Company Checking Account","Check","2018-08-31","5216","Credit Card","ACCT# 3786401297855001","QuickBooks Credit Card",NA,66.03,67254.51
"283","Company Checking Account","Bill Pmt -Check","2018-08-31","5217","Fisse Fast Package Delivery","ACCT# 256044025","Accounts Payable",NA,148,67106.51
"284","Company Checking Account","Bill Pmt -Check","2018-08-31","5218","Printing Shop","Inv#","Accounts Payable",NA,835,66271.51
"285","Company Checking Account","Paycheck","2018-09-01","3033","Bolinski, Rafal",NA,"-SPLIT-",NA,310.78,65960.73
"286","Company Checking Account","Paycheck","2018-09-01","3034","Deen, Jeannette",NA,"-SPLIT-",NA,218.96,65741.77
"287","Company Checking Account","Check","2018-09-03","5220","Kuver Property","Sept Rent","Rent",NA,583.75,65158.02
"288","Company Checking Account","Paycheck","2018-09-03","3032","King, Vicki",NA,"-SPLIT-",NA,30.64,65127.38
"289","Company Checking Account","Check","2018-09-04","5221","Local Bank","Interest on Line of Credit Aug 07","Interest Expense",NA,95.65,65031.73
"290","Company Checking Account","Check","2018-09-04","5222","Gretton Insurance Co.","Sept 07 WC Policy # 87023, Gen Liab. #14B09","-SPLIT-",NA,461.84,64569.89
"291","Company Checking Account","Check","2018-09-07","5223","Gas & Electic Company","ACCT# 098703","Utilities",NA,30.54,64539.35
"292","Company Checking Account","Check","2018-09-14","5225","Automobile Loan Company","Car lease","Car Lease",NA,563,63976.35
"293","Company Checking Account","Paycheck","2018-09-15","3035","Bolinski, Rafal",NA,"-SPLIT-",NA,310.78,63665.57
"294","Company Checking Account","Paycheck","2018-09-15","3036","Deen, Jeannette",NA,"-SPLIT-",NA,218.96,63446.61
"295","Company Checking Account","Deposit","2018-09-15",NA,NA,"Deposit","-SPLIT-",22389.1,NA,85835.71
"296","Company Checking Account","Liability Check","2018-09-15","5355","Local Bank","55-5555555","-SPLIT-",NA,989.3,84846.41
"297","Company Checking Account","Paycheck","2018-09-17","3034","King, Vicki",NA,"-SPLIT-",NA,30.64,84815.77
"298","Company Checking Account","Liability Check","2018-09-17","5228","Sec125 Administrator","Acct#  870547","SEC125 Payable",NA,100,84715.77
"299","Company Checking Account","Check","2018-09-21","5231","Cell Phone Company","Cell","Telephone",NA,102.87,84612.9
"300","Company Checking Account","Check","2018-09-21","5229","Local Phone Company","6503221414","Telephone",NA,200.69,84412.21
"301","Company Checking Account","Check","2018-09-21","5230","Legal Firm","ACCT#400259","Legal Fees",NA,200,84212.21
"302","Company Checking Account","Check","2018-09-21","5232","Fisse Fast Package Delivery","ACCT# 256044025","Postage and Delivery",NA,78,84134.21
"303","Company Checking Account","Check","2018-09-24","5233","Office Supply Store","Acct# 27804","Supplies",NA,222.36,83911.85
"304","Company Checking Account","Check","2018-09-24","5234","Payroll Service Co.","Payroll  Fee","Payroll Service Fees",NA,123.08,83788.77
"305","Company Checking Account","Check","2018-09-25","5235","Health Insurance Co.","Employee Health Insurance Policy#258BVF4","-SPLIT-",NA,543.83,83244.94
"306","Company Checking Account","Check","2018-09-25","5237","Pace Shipping Supplies","Acct# 45980","Office Equipment",NA,25,83219.94
"307","Company Checking Account","Check","2018-09-25","5236","Deborah Wood (Owner)","Owner's Draw","Deborah Wood Draws",NA,11500,71719.94
"308","Company Checking Account","Check","2018-09-28","5240","Jeff's Janitorial","Monthly Fees","Maintenance/Janitorial",NA,200,71519.94
"309","Company Checking Account","Check","2018-09-28","5241","Automobile Insurance Company","Auto Insurance Policy # 14906","Insurance-Auto",NA,120,71399.94
"310","Company Checking Account","Check","2018-09-28","5242","Credit Card","ACCT# 3786401297855001","QuickBooks Credit Card",NA,156.6,71243.34
"311","Company Checking Account","Check","2018-09-28","5243","King, Vicki",NA,"Travel",NA,191,71052.34
"312","Company Checking Account","Bill Pmt -Check","2018-09-28","5239","Printing Shop","Inv#","Accounts Payable",NA,325,70727.34
"313","Company Checking Account","Deposit","2018-09-30",NA,NA,"Deposit","-SPLIT-",25607.5,NA,96334.84
"314","Company Checking Account","Check","2018-10-01","5244","Kuver Property","Oct Rent","Rent",NA,583.75,95751.09
"315","Company Checking Account","Paycheck","2018-10-01","3037","Bolinski, Rafal",NA,"-SPLIT-",NA,310.78,95440.31
"316","Company Checking Account","Paycheck","2018-10-01","3038","Deen, Jeannette",NA,"-SPLIT-",NA,218.96,95221.35
"317","Company Checking Account","Paycheck","2018-10-03","3036","King, Vicki",NA,"-SPLIT-",NA,130.64,95090.71
"318","Company Checking Account","Check","2018-10-04","5245","Local Bank","Interest on Line of Credit Sept 07","Interest Expense",NA,97.25,94993.46
"319","Company Checking Account","Check","2018-10-04","5246","Gretton Insurance Co.","Oct 07 WC Policy # 87023, Gen Liab. #14B09","-SPLIT-",NA,461.84,94531.62
"320","Company Checking Account","Bill Pmt -Check","2018-10-05","3079","Foster Lighting",NA,"Accounts Payable",NA,6000,88531.62
"321","Company Checking Account","Bill Pmt -Check","2018-10-05","3080","Hall Lighting & Accessories",NA,"Accounts Payable",NA,8800,79731.62
"322","Company Checking Account","Bill Pmt -Check","2018-10-05","3081","Paulsen's Lighting",NA,"Accounts Payable",NA,9225,70506.62
"323","Company Checking Account","Check","2018-10-08","5247","Gas & Electic Company","ACCT# 098703","Utilities",NA,32.9,70473.72
"324","Company Checking Account","Check","2018-10-15","5252","Automobile Loan Company","Car lease","Car Lease",NA,563,69910.72
"325","Company Checking Account","Liability Check","2018-10-15","5251","Sec125 Administrator","Acct#  870547","SEC125 Payable",NA,100,69810.72
"326","Company Checking Account","Paycheck","2018-10-15","3039","Bolinski, Rafal",NA,"-SPLIT-",NA,310.78,69499.94
"327","Company Checking Account","Paycheck","2018-10-15","3040","Deen, Jeannette",NA,"-SPLIT-",NA,218.96,69280.98
"328","Company Checking Account","Liability Check","2018-10-15","5354","Local Bank","55-5555555","-SPLIT-",NA,1043.64,68237.34
"329","Company Checking Account","Deposit","2018-10-16",NA,NA,"Deposit","-SPLIT-",5866.65,NA,74103.99
"330","Company Checking Account","Paycheck","2018-10-17","3038","King, Vicki",NA,"-SPLIT-",NA,130.64,73973.35
"331","Company Checking Account","Check","2018-10-19","5253","Novello Lights Magazine","Q4 07 Ad","Advertising Expense",NA,500,73473.35
"332","Company Checking Account","Check","2018-10-22","5254","Cell Phone Company","Cell","Telephone",NA,101.32,73372.03
"333","Company Checking Account","Check","2018-10-22","5256","Local Phone Company","6503221414","Telephone",NA,211.36,73160.67
"334","Company Checking Account","Check","2018-10-22","5255","King, Vicki",NA,"-SPLIT-",NA,42.36,73118.31
"335","Company Checking Account","Check","2018-10-22","5257","Deborah Wood (Owner)","930037 Exp Report","-SPLIT-",NA,1198.63,71919.68
"336","Company Checking Account","Check","2018-10-22","5258","Jeff's Janitorial","supplies","Maintenance/Janitorial",NA,157.45,71762.23
"337","Company Checking Account","Check","2018-10-22","5259","Fisse Fast Package Delivery","ACCT# 256044025","Postage and Delivery",NA,78,71684.23
"338","Company Checking Account","Check","2018-10-24","5260","Office Supply Store","Acct# 27804","Supplies",NA,141.67,71542.56
"339","Company Checking Account","Check","2018-10-25","5262","Health Insurance Co.","Employee Health Insurance Policy#258BVF4","-SPLIT-",NA,543.83,70998.73
"340","Company Checking Account","Check","2018-10-25","5263","Pace Shipping Supplies","Acct# 45980","Office Equipment",NA,25,70973.73
"341","Company Checking Account","Check","2018-10-25","5264","Payroll Service Co.","Payroll  Fee","Payroll Service Fees",NA,124.08,70849.65
"342","Company Checking Account","Check","2018-10-25","5261","Deborah Wood (Owner)","Owner's Draw","Deborah Wood Draws",NA,11000,59849.65
"343","Company Checking Account","Deposit","2018-10-30",NA,NA,"Deposit","-SPLIT-",11723.25,NA,71572.9
"344","Company Checking Account","Check","2018-10-31","5267","Jeff's Janitorial","Monthly Fees","Maintenance/Janitorial",NA,200,71372.9
"345","Company Checking Account","Check","2018-10-31","5269","Automobile Insurance Company","Auto Insurance Policy # 14906","Insurance-Auto",NA,120,71252.9
"346","Company Checking Account","Check","2018-10-31","5268","Credit Card","ACCT# 3786401297855001","QuickBooks Credit Card",NA,172.35,71080.55
"347","Company Checking Account","Bill Pmt -Check","2018-10-31","5265","Fisse Fast Package Delivery","ACCT# 256044025","Accounts Payable",NA,181,70899.55
"348","Company Checking Account","Bill Pmt -Check","2018-10-31","5266","Printing Shop","Inv#","Accounts Payable",NA,427.5,70472.05
"349","Company Checking Account","Check","2018-11-01","5270","Kuver Property","Nov Rent","Rent",NA,583.75,69888.3
"350","Company Checking Account","Paycheck","2018-11-01","3041","Bolinski, Rafal",NA,"-SPLIT-",NA,310.78,69577.52
"351","Company Checking Account","Paycheck","2018-11-01","3042","Deen, Jeannette",NA,"-SPLIT-",NA,218.96,69358.56
"352","Company Checking Account","Paycheck","2018-11-02","3040","King, Vicki",NA,"-SPLIT-",NA,130.64,69227.92
"353","Company Checking Account","Check","2018-11-05","5271","Local Bank","Interest on Line of Credit Oct 07","Interest Expense",NA,99.56,69128.36
"354","Company Checking Account","Check","2018-11-05","5272","Gretton Insurance Co.","Nov 07 WC Policy # 87023, Gen Liab. #14B09","-SPLIT-",NA,461.84,68666.52
"355","Company Checking Account","Bill Pmt -Check","2018-11-05","3082","Peacock Bulb Manufacturing Company","Cust ID#WD98760","Accounts Payable",NA,175,68491.52
"356","Company Checking Account","Check","2018-11-07","5273","Gas & Electic Company","ACCT# 098703","Utilities",NA,67.08,68424.44
"357","Company Checking Account","Check","2018-11-15","5278","Automobile Loan Company","Car lease","Car Lease",NA,563,67861.44
"358","Company Checking Account","Liability Check","2018-11-15","5277","Sec125 Administrator","Acct#  870547","SEC125 Payable",NA,100,67761.44
"359","Company Checking Account","Paycheck","2018-11-15","3043","Bolinski, Rafal",NA,"-SPLIT-",NA,310.78,67450.66
"360","Company Checking Account","Paycheck","2018-11-15","3044","Deen, Jeannette",NA,"-SPLIT-",NA,218.96,67231.7
"361","Company Checking Account","Liability Check","2018-11-15","5356","Local Bank","55-5555555","-SPLIT-",NA,1043.54,66188.16
"362","Company Checking Account","Paycheck","2018-11-16","3042","King, Vicki",NA,"-SPLIT-",NA,130.64,66057.52
"363","Company Checking Account","Transfer","2018-11-16",NA,NA,"Funds Transfer","Line of Credit",NA,5000,61057.52
"364","Company Checking Account","Check","2018-11-22","5280","Cell Phone Company","Cell","Telephone",NA,100.45,60957.07
"365","Company Checking Account","Check","2018-11-22","5281","Local Phone Company","6503221414","Telephone",NA,203.03,60754.04
"366","Company Checking Account","Check","2018-11-22","5279","Jonathan Graham (reimbursments)","93003 Expense Report","-SPLIT-",NA,187.53,60566.51
"367","Company Checking Account","Check","2018-11-22","5283","Deborah Wood (Owner)","Petty Cash","-SPLIT-",NA,435.26,60131.25
"368","Company Checking Account","Check","2018-11-22","5284","Postmaster","postage","Postage and Delivery",NA,54,60077.25
"369","Company Checking Account","Check","2018-11-22","5282","Fisse Fast Package Delivery","ACCT# 256044025","Postage and Delivery",NA,78,59999.25
"370","Company Checking Account","Check","2018-11-23","5285","Office Supply Store","Acct# 27804","Supplies",NA,123.23,59876.02
"371","Company Checking Account","Check","2018-11-26","5288","Health Insurance Co.","Employee Health Insurance Policy#258BVF4","-SPLIT-",NA,543.83,59332.19
"372","Company Checking Account","Check","2018-11-26","5286","Pace Shipping Supplies","Acct# 45980","Office Equipment",NA,25,59307.19
"373","Company Checking Account","Check","2018-11-26","5289","Payroll Service Co.","Payroll  Fee","Payroll Service Fees",NA,123.08,59184.11
"374","Company Checking Account","Check","2018-11-26","5287","Deborah Wood (Owner)","Owner's Draw","Deborah Wood Draws",NA,10750,48434.11
"375","Company Checking Account","Check","2018-11-30","5293","Jeff's Janitorial","Monthly Fees","Maintenance/Janitorial",NA,200,48234.11
"376","Company Checking Account","Check","2018-11-30","5292","Automobile Insurance Company","Auto Insurance Policy # 14906","Insurance-Auto",NA,120,48114.11
"377","Company Checking Account","Check","2018-11-30","5294","Credit Card","ACCT# 3786401297855001","QuickBooks Credit Card",NA,232.69,47881.42
"378","Company Checking Account","Bill Pmt -Check","2018-11-30","5290","Fisse Fast Package Delivery","ACCT# 256044025","Accounts Payable",NA,196,47685.42
"379","Company Checking Account","Bill Pmt -Check","2018-11-30","5291","Printing Shop","Inv#","Accounts Payable",NA,197,47488.42
"380","Company Checking Account","Paycheck","2018-12-01","3045","Bolinski, Rafal",NA,"-SPLIT-",NA,310.78,47177.64
"381","Company Checking Account","Paycheck","2018-12-01","3046","Deen, Jeannette",NA,"-SPLIT-",NA,218.96,46958.68
"382","Company Checking Account","Deposit","2018-12-01",NA,NA,"Deposit","-SPLIT-",35550.6,NA,82509.28
"383","Company Checking Account","Check","2018-12-03","5295","Kuver Property","Dec Rent","Rent",NA,583.75,81925.53
"384","Company Checking Account","Paycheck","2018-12-03","3044","King, Vicki",NA,"-SPLIT-",NA,130.64,81794.89
"385","Company Checking Account","Check","2018-12-04","5296","Local Bank","Interest on Line of Credit Nov 07","Interest Expense",NA,54.21,81740.68
"386","Company Checking Account","Check","2018-12-04","5297","Gretton Insurance Co.","Dec 07 WC Policy # 87023, Gen Liab. #14B09","-SPLIT-",NA,461.84,81278.84
"387","Company Checking Account","Check","2018-12-05","5298","Women's Shelter","donation","Contributions",NA,2500,78778.84
"388","Company Checking Account","Check","2018-12-07","5299","Gas & Electic Company","ACCT# 098703","Utilities",NA,75.6,78703.24
"389","Company Checking Account","Check","2018-12-14","5301","Automobile Loan Company","Car lease","Car Lease",NA,563,78140.24
"390","Company Checking Account","Paycheck","2018-12-15","3047","Bolinski, Rafal",NA,"-SPLIT-",NA,310.78,77829.46
"391","Company Checking Account","Paycheck","2018-12-15","3048","Deen, Jeannette",NA,"-SPLIT-",NA,218.96,77610.5
"392","Company Checking Account","Deposit","2018-12-15",NA,NA,"Deposit","-SPLIT-",12402.6,NA,90013.1
"393","Company Checking Account","Deposit","2018-12-15",NA,NA,"Deposit","-SPLIT-",18872.5,NA,108885.6
"394","Company Checking Account","Liability Check","2018-12-15","5357","Local Bank","55-5555555","-SPLIT-",NA,521.77,108363.83
"395","Company Checking Account","Liability Check","2018-12-15",NA,"Sec125 Administrator","Acct#  870547","SEC125 Payable",NA,100,108263.83
"396","Company Checking Account","Liability Check","2018-12-15",NA,"Local Bank","55-5555555","-SPLIT-",NA,441.95,107821.88
"397","Company Checking Account","Paycheck","2018-12-15","5361","Graham, Jonathan",NA,"-SPLIT-",NA,1845.77,105976.11
"398","Company Checking Account","Paycheck","2018-12-15","5362","King, Vicki",NA,"-SPLIT-",NA,300.17,105675.94
"399","Company Checking Account","Paycheck","2018-12-15","5363","Wood, Deborah",NA,"-SPLIT-",0,NA,105675.94
"400","Company Checking Account","Liability Check","2018-12-15",NA,"Sec125 Administrator","Acct#  870547","SEC125 Payable",NA,150,105525.94
"401","Company Checking Account","Paycheck","2018-12-15","5364","Bolinski, Rafal",NA,"-SPLIT-",NA,426.23,105099.71
"402","Company Checking Account","Liability Check","2018-12-15",NA,"Sec125 Administrator","Acct#  870547","SEC125 Payable",NA,50,105049.71
"403","Company Checking Account","Paycheck","2018-12-15","5365","Deen, Jeannette",NA,"-SPLIT-",NA,339.99,104709.72
"404","Company Checking Account","Paycheck","2018-12-17","3046","King, Vicki",NA,"-SPLIT-",NA,130.64,104579.08
"405","Company Checking Account","Liability Check","2018-12-17","5303","Sec125 Administrator","Acct#  870547","SEC125 Payable",NA,100,104479.08
"406","Company Checking Account","Check","2018-12-19","5305","Local Phone Company","6503221414","Telephone",NA,187.23,104291.85
"407","Company Checking Account","Check","2018-12-20","5306","Office Supply Store","Acct# 27804","Supplies",NA,52.63,104239.22
"408","Company Checking Account","Check","2018-12-20","5307","Cell Phone Company","Cell","Telephone",NA,104.58,104134.64
"409","Company Checking Account","Check","2018-12-21","5308","Fisse Fast Package Delivery","ACCT# 256044025","Postage and Delivery",NA,78,104056.64
"410","Company Checking Account","Check","2018-12-21","5309","Deborah Wood (Owner)","Owner's Draw","Deborah Wood Draws",NA,12000,92056.64
"411","Company Checking Account","Check","2018-12-27","5310","Health Insurance Co.","Employee Health Insurance Policy#258BVF4","-SPLIT-",NA,543.83,91512.81
"412","Company Checking Account","Check","2018-12-27","5311","Pace Shipping Supplies","Acct# 45980","Office Equipment",NA,25,91487.81
"413","Company Checking Account","Check","2018-12-27","5312","Payroll Service Co.","Payroll  Fee","Payroll Service Fees",NA,123.08,91364.73
"414","Company Checking Account","Check","2018-12-31","5317","Jeff's Janitorial","Monthly Fees","Maintenance/Janitorial",NA,200,91164.73
"415","Company Checking Account","Check","2018-12-31","5315","Automobile Insurance Company","Auto Insurance Policy # 14906","Insurance-Auto",NA,120,91044.73
"416","Company Checking Account","Check","2018-12-31","5316","Credit Card","ACCT# 3786401297855001","QuickBooks Credit Card",NA,388.41,90656.32
"417","Company Checking Account","Bill Pmt -Check","2018-12-31","5313","Fisse Fast Package Delivery","ACCT# 256044025","Accounts Payable",NA,162,90494.32
"418","Company Checking Account","Bill Pmt -Check","2018-12-31","5314","Printing Shop","Inv#","Accounts Payable",NA,340,90154.32
"436","Petty Cash Account","Check","2018-01-05","5002","Deborah Wood (Owner)","Petty Cash","Company Checking Account",500,NA,500
"439","Accounts Receivable","Invoice","2018-01-06","71047","Baker's Professional Lighting:Store #25",NA,"-SPLIT-",2381,NA,2381
"440","Accounts Receivable","Invoice","2018-01-14","71050","Godwin Lighting Depot:Store #202",NA,"-SPLIT-",7786.4,NA,10167.4
"441","Accounts Receivable","Invoice","2018-01-17","71055","Miscellaneous - Retail:Ms. Jann Minor",NA,"-SPLIT-",1084,NA,11251.4
"442","Accounts Receivable","Payment","2018-01-17","555","Miscellaneous - Retail:Ms. Jann Minor","71055","Undeposited Funds",NA,1084,10167.4
"443","Accounts Receivable","Invoice","2018-01-18","71092","Miscellaneous - Retail:Brian Stern",NA,"-SPLIT-",1126,NA,11293.4
"444","Accounts Receivable","Payment","2018-01-18","11124","Miscellaneous - Retail:Brian Stern","71092","Undeposited Funds",NA,1126,10167.4
"445","Accounts Receivable","Invoice","2018-01-28","71053","Miscellaneous - Retail:Alison Johnson",NA,"-SPLIT-",854,NA,11021.4
"446","Accounts Receivable","Invoice","2018-01-28","71072","Cole Home Builders:Phase 2 - Lot 5",NA,"-SPLIT-",2187.45,NA,13208.85
"447","Accounts Receivable","Payment","2018-01-28","254","Miscellaneous - Retail:Alison Johnson","71053","Undeposited Funds",NA,854,12354.85
"448","Accounts Receivable","Invoice","2018-01-29","71124","Kern Lighting Warehouse:Store #34",NA,"Revenue",8400,NA,20754.85
"449","Accounts Receivable","Invoice","2018-01-31","71059","Godwin Lighting Depot:Store #303",NA,"-SPLIT-",1687.95,NA,22442.8
"450","Accounts Receivable","Invoice","2018-02-01","71121","Kern Lighting Warehouse:Store #34",NA,"-SPLIT-",6745,NA,29187.8
"451","Accounts Receivable","Payment","2018-02-09","130","Baker's Professional Lighting:Store #25","71047","Undeposited Funds",NA,2381,26806.8
"452","Accounts Receivable","Invoice","2018-02-10","71051","Cole Home Builders:Phase 2 - Lot 5",NA,"-SPLIT-",4364,NA,31170.8
"453","Accounts Receivable","Invoice","2018-02-11","71112","Thompson Lighting Stores:Store #15",NA,"-SPLIT-",3025,NA,34195.8
"454","Accounts Receivable","Invoice","2018-02-12","71088","Cole Home Builders:Phase 1 - Lot 2",NA,"-SPLIT-",2187.45,NA,36383.25
"455","Accounts Receivable","Invoice","2018-02-14","71110","Baker's Professional Lighting:Store #05",NA,"-SPLIT-",2391,NA,38774.25
"456","Accounts Receivable","Payment","2018-02-15","1103","Stern Commercial Contractor's:Walker Properties","71106","Undeposited Funds",NA,21330,17444.25
"457","Accounts Receivable","Invoice","2018-02-18","71093","Miscellaneous - Retail:Ruth Kuver",NA,"-SPLIT-",1366,NA,18810.25
"458","Accounts Receivable","Payment","2018-02-18","5467","Miscellaneous - Retail:Ruth Kuver","71093","Undeposited Funds",NA,1366,17444.25
"459","Accounts Receivable","Invoice","2018-02-20","71054","Miscellaneous - Retail:Mrs. Chris Holly",NA,"-SPLIT-",1300,NA,18744.25
"460","Accounts Receivable","Payment","2018-02-20","305","Miscellaneous - Retail:Mrs. Chris Holly","71054","Undeposited Funds",NA,1300,17444.25
"461","Accounts Receivable","Invoice","2018-02-23","71094","Miscellaneous - Retail:David Lo",NA,"-SPLIT-",1932,NA,19376.25
"462","Accounts Receivable","Payment","2018-02-23","12357","Miscellaneous - Retail:David Lo","71094","Undeposited Funds",NA,1932,17444.25
"463","Accounts Receivable","Invoice","2018-02-27","71052","Baker's Professional Lighting:Store #15",NA,"-SPLIT-",1885,NA,19329.25
"464","Accounts Receivable","Invoice","2018-02-28","71122","Lavery Lighting & Design:Store #JL-08",NA,"Revenue",600,NA,19929.25
"465","Accounts Receivable","Payment","2018-02-28","57702","Godwin Lighting Depot:Store #202","71050","Undeposited Funds",NA,7786.4,12142.85
"466","Accounts Receivable","Payment","2018-02-28","57713","Godwin Lighting Depot:Store #303","71059","Undeposited Funds",NA,1687.95,10454.9
"467","Accounts Receivable","Payment","2018-03-02","5749","Kern Lighting Warehouse:Store #34","71124","Undeposited Funds",NA,8400,2054.9
"468","Accounts Receivable","Payment","2018-03-02","5750","Kern Lighting Warehouse:Store #13","71123","Undeposited Funds",NA,110,1944.9
"469","Accounts Receivable","Invoice","2018-03-11","71048","Baker's Professional Lighting:Store #20",NA,"-SPLIT-",1872,NA,3816.9
"470","Accounts Receivable","Invoice","2018-03-12","71049","Lavery Lighting & Design:Store #JL-06",NA,"-SPLIT-",4694.5,NA,8511.4
"471","Accounts Receivable","Invoice","2018-03-15","71056","Miscellaneous - Retail:Mr. Fred Kaseman",NA,"-SPLIT-",2221,NA,10732.4
"472","Accounts Receivable","Payment","2018-03-15","741","Miscellaneous - Retail:Mr. Fred Kaseman","71056","Undeposited Funds",NA,2221,8511.4
"473","Accounts Receivable","Payment","2018-03-16","5790","Kern Lighting Warehouse:Store #34","71121","Undeposited Funds",NA,6745,1766.4
"474","Accounts Receivable","Payment","2018-03-16","142","Baker's Professional Lighting:Store #05","71110","Undeposited Funds",NA,2391,-624.6
"475","Accounts Receivable","Payment","2018-03-16","11030","Cole Home Builders:Phase 2 - Lot 5","71072","Undeposited Funds",NA,2187.45,-2812.05
"476","Accounts Receivable","Invoice","2018-03-26","71065","Godwin Lighting Depot:Store #303",NA,"-SPLIT-",2578.95,NA,-233.1
"477","Accounts Receivable","Invoice","2018-03-27","71060","Godwin Lighting Depot:Store #404",NA,"-SPLIT-",1687.95,NA,1454.85
"478","Accounts Receivable","Invoice","2018-03-28","71071","Dan A. North Builders:McCarthy Properties",NA,"-SPLIT-",8929,NA,10383.85
"479","Accounts Receivable","Invoice","2018-03-28","71125","Kern Lighting Warehouse:Store #45",NA,"-SPLIT-",8500,NA,18883.85
"480","Accounts Receivable","Payment","2018-03-30","157","Baker's Professional Lighting:Store #15","71052","Undeposited Funds",NA,1885,16998.85
"481","Accounts Receivable","Payment","2018-03-30","11111","Lavery Lighting & Design:Store #JL-08","71122","Undeposited Funds",NA,600,16398.85
"482","Accounts Receivable","Invoice","2018-04-10","71057","Miscellaneous - Retail:Mr. Jay Jessen",NA,"-SPLIT-",1239,NA,17637.85
"483","Accounts Receivable","Payment","2018-04-10","489","Miscellaneous - Retail:Mr. Jay Jessen","71057","Undeposited Funds",NA,1239,16398.85
"484","Accounts Receivable","Invoice","2018-04-13","71126","Kern Lighting Warehouse:Store #13",NA,"Revenue",12600,NA,28998.85
"485","Accounts Receivable","Payment","2018-04-13","169","Baker's Professional Lighting:Store #20","71048","Undeposited Funds",NA,1872,27126.85
"486","Accounts Receivable","Invoice","2018-04-16","71087","Cole Home Builders:Phase 1 - Lot 5",NA,"-SPLIT-",2187.45,NA,29314.3
"487","Accounts Receivable","Payment","2018-04-16","11057","Cole Home Builders:Phase 1 - Lot 2","71088","Undeposited Funds",NA,2187.45,27126.85
"488","Accounts Receivable","Payment","2018-04-16","11049","Cole Home Builders:Phase 2 - Lot 5","71051","Undeposited Funds",NA,4364,22762.85
"489","Accounts Receivable","Invoice","2018-04-17","71061","Godwin Lighting Depot:Store #202",NA,"-SPLIT-",1687.95,NA,24450.8
"490","Accounts Receivable","Invoice","2018-04-22","71064","Godwin Lighting Depot:Store #404",NA,"-SPLIT-",2578.95,NA,27029.75
"491","Accounts Receivable","Invoice","2018-04-25","71058","Miscellaneous - Retail:Mrs. Anne Hemp",NA,"-SPLIT-",1563,NA,28592.75
"492","Accounts Receivable","Payment","2018-04-25","8111","Thompson Lighting Stores:Store #15","71112","Undeposited Funds",NA,3025,25567.75
"493","Accounts Receivable","Payment","2018-04-25","265","Miscellaneous - Retail:Mrs. Anne Hemp","71058","Undeposited Funds",NA,1563,24004.75
"494","Accounts Receivable","Invoice","2018-04-28","71066","Godwin Lighting Depot:Store #909",NA,"-SPLIT-",2578.95,NA,26583.7
"495","Accounts Receivable","Invoice","2018-04-28","71067","Dan A. North Builders:Wagner Suites",NA,"-SPLIT-",7890,NA,34473.7
"496","Accounts Receivable","Payment","2018-04-30","57730","Godwin Lighting Depot:Store #404","71060","Undeposited Funds",NA,1687.95,32785.75
"497","Accounts Receivable","Payment","2018-04-30","57713","Godwin Lighting Depot:Store #303","71065","Undeposited Funds",NA,2578.95,30206.8
"498","Accounts Receivable","Payment","2018-04-30","11128","Lavery Lighting & Design:Store #JL-06","71049","Undeposited Funds",NA,4694.5,25512.3
"499","Accounts Receivable","Payment","2018-04-30","5790","Dan A. North Builders:McCarthy Properties","71071","Undeposited Funds",NA,8929,16583.3
"500","Accounts Receivable","Invoice","2018-05-02","71062","Godwin Lighting Depot:Store #404",NA,"-SPLIT-",1687.95,NA,18271.25
"501","Accounts Receivable","Payment","2018-05-02","5824","Kern Lighting Warehouse:Store #45","71124","Undeposited Funds",NA,8500,9771.25
"502","Accounts Receivable","Invoice","2018-05-09","71111","Baker's Professional Lighting:Store #10",NA,"-SPLIT-",2038,NA,11809.25
"503","Accounts Receivable","Invoice","2018-05-10","71068","Godwin Lighting Depot:Store #909",NA,"-SPLIT-",2578.95,NA,14388.2
"504","Accounts Receivable","Invoice","2018-05-16","71095","Miscellaneous - Retail:Carlos Nazar",NA,"-SPLIT-",2025,NA,16413.2
"505","Accounts Receivable","Invoice","2018-05-16","71113","Thompson Lighting Stores:Store #20",NA,"-SPLIT-",3025,NA,19438.2
"506","Accounts Receivable","Payment","2018-05-16","1125","Miscellaneous - Retail:Carlos Nazar","71095","Undeposited Funds",NA,2025,17413.2
"507","Accounts Receivable","Invoice","2018-05-18","71084","Cole Home Builders:Phase 1 - Lot 5",NA,"-SPLIT-",1637.1,NA,19050.3
"508","Accounts Receivable","Invoice","2018-05-19","71063","Godwin Lighting Depot:Store #404",NA,"-SPLIT-",1687.95,NA,20738.25
"509","Accounts Receivable","Invoice","2018-05-22","71127","Kern Lighting Warehouse:Store #34",NA,"-SPLIT-",8756,NA,29494.25
"510","Accounts Receivable","Invoice","2018-05-24","71086","Cole Home Builders:Phase 1 - Lot 4",NA,"-SPLIT-",2187.45,NA,31681.7
"511","Accounts Receivable","Invoice","2018-05-30","71069","Godwin Lighting Depot:Store #1020",NA,"-SPLIT-",2578.95,NA,34260.65
"512","Accounts Receivable","Payment","2018-05-30","5810","Dan A. North Builders:Wagner Suites","71067","Undeposited Funds",NA,7890,26370.65
"513","Accounts Receivable","Invoice","2018-05-31","71083","Cole Home Builders:Phase 2 - Lot 5",NA,"-SPLIT-",1637.1,NA,28007.75
"514","Accounts Receivable","Payment","2018-05-31","57749","Godwin Lighting Depot:Store #202","71061","Undeposited Funds",NA,1687.95,26319.8
"515","Accounts Receivable","Payment","2018-05-31","57767","Godwin Lighting Depot:Store #404","71064","Undeposited Funds",NA,2578.95,23740.85
"516","Accounts Receivable","Payment","2018-05-31","57777","Godwin Lighting Depot:Store #909","71066","Undeposited Funds",NA,2578.95,21161.9
"517","Accounts Receivable","Invoice","2018-06-05","71096","Miscellaneous - Retail:Anne Loomis",NA,"-SPLIT-",1608,NA,22769.9
"518","Accounts Receivable","Payment","2018-06-05","2546","Miscellaneous - Retail:Anne Loomis","71096","Undeposited Funds",NA,1608,21161.9
"519","Accounts Receivable","Invoice","2018-06-07","71085","Cole Home Builders:Phase 1 - Lot 5",NA,"-SPLIT-",2187.45,NA,23349.35
"520","Accounts Receivable","Payment","2018-06-08","5832","Kern Lighting Warehouse:Store #13","71126","Undeposited Funds",NA,12600,10749.35
"521","Accounts Receivable","Invoice","2018-06-10","71128","Kern Lighting Warehouse:Store #45",NA,"-SPLIT-",14175,NA,24924.35
"522","Accounts Receivable","Invoice","2018-06-11","71070","Godwin Lighting Depot:Store #303",NA,"-SPLIT-",2578.95,NA,27503.3
"523","Accounts Receivable","Payment","2018-06-11","201","Baker's Professional Lighting:Store #10","71111","Undeposited Funds",NA,2038,25465.3
"524","Accounts Receivable","Invoice","2018-06-12","71080","Cole Home Builders:Phase 1 - Lot 5",NA,"-SPLIT-",2009.25,NA,27474.55
"525","Accounts Receivable","Invoice","2018-06-12","71081","Cole Home Builders:Phase 2 - Lot 5",NA,"-SPLIT-",1637.1,NA,29111.65
"526","Accounts Receivable","Invoice","2018-06-12","71114","Thompson Lighting Stores:Store #30",NA,"-SPLIT-",3025,NA,32136.65
"527","Accounts Receivable","Invoice","2018-06-15","71082","Cole Home Builders:Phase 1 - Lot 5",NA,"-SPLIT-",1637.1,NA,33773.75
"528","Accounts Receivable","Payment","2018-06-15","11123","Cole Home Builders:Phase 1 - Lot 5","71087","Undeposited Funds",NA,2187.45,31586.3
"529","Accounts Receivable","Invoice","2018-06-28","71116","Thompson Lighting Stores:Store #50",NA,"-SPLIT-",3025,NA,34611.3
"530","Accounts Receivable","Payment","2018-06-29","57790","Godwin Lighting Depot:Store #404","71062","Undeposited Funds",NA,1687.95,32923.35
"531","Accounts Receivable","Payment","2018-06-29","57801","Godwin Lighting Depot:Store #404","71063","Undeposited Funds",NA,1687.95,31235.4
"532","Accounts Receivable","Payment","2018-06-29","57799","Godwin Lighting Depot:Store #909","71068","Undeposited Funds",NA,2578.95,28656.45
"533","Accounts Receivable","Payment","2018-06-29","57811","Godwin Lighting Depot:Store #1020","71069","Undeposited Funds",NA,2578.95,26077.5
"534","Accounts Receivable","Invoice","2018-07-05","71089","Cole Home Builders:Phase 1 - Lot 5",NA,"-SPLIT-",1637.1,NA,27714.6
"535","Accounts Receivable","Invoice","2018-07-12","71079","Cole Home Builders:Phase 1 - Lot 5",NA,"-SPLIT-",2009.25,NA,29723.85
"536","Accounts Receivable","Invoice","2018-07-13","71119","Kern Lighting Warehouse:Store #01","Make sure these get sent on time!","-SPLIT-",6150,NA,35873.85
"537","Accounts Receivable","Invoice","2018-07-16","71076","Cole Home Builders:Phase 1 - Lot 5",NA,"-SPLIT-",2138.4,NA,38012.25
"538","Accounts Receivable","Invoice","2018-07-16","71115","Thompson Lighting Stores:Store #40",NA,"-SPLIT-",3025,NA,41037.25
"539","Accounts Receivable","Payment","2018-07-16","11173","Cole Home Builders:Phase 2 - Lot 5","71083","Undeposited Funds",NA,1637.1,39400.15
"540","Accounts Receivable","Payment","2018-07-16","11154","Cole Home Builders:Phase 1 - Lot 5","71084","Undeposited Funds",NA,1637.1,37763.05
"541","Accounts Receivable","Invoice","2018-07-17","71129","Kern Lighting Warehouse:Store #01",NA,"-SPLIT-",18940,NA,56703.05
"542","Accounts Receivable","Payment","2018-07-20","11167","Cole Home Builders:Phase 1 - Lot 4","71086","Undeposited Funds",NA,2187.45,54515.6
"543","Accounts Receivable","Invoice","2018-07-24","71097","Miscellaneous - Retail:Sean Martin",NA,"-SPLIT-",1542,NA,56057.6
"544","Accounts Receivable","Payment","2018-07-24","35587","Miscellaneous - Retail:Sean Martin","71097","Undeposited Funds",NA,1542,54515.6
"545","Accounts Receivable","Invoice","2018-07-27","71078","Cole Home Builders:Phase 1 - Lot 5",NA,"-SPLIT-",2009.25,NA,56524.85
"546","Accounts Receivable","Payment","2018-07-27","7233","Thompson Lighting Stores:Store #20","71113","Undeposited Funds",NA,3025,53499.85
"547","Accounts Receivable","Payment","2018-07-29","5740","Kern Lighting Warehouse:Store #01","71119","Undeposited Funds",NA,6150,47349.85
"548","Accounts Receivable","Invoice","2018-07-31","71077","Cole Home Builders:Phase 1 - Lot 5",NA,"-SPLIT-",2009.25,NA,49359.1
"549","Accounts Receivable","Payment","2018-07-31","5850","Kern Lighting Warehouse:Store #34","71127","Undeposited Funds",NA,8756,40603.1
"550","Accounts Receivable","Payment","2018-07-31","57820","Godwin Lighting Depot:Store #303","71070","Undeposited Funds",NA,2578.95,38024.15
"551","Accounts Receivable","Invoice","2018-08-07","71098","Miscellaneous - Retail:Jann Minor",NA,"-SPLIT-",2085,NA,40109.15
"552","Accounts Receivable","Payment","2018-08-07","5587","Miscellaneous - Retail:Jann Minor","71098","Undeposited Funds",NA,2085,38024.15
"553","Accounts Receivable","Invoice","2018-08-10","71090","Cole Home Builders:Phase 2 - Lot 5",NA,"-SPLIT-",2009.25,NA,40033.4
"554","Accounts Receivable","Payment","2018-08-15","7262","Thompson Lighting Stores:Store #50","71116","Undeposited Funds",NA,3025,37008.4
"555","Accounts Receivable","Payment","2018-08-15","11191","Cole Home Builders:Phase 1 - Lot 5","71080","Undeposited Funds",NA,2009.25,34999.15
"556","Accounts Receivable","Payment","2018-08-15","11190","Cole Home Builders:Phase 2 - Lot 5","71081","Undeposited Funds",NA,1637.1,33362.05
"557","Accounts Receivable","Payment","2018-08-15","11199","Cole Home Builders:Phase 1 - Lot 5","71082","Undeposited Funds",NA,1637.1,31724.95
"558","Accounts Receivable","Invoice","2018-08-17","71075","Cole Home Builders:Phase 1 - Lot 5",NA,"-SPLIT-",2138.4,NA,33863.35
"559","Accounts Receivable","Payment","2018-08-17","11184","Cole Home Builders:Phase 1 - Lot 5","71085","Undeposited Funds",NA,2187.45,31675.9
"560","Accounts Receivable","Payment","2018-08-17","5861","Kern Lighting Warehouse:Store #45","71128","Undeposited Funds",NA,14175,17500.9
"561","Accounts Receivable","Invoice","2018-08-22","71109","Dan A. North Builders:Turner Suites",NA,"-SPLIT-",13300,NA,30800.9
"562","Accounts Receivable","Invoice","2018-08-24","71074","Cole Home Builders:Phase 1 - Lot 5",NA,"-SPLIT-",2138.4,NA,32939.3
"563","Accounts Receivable","Invoice","2018-08-30","71130","Kern Lighting Warehouse:Store #45",NA,"-SPLIT-",8000,NA,40939.3
"564","Accounts Receivable","Invoice","2018-08-31","71073","Cole Home Builders:Phase 1 - Lot 5",NA,"-SPLIT-",2138.4,NA,43077.7
"565","Accounts Receivable","Invoice","2018-09-11","71099","Miscellaneous - Retail:Jason Helper",NA,"-SPLIT-",1812,NA,44889.7
"566","Accounts Receivable","Payment","2018-09-11","6687","Miscellaneous - Retail:Jason Helper","71099","Undeposited Funds",NA,1812,43077.7
"567","Accounts Receivable","Invoice","2018-09-14","71091","Cole Home Builders:Phase 2 - Lot 5",NA,"-SPLIT-",2138.4,NA,45216.1
"568","Accounts Receivable","Payment","2018-09-14","11201","Cole Home Builders:Phase 1 - Lot 5","71089","Undeposited Funds",NA,1637.1,43579
"569","Accounts Receivable","Payment","2018-09-14","5890","Kern Lighting Warehouse:Store #01","71129","Undeposited Funds",NA,18940,24639
"570","Accounts Receivable","Payment","2018-09-17","11223","Cole Home Builders:Phase 1 - Lot 5","71078","Undeposited Funds",NA,2009.25,22629.75
"571","Accounts Receivable","Payment","2018-09-17","11213","Cole Home Builders:Phase 1 - Lot 5","71079","Undeposited Funds",NA,2009.25,20620.5
"572","Accounts Receivable","Invoice","2018-09-19","71131","Kern Lighting Warehouse:Store #13",NA,"-SPLIT-",5569,NA,26189.5
"573","Accounts Receivable","Invoice","2018-09-25","71100","Miscellaneous - Retail:John Huhn",NA,"-SPLIT-",2239,NA,28428.5
"574","Accounts Receivable","Invoice","2018-09-25","71107","Stern Commercial Contractor's:Tittle Properties",NA,"-SPLIT-",17433,NA,45861.5
"575","Accounts Receivable","Payment","2018-09-25","71105","Miscellaneous - Retail:John Huhn","71100","Undeposited Funds",NA,2239,43622.5
"576","Accounts Receivable","Payment","2018-09-28","7253","Thompson Lighting Stores:Store #30","71114","Undeposited Funds",NA,3025,40597.5
"577","Accounts Receivable","Payment","2018-09-28","7279","Thompson Lighting Stores:Store #40","71115","Undeposited Funds",NA,3025,37572.5
"578","Accounts Receivable","Payment","2018-09-28","6111","Dan A. North Builders:Turner Suites","71109","Undeposited Funds",NA,13300,24272.5
"579","Accounts Receivable","Invoice","2018-10-09","71101","Miscellaneous - Retail:Doug Jacobsen",NA,"-SPLIT-",1719,NA,25991.5
"580","Accounts Receivable","Payment","2018-10-09","99611","Miscellaneous - Retail:Doug Jacobsen","71101","Undeposited Funds",NA,1719,24272.5
"581","Accounts Receivable","Invoice","2018-10-15","71132","Kern Lighting Warehouse:Store #34",NA,"-SPLIT-",10723.6,NA,34996.1
"582","Accounts Receivable","Payment","2018-10-15","11219","Cole Home Builders:Phase 1 - Lot 5","71076","Undeposited Funds",NA,2138.4,32857.7
"583","Accounts Receivable","Payment","2018-10-15","11230","Cole Home Builders:Phase 1 - Lot 5","71077","Undeposited Funds",NA,2009.25,30848.45
"584","Accounts Receivable","Payment","2018-10-19","11240","Cole Home Builders:Phase 2 - Lot 5","71090","Undeposited Funds",NA,2009.25,28839.2
"585","Accounts Receivable","Payment","2018-10-19","5910","Kern Lighting Warehouse:Store #45","71130","Undeposited Funds",NA,8000,20839.2
"586","Accounts Receivable","Invoice","2018-10-25","71102","Miscellaneous - Retail:Peter Karpas",NA,"-SPLIT-",1714,NA,22553.2
"587","Accounts Receivable","Payment","2018-10-25","115789","Miscellaneous - Retail:Peter Karpas","71102","Undeposited Funds",NA,1714,20839.2
"588","Accounts Receivable","Invoice","2018-10-26","71108","Stern Commercial Contractor's:Wilson Suites",NA,"-SPLIT-",14355,NA,35194.2
"589","Accounts Receivable","Invoice","2018-11-01","71120","Kern Lighting Warehouse:Store #13","Back ordered five 2032-02","-SPLIT-",8190,NA,43384.2
"590","Accounts Receivable","Invoice","2018-11-05","71103","Miscellaneous - Retail:Valesha Jones",NA,"-SPLIT-",2395,NA,45779.2
"591","Accounts Receivable","Invoice","2018-11-05","71117","Lavery Lighting & Design:Store #JL-01",NA,"-SPLIT-",5279,NA,51058.2
"592","Accounts Receivable","Payment","2018-11-05","101","Miscellaneous - Retail:Valesha Jones","71103","Undeposited Funds",NA,2395,48663.2
"593","Accounts Receivable","Invoice","2018-11-16","71118","Lavery Lighting & Design:Store #JL-04",NA,"-SPLIT-",11715,NA,60378.2
"594","Accounts Receivable","Payment","2018-11-16","11270","Cole Home Builders:Phase 1 - Lot 5","71073","Undeposited Funds",NA,2138.4,58239.8
"595","Accounts Receivable","Payment","2018-11-16","11257","Cole Home Builders:Phase 1 - Lot 5","71074","Undeposited Funds",NA,2138.4,56101.4
"596","Accounts Receivable","Payment","2018-11-16","11250","Cole Home Builders:Phase 1 - Lot 5","71075","Undeposited Funds",NA,2138.4,53963
"597","Accounts Receivable","Payment","2018-11-16","11280","Cole Home Builders:Phase 2 - Lot 5","71091","Undeposited Funds",NA,2138.4,51824.6
"598","Accounts Receivable","Payment","2018-11-16","5930","Kern Lighting Warehouse:Store #13","71131","Undeposited Funds",NA,5569,46255.6
"599","Accounts Receivable","Invoice","2018-11-20","71104","Miscellaneous - Retail:Melanie Hall",NA,"-SPLIT-",1600,NA,47855.6
"600","Accounts Receivable","Payment","2018-11-20","55449","Miscellaneous - Retail:Melanie Hall","71104","Undeposited Funds",NA,1600,46255.6
"601","Accounts Receivable","Invoice","2018-11-22","71133","Kern Lighting Warehouse:Store #01",NA,"-SPLIT-",9839,NA,56094.6
"602","Accounts Receivable","Invoice","2018-11-29","71123","Kern Lighting Warehouse:Store #13",NA,"-SPLIT-",110,NA,56204.6
"603","Accounts Receivable","Payment","2018-11-29","1052","Stern Commercial Contractor's:Tittle Properties","71107","Undeposited Funds",NA,17433,38771.6
"604","Accounts Receivable","Payment","2018-11-30","5791","Kern Lighting Warehouse:Store #13","71120","Undeposited Funds",NA,8190,30581.6
"605","Accounts Receivable","Payment","2018-11-30","1098","Stern Commercial Contractor's:Wilson Suites","71108","Undeposited Funds",NA,14355,16226.6
"606","Accounts Receivable","Payment","2018-12-01","11311","Lavery Lighting & Design:Store #JL-04","71118","Undeposited Funds",NA,11715,4511.6
"607","Accounts Receivable","Invoice","2018-12-03","71139","Lavery Lighting & Design:Store #JL-08","Partial ship 12/02/2007","-SPLIT-",2708.1,NA,7219.7
"608","Accounts Receivable","Invoice","2018-12-07","71138","Baker's Professional Lighting:Store #10","Partial ship 12/7/2007","-SPLIT-",10680.48,NA,17900.18
"609","Accounts Receivable","Invoice","2018-12-10","71105","Miscellaneous - Retail:Lara Gussman",NA,"-SPLIT-",1679,NA,19579.18
"610","Accounts Receivable","Payment","2018-12-10","66587","Miscellaneous - Retail:Lara Gussman","71105","Undeposited Funds",NA,1679,17900.18
"611","Accounts Receivable","Payment","2018-12-11","5977","Kern Lighting Warehouse:Store #01","71133","Undeposited Funds",NA,9839,8061.18
"612","Accounts Receivable","Invoice","2018-12-12","71106","Stern Commercial Contractor's:Walker Properties",NA,"-SPLIT-",21330,NA,29391.18
"613","Accounts Receivable","Payment","2018-12-14","5950","Kern Lighting Warehouse:Store #34","71132","Undeposited Funds",NA,10723.6,18667.58
"614","Accounts Receivable","Invoice","2018-12-15","71134","Kern Lighting Warehouse:Store #13",NA,"-SPLIT-",9033.5,NA,27701.08
"615","Accounts Receivable","Invoice","2018-12-15","71135","Baker's Professional Lighting:Store #15",NA,"-SPLIT-",1422,NA,29123.08
"616","Accounts Receivable","Invoice","2018-12-15","71136","Kern Lighting Warehouse:Store #13",NA,"-SPLIT-",2222.5,NA,31345.58
"617","Accounts Receivable","Invoice","2018-12-15","71137","Dan A. North Builders:Custom Order - Suite 100A",NA,"-SPLIT-",3500,NA,34845.58
"618","Accounts Receivable","Invoice","2018-12-15","71140","Thompson Lighting Stores:Store #15",NA,"-SPLIT-",11800,NA,46645.58
"619","Accounts Receivable","Payment","2018-12-15","11301","Lavery Lighting & Design:Store #JL-01","71117","Undeposited Funds",NA,5279,41366.58
"620","Accounts Receivable","Payment","2018-12-15","5999","Kern Lighting Warehouse:Store #13","71134","Undeposited Funds",NA,9033.5,32333.08
"625","Inventory Asset","Bill","2018-01-02","76850-2","Peacock Bulb Manufacturing Company","Specialty Bulbs, 100 watt (6 pack)","Accounts Payable",28.5,NA,88213.8
"626","Inventory Asset","Bill","2018-01-02","76850-2","Peacock Bulb Manufacturing Company","Cand. Light, 20 watts (8 pack)","Accounts Payable",48,NA,88261.8
"627","Inventory Asset","Bill","2018-01-06","87865","Paulsen's Lighting","Tiffany Collection,Golden Baroque, 1-light lantern, medium base (100 watt max)","Accounts Payable",2400,NA,90661.8
"628","Inventory Asset","Invoice","2018-01-06","71047","Baker's Professional Lighting:Store #25","Pearl Nickle, 5 Light, Medium Base (100 watt max)","Accounts Receivable",NA,240,90421.8
"629","Inventory Asset","Invoice","2018-01-06","71047","Baker's Professional Lighting:Store #25","Black Finish, Solid Brass, Clear Glass, Hanging, 2-60 watt max.","Accounts Receivable",NA,36,90385.8
"630","Inventory Asset","Invoice","2018-01-06","71047","Baker's Professional Lighting:Store #25","Beveled Mirror, Etched Ribbed Glass (75 watt max)","Accounts Receivable",NA,66,90319.8
"631","Inventory Asset","Invoice","2018-01-06","71047","Baker's Professional Lighting:Store #25","Tiffany Collection,Golden Baroque, 1-light lantern, medium base (100 watt max)","Accounts Receivable",NA,240,90079.8
"632","Inventory Asset","Invoice","2018-01-06","71047","Baker's Professional Lighting:Store #25","Burnished Brass (60 watt)  w/Golden Umber Accents","Accounts Receivable",NA,150,89929.8
"633","Inventory Asset","Invoice","2018-01-06","71047","Baker's Professional Lighting:Store #25","Specialty Bulbs, 100 watt (6 pack)","Accounts Receivable",NA,23.75,89906.05
"634","Inventory Asset","Invoice","2018-01-06","71047","Baker's Professional Lighting:Store #25","Pendant Bar, Cobblestone, 50lbs. max","Accounts Receivable",NA,20,89886.05
"635","Inventory Asset","Invoice","2018-01-06","71047","Baker's Professional Lighting:Store #25","Verona Collection, Pendant, Cobblestone, Etched Alabaster Glass, 150 watt max","Accounts Receivable",NA,140,89746.05
"636","Inventory Asset","Invoice","2018-01-06","71047","Baker's Professional Lighting:Store #25","Halogen Lamp, 20 watts, Luminous Intensity","Accounts Receivable",NA,6,89740.05
"637","Inventory Asset","Invoice","2018-01-06","71047","Baker's Professional Lighting:Store #25","Cand. Light, 20 watts (8 pack)","Accounts Receivable",NA,24,89716.05
"638","Inventory Asset","Invoice","2018-01-14","71050","Godwin Lighting Depot:Store #202","Pearl Nickle, 5 Light, Medium Base (100 watt max)","Accounts Receivable",NA,1000,88716.05
"639","Inventory Asset","Invoice","2018-01-14","71050","Godwin Lighting Depot:Store #202","Roman Bronze, 1-light Lantern, w/tail, (100 watt max)","Accounts Receivable",NA,380,88336.05
"640","Inventory Asset","Invoice","2018-01-14","71050","Godwin Lighting Depot:Store #202","Flush Mount, Polished Brass (2, 13 watt)  White acrylic diffuser","Accounts Receivable",NA,256,88080.05
"641","Inventory Asset","Invoice","2018-01-14","71050","Godwin Lighting Depot:Store #202","Brushed Nickel, Pendant, 1-100 watt Medium Base, Satin Etched Glass","Accounts Receivable",NA,300,87780.05
"642","Inventory Asset","Invoice","2018-01-14","71050","Godwin Lighting Depot:Store #202","Tiffany Collection,Golden Baroque, 1-light lantern, medium base (100 watt max)","Accounts Receivable",NA,480,87300.05
"643","Inventory Asset","Invoice","2018-01-14","71050","Godwin Lighting Depot:Store #202","River Rock (8/60 watt)  Faux Alabaster Glass","Accounts Receivable",NA,450,86850.05
"644","Inventory Asset","Invoice","2018-01-14","71050","Godwin Lighting Depot:Store #202","Specialty, Stage & Studio Bulbs  60 watt","Accounts Receivable",NA,125,86725.05
"645","Inventory Asset","Invoice","2018-01-14","71050","Godwin Lighting Depot:Store #202","Specialty Bulbs, 100 watt (6 pack)","Accounts Receivable",NA,47.5,86677.55
"646","Inventory Asset","Invoice","2018-01-14","71050","Godwin Lighting Depot:Store #202","Halogen Lamp, 20 watts, Luminous Intensity","Accounts Receivable",NA,19.2,86658.35
"647","Inventory Asset","Invoice","2018-01-17","71055","Miscellaneous - Retail:Ms. Jann Minor","Polished Brass Pendant, 1-100 watt Medium Base, Clear Ribbed Glass","Accounts Receivable",NA,160,86498.35
"648","Inventory Asset","Invoice","2018-01-17","71055","Miscellaneous - Retail:Ms. Jann Minor","Pendant Bar, Textured White, 50lbs max","Accounts Receivable",NA,20,86478.35
"649","Inventory Asset","Invoice","2018-01-17","71055","Miscellaneous - Retail:Ms. Jann Minor","Golden Umber (100 watt)  Six Light Chandelier","Accounts Receivable",NA,85,86393.35
"650","Inventory Asset","Invoice","2018-01-17","71055","Miscellaneous - Retail:Ms. Jann Minor","Beveled Mirror, Etched Ribbed Glass (75 watt max)","Accounts Receivable",NA,66,86327.35
"651","Inventory Asset","Invoice","2018-01-17","71055","Miscellaneous - Retail:Ms. Jann Minor","Sunset, Clear Glass, 1-100 watt max.","Accounts Receivable",NA,60,86267.35
"652","Inventory Asset","Invoice","2018-01-17","71055","Miscellaneous - Retail:Ms. Jann Minor","Black Finish, Solid Brass, Hanging w/Clear Glass (2x60watt max)","Accounts Receivable",NA,40,86227.35
"653","Inventory Asset","Invoice","2018-01-18","71092","Miscellaneous - Retail:Brian Stern","Sunset, Clear Glass, 1-100 watt max.","Accounts Receivable",NA,75,86152.35
"654","Inventory Asset","Invoice","2018-01-18","71092","Miscellaneous - Retail:Brian Stern","Beveled Mirror, Etched Ribbed Glass (75 watt max)","Accounts Receivable",NA,66,86086.35
"655","Inventory Asset","Invoice","2018-01-18","71092","Miscellaneous - Retail:Brian Stern","Athena Collection, (100 watt max) Copper Verde, Seeded Glass","Accounts Receivable",NA,75,86011.35
"656","Inventory Asset","Invoice","2018-01-18","71092","Miscellaneous - Retail:Brian Stern","Burnished Brass (60 watt)  w/Golden Umber Accents","Accounts Receivable",NA,75,85936.35
"657","Inventory Asset","Invoice","2018-01-18","71092","Miscellaneous - Retail:Brian Stern","Polished Brass Pendant, 1-100 watt Medium Base, Clear Ribbed Glass","Accounts Receivable",NA,128,85808.35
"658","Inventory Asset","Invoice","2018-01-18","71092","Miscellaneous - Retail:Brian Stern","Pendant Bar, Textured White, 50lbs max","Accounts Receivable",NA,20,85788.35
"659","Inventory Asset","Bill","2018-01-24","U7890","Paulsen's Lighting","Pearl Nickle, 5 Light, Medium Base (100 watt max)","Accounts Payable",3000,NA,88788.35
"660","Inventory Asset","Bill","2018-01-24","U7890","Paulsen's Lighting","Renaissance Collection, (100 watt max) Millstone Finish, One-light","Accounts Payable",1137.5,NA,89925.85
"661","Inventory Asset","Bill","2018-01-24","U7890","Paulsen's Lighting","Athena Collection, (100 watt max) Copper Verde, Seeded Glass","Accounts Payable",1650,NA,91575.85
"662","Inventory Asset","Bill","2018-01-24","U7890","Paulsen's Lighting","Roman Bronze, 1-light Lantern, w/tail, (100 watt max)","Accounts Payable",3800,NA,95375.85
"663","Inventory Asset","Bill","2018-01-24","U7890","Paulsen's Lighting","Vianne Lanterns, Satin Antiqued Solid Brass, 3-light wall latern, Candelabra base (60 watt max)","Accounts Payable",2425,NA,97800.85
"664","Inventory Asset","Bill","2018-01-24","U7890","Paulsen's Lighting","Pendant Bar, Cobblestone, 50lbs. max","Accounts Payable",600,NA,98400.85
"665","Inventory Asset","Bill","2018-01-26","b8796","Peacock Bulb Manufacturing Company","Halogen Lamp, 20 watts, Luminous Intensity","Accounts Payable",180,NA,98580.85
"666","Inventory Asset","Bill","2018-01-26","b8796","Peacock Bulb Manufacturing Company","Specialty, Stage & Studio Bulbs  60 watt (set of 4)","Accounts Payable",1250,NA,99830.85
"667","Inventory Asset","Bill","2018-01-26","b8796","Peacock Bulb Manufacturing Company","Specialty Bulbs, 100 watt (6 pack)","Accounts Payable",712.5,NA,100543.35
"668","Inventory Asset","Bill","2018-01-26","b8796","Peacock Bulb Manufacturing Company","Cand. Light, 20 watts (8 pack)","Accounts Payable",3600,NA,104143.35
"669","Inventory Asset","Bill","2018-01-26","b8796","Peacock Bulb Manufacturing Company","Halogen Lamp, Volts:3.5  Tubular","Accounts Payable",100,NA,104243.35
"670","Inventory Asset","Bill","2018-01-26","b8796","Peacock Bulb Manufacturing Company","Fluorescent Lamp, T-12, Medium Bipin  (30pack)","Accounts Payable",3300,NA,107543.35
"671","Inventory Asset","Invoice","2018-01-28","71053","Miscellaneous - Retail:Alison Johnson","Tapestry, (2-60 watt Med), Etched Cracked Glass, Finish 10","Accounts Receivable",NA,30,107513.35
"672","Inventory Asset","Invoice","2018-01-28","71053","Miscellaneous - Retail:Alison Johnson","Tapestry (8/60 watt)  Faux Alabaster Glass","Accounts Receivable",NA,75,107438.35
"673","Inventory Asset","Invoice","2018-01-28","71053","Miscellaneous - Retail:Alison Johnson","Vianne Lanterns, Satin Antiqued Solid Brass, 3-light wall latern, Candelabra base (60 watt max)","Accounts Receivable",NA,193.79,107244.56
"674","Inventory Asset","Invoice","2018-01-28","71053","Miscellaneous - Retail:Alison Johnson","White, 4.5x7.5, 1-100 watt Medium Base, Satin White Glass","Accounts Receivable",NA,30,107214.56
"675","Inventory Asset","Invoice","2018-01-28","71072","Cole Home Builders:Phase 2 - Lot 5","Die Cast Lanterns, Black, 1-100 watt, Medium Base, Clear Cracked Glass","Accounts Receivable",NA,228,106986.56
"676","Inventory Asset","Invoice","2018-01-28","71072","Cole Home Builders:Phase 2 - Lot 5","Tapestry, (2-60 watt Med), Etched Cracked Glass, Finish 10","Accounts Receivable",NA,90,106896.56
"677","Inventory Asset","Invoice","2018-01-28","71072","Cole Home Builders:Phase 2 - Lot 5","Pearl Nickle, 5 Light, Medium Base (100 watt max)","Accounts Receivable",NA,160,106736.56
"678","Inventory Asset","Invoice","2018-01-28","71072","Cole Home Builders:Phase 2 - Lot 5","Sunset, Clear Glass, 1-100 watt max.","Accounts Receivable",NA,60,106676.56
"679","Inventory Asset","Invoice","2018-01-28","71072","Cole Home Builders:Phase 2 - Lot 5","Black Finish, Solid Brass, Clear Glass, Hanging, 2-60 watt max.","Accounts Receivable",NA,54,106622.56
"680","Inventory Asset","Invoice","2018-01-28","71072","Cole Home Builders:Phase 2 - Lot 5","Burnished Brass (60 watt)  w/Golden Umber Accents","Accounts Receivable",NA,75,106547.56
"681","Inventory Asset","Invoice","2018-01-28","71072","Cole Home Builders:Phase 2 - Lot 5","Chestnut (3/60 watt)  Marble Glass","Accounts Receivable",NA,95,106452.56
"682","Inventory Asset","Invoice","2018-01-28","71072","Cole Home Builders:Phase 2 - Lot 5","Pendant Bar, Textured White, 50lbs max","Accounts Receivable",NA,10,106442.56
"683","Inventory Asset","Invoice","2018-01-28","71072","Cole Home Builders:Phase 2 - Lot 5","Athena Collection, (100 watt max) Copper Verde, Seeded Glass","Accounts Receivable",NA,32.14,106410.42
"684","Inventory Asset","Invoice","2018-01-28","71072","Cole Home Builders:Phase 2 - Lot 5","Cand. Light, 20 watts (8 pack)","Accounts Receivable",NA,24,106386.42
"685","Inventory Asset","Invoice","2018-01-28","71072","Cole Home Builders:Phase 2 - Lot 5","Fluorescent Lamp, T-12, Medium Bipin  (30pack)","Accounts Receivable",NA,6.34,106380.08
"686","Inventory Asset","Invoice","2018-01-28","71072","Cole Home Builders:Phase 2 - Lot 5","Fluorescent Lamp, T-5, Bipin","Accounts Receivable",NA,6,106374.08
"687","Inventory Asset","Invoice","2018-01-28","71072","Cole Home Builders:Phase 2 - Lot 5","Halogen Lamp, Volts:3.5  Tubular","Accounts Receivable",NA,2.5,106371.58
"688","Inventory Asset","Invoice","2018-01-28","71072","Cole Home Builders:Phase 2 - Lot 5","Specialty Bulbs, 100 watt (6 pack)","Accounts Receivable",NA,9.5,106362.08
"689","Inventory Asset","Invoice","2018-01-28","71072","Cole Home Builders:Phase 2 - Lot 5","Specialty, Stage & Studio Bulbs  60 watt","Accounts Receivable",NA,20,106342.08
"690","Inventory Asset","Invoice","2018-01-28","71072","Cole Home Builders:Phase 2 - Lot 5","Flat Glass, (25 watt max) Polished Brass, 4 light","Accounts Receivable",NA,40,106302.08
"691","Inventory Asset","Invoice","2018-01-28","71072","Cole Home Builders:Phase 2 - Lot 5","Beveled Mirror, Etched Ribbed Glass (75 watt max)","Accounts Receivable",NA,44,106258.08
"692","Inventory Asset","Invoice","2018-01-29","71124","Kern Lighting Warehouse:Store #34","Burnished Brass (60 watt)  w/Golden Umber Accents","Accounts Receivable",NA,2100,104158.08
"693","Inventory Asset","Bill","2018-01-30","98760AR","Hall Lighting & Accessories","Black Finish, Solid Brass, Clear Glass, Hanging, 2-60 watt max.","Accounts Payable",2310,NA,106468.08
"694","Inventory Asset","Bill","2018-01-30","98760AR","Hall Lighting & Accessories","Sunset, Clear Glass, 1-100 watt max.","Accounts Payable",2187.5,NA,108655.58
"695","Inventory Asset","Bill","2018-01-30","98760AR","Hall Lighting & Accessories","Sunset, Clear Glass, 1-100 watt max.","Accounts Payable",NA,5,108650.58
"696","Inventory Asset","Bill","2018-01-30","98760AR","Hall Lighting & Accessories","Beveled Mirror, Etched Ribbed Glass (75 watt max)","Accounts Payable",2250,NA,110900.58
"697","Inventory Asset","Bill","2018-01-31","8907","Foster Lighting","Chestnut (3/60 watt)  Marble Glass","Accounts Payable",3000,NA,113900.58
"698","Inventory Asset","Bill","2018-01-31","8907","Foster Lighting","Frosted Taupe (3/60 watt)  Marble Glass  ","Accounts Payable",1470,NA,115370.58
"699","Inventory Asset","Invoice","2018-01-31","71059","Godwin Lighting Depot:Store #303","Black Finish, Solid Brass, Clear Glass, Hanging, 2-60 watt max.","Accounts Receivable",NA,57.57,115313.01
"700","Inventory Asset","Invoice","2018-01-31","71059","Godwin Lighting Depot:Store #303","Black Finish, Solid Brass,Wall Mount w/Clear Glass (2x60watt max)","Accounts Receivable",NA,200,115113.01
"701","Inventory Asset","Invoice","2018-01-31","71059","Godwin Lighting Depot:Store #303","Tapestry (8/60 watt)  Faux Alabaster Glass","Accounts Receivable",NA,150,114963.01
"702","Inventory Asset","Invoice","2018-01-31","71059","Godwin Lighting Depot:Store #303","Athena Collection, (100 watt max) Copper Verde, Seeded Glass","Accounts Receivable",NA,160.71,114802.3
"703","Inventory Asset","Invoice","2018-01-31","71059","Godwin Lighting Depot:Store #303","Broadway Collection, Polished Chrome, 4 Light (60 watt max)","Accounts Receivable",NA,126,114676.3
"704","Inventory Asset","Invoice","2018-01-31","71059","Godwin Lighting Depot:Store #303","Halogen Lamp, Volts:3.5  Tubular","Accounts Receivable",NA,5,114671.3
"705","Inventory Asset","Invoice","2018-01-31","71059","Godwin Lighting Depot:Store #303","Specialty Bulbs, 100 watt (6 pack)","Accounts Receivable",NA,9.5,114661.8
"706","Inventory Asset","Invoice","2018-01-31","71059","Godwin Lighting Depot:Store #303","Specialty, Stage & Studio Bulbs  60 watt","Accounts Receivable",NA,17.5,114644.3
"707","Inventory Asset","Invoice","2018-01-31","71059","Godwin Lighting Depot:Store #303","Fluorescent Lamp, T-12, Medium Bipin  (30pack)","Accounts Receivable",NA,6.34,114637.96
"708","Inventory Asset","Invoice","2018-01-31","71059","Godwin Lighting Depot:Store #303","Domes, White, 59x21x6 5/8 ht, 120v HPF","Accounts Receivable",NA,36,114601.96
"709","Inventory Asset","Invoice","2018-02-01","71121","Kern Lighting Warehouse:Store #34","Brushed Nickel, Pendant, 1-100 watt Medium Base, Satin Etched Glass","Accounts Receivable",NA,250,114351.96
"710","Inventory Asset","Invoice","2018-02-01","71121","Kern Lighting Warehouse:Store #34","Tapestry, (2-60 watt Med), Etched Cracked Glass, Finish 10","Accounts Receivable",NA,225,114126.96
"711","Inventory Asset","Invoice","2018-02-01","71121","Kern Lighting Warehouse:Store #34","18x8x10, Solid Brass, 3-60watt Medium Base, Satin Etched Glass","Accounts Receivable",NA,640,113486.96
"712","Inventory Asset","Invoice","2018-02-01","71121","Kern Lighting Warehouse:Store #34","18x8x10, Solid Brass, 3-60watt Medium Base, Satin Etched Glass","Accounts Receivable",NA,960,112526.96
"713","Inventory Asset","Invoice","2018-02-01","71121","Kern Lighting Warehouse:Store #34","Solid Brass, 4-light, 25x13x10.75, 4-60 watt, Medium Base, Satin Etched Glass","Accounts Receivable",NA,570,111956.96
"714","Inventory Asset","Invoice","2018-02-01","71121","Kern Lighting Warehouse:Store #34","White, 4.5x7.5, 1-100 watt Medium Base, Satin White Glass","Accounts Receivable",NA,450,111506.96
"715","Inventory Asset","Bill","2018-02-06","455778","Paulsen's Lighting","Golden Umber (100 watt)  Six Light Chandelier","Accounts Payable",425,NA,111931.96
"716","Inventory Asset","Bill","2018-02-06","455778","Paulsen's Lighting","Burnished Brass (60 watt)  w/Golden Umber Accents","Accounts Payable",375,NA,112306.96
"717","Inventory Asset","Bill","2018-02-06","455778","Paulsen's Lighting","Domes, White, 59x21x6 5/8 ht, 120v HPF","Accounts Payable",1350,NA,113656.96
"718","Inventory Asset","Bill","2018-02-06","78900","Foster Lighting","Acid Verde, 10x21x10, 2-60 watt cand.","Accounts Payable",2250,NA,115906.96
"719","Inventory Asset","Bill","2018-02-06","78900","Foster Lighting","Die Cast Lanterns, Black, 1-100 watt, Medium Base, Clear Cracked Glass","Accounts Payable",3800,NA,119706.96
"720","Inventory Asset","Bill","2018-02-06","78900","Foster Lighting","18x8x10, Solid Brass, 3-60watt Medium Base, Satin Etched Glass","Accounts Payable",2400,NA,122106.96
"721","Inventory Asset","Invoice","2018-02-10","71051","Cole Home Builders:Phase 2 - Lot 5","Specialty Bulbs, 100 watt (6 pack)","Accounts Receivable",NA,57,122049.96
"722","Inventory Asset","Invoice","2018-02-10","71051","Cole Home Builders:Phase 2 - Lot 5","Cand. Light, 20 watts (8 pack)","Accounts Receivable",NA,48,122001.96
"723","Inventory Asset","Invoice","2018-02-10","71051","Cole Home Builders:Phase 2 - Lot 5","Golden Umber (100 watt)  Six Light Chandelier","Accounts Receivable",NA,510,121491.96
"724","Inventory Asset","Invoice","2018-02-10","71051","Cole Home Builders:Phase 2 - Lot 5","Acid Verde, 10x21x10, 2-60 watt cand.","Accounts Receivable",NA,150,121341.96
"725","Inventory Asset","Invoice","2018-02-10","71051","Cole Home Builders:Phase 2 - Lot 5","18x8x10, Solid Brass, 3-60watt Medium Base, Satin Etched Glass","Accounts Receivable",NA,480,120861.96
"726","Inventory Asset","Invoice","2018-02-10","71051","Cole Home Builders:Phase 2 - Lot 5","Athena Collection, (100 watt max) Copper Verde, Seeded Glass","Accounts Receivable",NA,321.43,120540.53
"727","Inventory Asset","Invoice","2018-02-11","71112","Thompson Lighting Stores:Store #15","Acid Verde, 10x21x10, 2-60 watt cand.","Accounts Receivable",NA,180,120360.53
"728","Inventory Asset","Invoice","2018-02-11","71112","Thompson Lighting Stores:Store #15","Die Cast Lanterns, Black, 1-100 watt, Medium Base, Clear Cracked Glass","Accounts Receivable",NA,152,120208.53
"729","Inventory Asset","Invoice","2018-02-11","71112","Thompson Lighting Stores:Store #15","Polished Brass Pendant, 1-100 watt Medium Base, Clear Ribbed Glass","Accounts Receivable",NA,128,120080.53
"730","Inventory Asset","Invoice","2018-02-11","71112","Thompson Lighting Stores:Store #15","2032 Series, (3-60 watt, Med) Desert Stone Finish","Accounts Receivable",NA,48,120032.53
"731","Inventory Asset","Invoice","2018-02-11","71112","Thompson Lighting Stores:Store #15","Brushed Nickel, 18x7.75x6, 3-60 watt Medium Base, Satin Opal Glass","Accounts Receivable",NA,74,119958.53
"732","Inventory Asset","Invoice","2018-02-11","71112","Thompson Lighting Stores:Store #15","Tapestry (8/60 watt)  Faux Alabaster Glass","Accounts Receivable",NA,75,119883.53
"733","Inventory Asset","Invoice","2018-02-11","71112","Thompson Lighting Stores:Store #15","Frosted Taupe (3/60 watt)  Marble Glass  ","Accounts Receivable",NA,89.88,119793.65
"734","Inventory Asset","Invoice","2018-02-11","71112","Thompson Lighting Stores:Store #15","Roman Bronze, 1-light Lantern, w/tail, (100 watt max)","Accounts Receivable",NA,152,119641.65
"735","Inventory Asset","Invoice","2018-02-11","71112","Thompson Lighting Stores:Store #15","Domes, White, 59x21x6 5/8 ht, 120v HPF","Accounts Receivable",NA,54,119587.65
"736","Inventory Asset","Invoice","2018-02-11","71112","Thompson Lighting Stores:Store #15","Flat Glass, (25 watt max) Polished Brass, 4 light","Accounts Receivable",NA,50,119537.65
"737","Inventory Asset","Invoice","2018-02-11","71112","Thompson Lighting Stores:Store #15","Burnished Brass (60 watt)  w/Golden Umber Accents","Accounts Receivable",NA,75,119462.65
"738","Inventory Asset","Invoice","2018-02-11","71112","Thompson Lighting Stores:Store #15","Pearl Nickle, 5 Light, Medium Base (100 watt max)","Accounts Receivable",NA,200,119262.65
"739","Inventory Asset","Invoice","2018-02-12","71088","Cole Home Builders:Phase 1 - Lot 2","Die Cast Lanterns, Black, 1-100 watt, Medium Base, Clear Cracked Glass","Accounts Receivable",NA,228,119034.65
"740","Inventory Asset","Invoice","2018-02-12","71088","Cole Home Builders:Phase 1 - Lot 2","Tapestry, (2-60 watt Med), Etched Cracked Glass, Finish 10","Accounts Receivable",NA,90,118944.65
"741","Inventory Asset","Invoice","2018-02-12","71088","Cole Home Builders:Phase 1 - Lot 2","Pearl Nickle, 5 Light, Medium Base (100 watt max)","Accounts Receivable",NA,160,118784.65
"742","Inventory Asset","Invoice","2018-02-12","71088","Cole Home Builders:Phase 1 - Lot 2","Sunset, Clear Glass, 1-100 watt max.","Accounts Receivable",NA,70,118714.65
"743","Inventory Asset","Invoice","2018-02-12","71088","Cole Home Builders:Phase 1 - Lot 2","Black Finish, Solid Brass, Clear Glass, Hanging, 2-60 watt max.","Accounts Receivable",NA,57.57,118657.08
"744","Inventory Asset","Invoice","2018-02-12","71088","Cole Home Builders:Phase 1 - Lot 2","Burnished Brass (60 watt)  w/Golden Umber Accents","Accounts Receivable",NA,75,118582.08
"745","Inventory Asset","Invoice","2018-02-12","71088","Cole Home Builders:Phase 1 - Lot 2","Chestnut (3/60 watt)  Marble Glass","Accounts Receivable",NA,97.78,118484.3
"746","Inventory Asset","Invoice","2018-02-12","71088","Cole Home Builders:Phase 1 - Lot 2","Pendant Bar, Textured White, 50lbs max","Accounts Receivable",NA,10,118474.3
"747","Inventory Asset","Invoice","2018-02-12","71088","Cole Home Builders:Phase 1 - Lot 2","Athena Collection, (100 watt max) Copper Verde, Seeded Glass","Accounts Receivable",NA,32.14,118442.16
"748","Inventory Asset","Invoice","2018-02-12","71088","Cole Home Builders:Phase 1 - Lot 2","Cand. Light, 20 watts (8 pack)","Accounts Receivable",NA,24,118418.16
"749","Inventory Asset","Invoice","2018-02-12","71088","Cole Home Builders:Phase 1 - Lot 2","Fluorescent Lamp, T-12, Medium Bipin  (30pack)","Accounts Receivable",NA,6.34,118411.82
"750","Inventory Asset","Invoice","2018-02-12","71088","Cole Home Builders:Phase 1 - Lot 2","Fluorescent Lamp, T-5, Bipin","Accounts Receivable",NA,6,118405.82
"751","Inventory Asset","Invoice","2018-02-12","71088","Cole Home Builders:Phase 1 - Lot 2","Halogen Lamp, Volts:3.5  Tubular","Accounts Receivable",NA,2.5,118403.32
"752","Inventory Asset","Invoice","2018-02-12","71088","Cole Home Builders:Phase 1 - Lot 2","Specialty Bulbs, 100 watt (6 pack)","Accounts Receivable",NA,9.5,118393.82
"753","Inventory Asset","Invoice","2018-02-12","71088","Cole Home Builders:Phase 1 - Lot 2","Specialty, Stage & Studio Bulbs  60 watt","Accounts Receivable",NA,20,118373.82
"754","Inventory Asset","Invoice","2018-02-12","71088","Cole Home Builders:Phase 1 - Lot 2","Flat Glass, (25 watt max) Polished Brass, 4 light","Accounts Receivable",NA,40,118333.82
"755","Inventory Asset","Invoice","2018-02-12","71088","Cole Home Builders:Phase 1 - Lot 2","Beveled Mirror, Etched Ribbed Glass (75 watt max)","Accounts Receivable",NA,48.25,118285.57
"756","Inventory Asset","Invoice","2018-02-14","71110","Baker's Professional Lighting:Store #05","River Rock (8/60 watt)  Faux Alabaster Glass","Accounts Receivable",NA,150,118135.57
"757","Inventory Asset","Invoice","2018-02-14","71110","Baker's Professional Lighting:Store #05","Chestnut (3/60 watt)  Marble Glass","Accounts Receivable",NA,97.78,118037.79
"758","Inventory Asset","Invoice","2018-02-14","71110","Baker's Professional Lighting:Store #05","Roman Bronze, 1-light Lantern, w/tail, (100 watt max)","Accounts Receivable",NA,380,117657.79
"759","Inventory Asset","Invoice","2018-02-14","71110","Baker's Professional Lighting:Store #05","Broadway Collection, Polished Brass, 6 Light (60 watt max)","Accounts Receivable",NA,60,117597.79
"760","Inventory Asset","Invoice","2018-02-14","71110","Baker's Professional Lighting:Store #05","Pearl Nickle, 5 Light, Medium Base (100 watt max)","Accounts Receivable",NA,80,117517.79
"761","Inventory Asset","Invoice","2018-02-14","71110","Baker's Professional Lighting:Store #05","Polished Brass Pendant, 1-100 watt Medium Base, Clear Ribbed Glass","Accounts Receivable",NA,128,117389.79
"762","Inventory Asset","Invoice","2018-02-14","71110","Baker's Professional Lighting:Store #05","Pendant Bar, Cobblestone, 50lbs. max","Accounts Receivable",NA,22.74,117367.05
"763","Inventory Asset","Bill","2018-02-15","P8890-01","Paulsen's Lighting","Pearl Nickle, 5 Light, Medium Base (100 watt max)","Accounts Payable",1000,NA,118367.05
"764","Inventory Asset","Bill","2018-02-15","P8890-01","Paulsen's Lighting","Roman Bronze, 1-light Lantern, w/tail, (100 watt max)","Accounts Payable",380,NA,118747.05
"765","Inventory Asset","Bill","2018-02-15","P8890-01","Paulsen's Lighting","Flush Mount, Polished Brass (2, 13 watt)  White acrylic diffuser","Accounts Payable",256,NA,119003.05
"766","Inventory Asset","Invoice","2018-02-18","71093","Miscellaneous - Retail:Ruth Kuver","Chestnut (3/60 watt)  Marble Glass","Accounts Receivable",NA,195.56,118807.49
"767","Inventory Asset","Invoice","2018-02-18","71093","Miscellaneous - Retail:Ruth Kuver","Verona Collection, Pendant, Cobblestone, Etched Alabaster Glass, 150 watt max","Accounts Receivable",NA,210,118597.49
"768","Inventory Asset","Invoice","2018-02-18","71093","Miscellaneous - Retail:Ruth Kuver","Pendant Bar, Cobblestone, 50lbs. max","Accounts Receivable",NA,22.74,118574.75
"769","Inventory Asset","Invoice","2018-02-18","71093","Miscellaneous - Retail:Ruth Kuver","Broadway Collection, Polished Brass, 6 Light (60 watt max)","Accounts Receivable",NA,90,118484.75
"770","Inventory Asset","Invoice","2018-02-20","71054","Miscellaneous - Retail:Mrs. Chris Holly","Vianne Lanterns, Satin Antiqued Solid Brass, 3-light wall latern, Candelabra base (60 watt max)","Accounts Receivable",NA,242.23,118242.52
"771","Inventory Asset","Invoice","2018-02-20","71054","Miscellaneous - Retail:Mrs. Chris Holly","White, 4.5x7.5, 1-100 watt Medium Base, Satin White Glass","Accounts Receivable",NA,45,118197.52
"772","Inventory Asset","Invoice","2018-02-20","71054","Miscellaneous - Retail:Mrs. Chris Holly","Frosted Taupe (3/60 watt)  Marble Glass  ","Accounts Receivable",NA,89.88,118107.64
"773","Inventory Asset","Invoice","2018-02-20","71054","Miscellaneous - Retail:Mrs. Chris Holly","Athena Collection, Pendant, Textured White, Med. Base, 100 watt max.","Accounts Receivable",NA,120,117987.64
"774","Inventory Asset","Invoice","2018-02-20","71054","Miscellaneous - Retail:Mrs. Chris Holly","Pendant Bar, Cobblestone, 50lbs. max","Accounts Receivable",NA,22.74,117964.9
"775","Inventory Asset","Invoice","2018-02-20","71054","Miscellaneous - Retail:Mrs. Chris Holly","Drop Opal w/Solid Oak Frame, 49 1/2 x 17, 120v HPF","Accounts Receivable",NA,40,117924.9
"776","Inventory Asset","Invoice","2018-02-23","71094","Miscellaneous - Retail:David Lo","Domes, White, 59x21x6 5/8 ht, 120v HPF","Accounts Receivable",NA,180,117744.9
"777","Inventory Asset","Invoice","2018-02-23","71094","Miscellaneous - Retail:David Lo","Tiffany Collection,Golden Baroque, 1-light lantern, medium base (100 watt max)","Accounts Receivable",NA,240,117504.9
"778","Inventory Asset","Invoice","2018-02-23","71094","Miscellaneous - Retail:David Lo","Chestnut (3/60 watt)  Marble Glass","Accounts Receivable",NA,195.56,117309.34
"779","Inventory Asset","Invoice","2018-02-23","71094","Miscellaneous - Retail:David Lo","Pearl Nickle, 5 Light, Medium Base (100 watt max)","Accounts Receivable",NA,80,117229.34
"780","Inventory Asset","Invoice","2018-02-23","71094","Miscellaneous - Retail:David Lo","18x8x10, Solid Brass, 3-60watt Medium Base, Satin Etched Glass","Accounts Receivable",NA,64,117165.34
"781","Inventory Asset","Invoice","2018-02-27","71052","Baker's Professional Lighting:Store #15","Acid Verde, 10x21x10, 2-60 watt cand.","Accounts Receivable",NA,120,117045.34
"782","Inventory Asset","Invoice","2018-02-27","71052","Baker's Professional Lighting:Store #15","Polished Brass Pendant, 1-100 watt Medium Base, Clear Ribbed Glass","Accounts Receivable",NA,96,116949.34
"783","Inventory Asset","Invoice","2018-02-27","71052","Baker's Professional Lighting:Store #15","River Rock (8/60 watt)  Faux Alabaster Glass","Accounts Receivable",NA,150,116799.34
"784","Inventory Asset","Invoice","2018-02-27","71052","Baker's Professional Lighting:Store #15","Brushed Nickel, 18x7.75x6, 3-60 watt Medium Base, Satin Opal Glass","Accounts Receivable",NA,55.5,116743.84
"785","Inventory Asset","Invoice","2018-02-27","71052","Baker's Professional Lighting:Store #15","Halogen Lamp, 20 watts, Luminous Intensity","Accounts Receivable",NA,6,116737.84
"786","Inventory Asset","Invoice","2018-02-27","71052","Baker's Professional Lighting:Store #15","Specialty, Stage & Studio Bulbs  60 watt","Accounts Receivable",NA,10,116727.84
"787","Inventory Asset","Invoice","2018-02-27","71052","Baker's Professional Lighting:Store #15","2032 Series, (3-60 watt, Med) Desert Stone Finish","Accounts Receivable",NA,72,116655.84
"788","Inventory Asset","Invoice","2018-02-27","71052","Baker's Professional Lighting:Store #15","Tapestry (8/60 watt)  Faux Alabaster Glass","Accounts Receivable",NA,75,116580.84
"789","Inventory Asset","Invoice","2018-02-27","71052","Baker's Professional Lighting:Store #15","Drop Opal w/Solid Oak Frame, 49 1/2 x 17, 120v HPF","Accounts Receivable",NA,60,116520.84
"790","Inventory Asset","Invoice","2018-02-27","71052","Baker's Professional Lighting:Store #15","Fluorescent Lamp, T-5, Bipin","Accounts Receivable",NA,2.7,116518.14
"791","Inventory Asset","Bill","2018-03-01","7866-92","Foster Lighting","Tapestry, (2-60 watt Med), Etched Cracked Glass, Finish 10","Accounts Payable",75,NA,116593.14
"792","Inventory Asset","Bill","2018-03-01","7866-92","Foster Lighting","Frosted Taupe (3/60 watt)  Marble Glass  ","Accounts Payable",510,NA,117103.14
"793","Inventory Asset","Bill","2018-03-01","7866-92","Foster Lighting","Brushed Nickel, (3-60 watt, Med) Ribbed Glass","Accounts Payable",120,NA,117223.14
"794","Inventory Asset","Bill","2018-03-09","R909878","Paulsen's Lighting","Vianne Lanterns, Satin Antiqued Solid Brass, 3-light wall latern, Candelabra base (60 watt max)","Accounts Payable",4800,NA,122023.14
"795","Inventory Asset","Bill","2018-03-09","R909878","Paulsen's Lighting","Golden Umber (100 watt)  Six Light Chandelier","Accounts Payable",8500,NA,130523.14
"796","Inventory Asset","Bill","2018-03-09","R909878","Paulsen's Lighting","Burnished Brass (60 watt)  w/Golden Umber Accents","Accounts Payable",7500,NA,138023.14
"797","Inventory Asset","Invoice","2018-03-11","71048","Baker's Professional Lighting:Store #20","Die Cast Lanterns, Black, 1-100 watt, Medium Base, Clear Cracked Glass","Accounts Receivable",NA,190,137833.14
"798","Inventory Asset","Invoice","2018-03-11","71048","Baker's Professional Lighting:Store #20","Polished Brass Pendant, 1-100 watt Medium Base, Clear Ribbed Glass","Accounts Receivable",NA,224,137609.14
"799","Inventory Asset","Invoice","2018-03-11","71048","Baker's Professional Lighting:Store #20","Golden Umber (100 watt)  Six Light Chandelier","Accounts Receivable",NA,170,137439.14
"800","Inventory Asset","Invoice","2018-03-11","71048","Baker's Professional Lighting:Store #20","Pendant Bar, Cobblestone, 50lbs. max","Accounts Receivable",NA,11.37,137427.77
"801","Inventory Asset","Invoice","2018-03-11","71048","Baker's Professional Lighting:Store #20","Broadway Collection, Polished Brass, 6 Light (60 watt max)","Accounts Receivable",NA,90,137337.77
"802","Inventory Asset","Invoice","2018-03-11","71048","Baker's Professional Lighting:Store #20","Black Finish, Solid Brass, Clear Glass, Hanging, 2-60 watt max.","Accounts Receivable",NA,19.19,137318.58
"803","Inventory Asset","Invoice","2018-03-11","71048","Baker's Professional Lighting:Store #20","Cand. Light, 20 watts (8 pack)","Accounts Receivable",NA,12,137306.58
"804","Inventory Asset","Invoice","2018-03-11","71048","Baker's Professional Lighting:Store #20","Specialty Bulbs, 100 watt (6 pack)","Accounts Receivable",NA,4.75,137301.83
"805","Inventory Asset","Invoice","2018-03-12","71049","Lavery Lighting & Design:Store #JL-06","Tapestry, (2-60 watt Med), Etched Cracked Glass, Finish 10","Accounts Receivable",NA,75,137226.83
"806","Inventory Asset","Invoice","2018-03-12","71049","Lavery Lighting & Design:Store #JL-06","Frosted Taupe (3/60 watt)  Marble Glass  ","Accounts Receivable",NA,535.26,136691.57
"807","Inventory Asset","Invoice","2018-03-12","71049","Lavery Lighting & Design:Store #JL-06","Brushed Nickel, (3-60 watt, Med) Ribbed Glass","Accounts Receivable",NA,120,136571.57
"808","Inventory Asset","Invoice","2018-03-12","71049","Lavery Lighting & Design:Store #JL-06","Vianne Lanterns, Satin Antiqued Solid Brass, 3-light wall latern, Candelabra base (60 watt max)","Accounts Receivable",NA,481.43,136090.14
"809","Inventory Asset","Invoice","2018-03-12","71049","Lavery Lighting & Design:Store #JL-06","Athena Collection, Pendant, Textured White, Med. Base, 100 watt max.","Accounts Receivable",NA,360,135730.14
"810","Inventory Asset","Invoice","2018-03-12","71049","Lavery Lighting & Design:Store #JL-06","Pendant Bar, Textured White, 50lbs max","Accounts Receivable",NA,40,135690.14
"811","Inventory Asset","Invoice","2018-03-12","71049","Lavery Lighting & Design:Store #JL-06","Sunset, Clear Glass, 1-100 watt max.","Accounts Receivable",NA,105,135585.14
"812","Inventory Asset","Invoice","2018-03-12","71049","Lavery Lighting & Design:Store #JL-06","Specialty, Stage & Studio Bulbs  60 watt","Accounts Receivable",NA,37.5,135547.64
"813","Inventory Asset","Invoice","2018-03-12","71049","Lavery Lighting & Design:Store #JL-06","Specialty Bulbs, 100 watt (6 pack)","Accounts Receivable",NA,9.5,135538.14
"814","Inventory Asset","Invoice","2018-03-15","71056","Miscellaneous - Retail:Mr. Fred Kaseman","Die Cast Lanterns, Black, 1-100 watt, Medium Base, Clear Cracked Glass","Accounts Receivable",NA,190,135348.14
"815","Inventory Asset","Invoice","2018-03-15","71056","Miscellaneous - Retail:Mr. Fred Kaseman","Black Finish, Solid Brass, Hanging w/Clear Glass (2x60watt max)","Accounts Receivable",NA,120,135228.14
"816","Inventory Asset","Invoice","2018-03-15","71056","Miscellaneous - Retail:Mr. Fred Kaseman","Verona Collection, Pendant, Cobblestone, Etched Alabaster Glass, 150 watt max","Accounts Receivable",NA,280,134948.14
"817","Inventory Asset","Invoice","2018-03-15","71056","Miscellaneous - Retail:Mr. Fred Kaseman","Pendant Bar, Cobblestone, 50lbs. max","Accounts Receivable",NA,45.48,134902.66
"818","Inventory Asset","Invoice","2018-03-15","71056","Miscellaneous - Retail:Mr. Fred Kaseman","Frosted Taupe (3/60 watt)  Marble Glass  ","Accounts Receivable",NA,178.42,134724.24
"819","Inventory Asset","Invoice","2018-03-15","71056","Miscellaneous - Retail:Mr. Fred Kaseman","Broadway Collection, Polished Brass, 6 Light (60 watt max)","Accounts Receivable",NA,90,134634.24
"820","Inventory Asset","Invoice","2018-03-26","71065","Godwin Lighting Depot:Store #303","Vianne Lanterns, Satin Antiqued Solid Brass, 3-light wall latern, Candelabra base (60 watt max)","Accounts Receivable",NA,192.57,134441.67
"821","Inventory Asset","Invoice","2018-03-26","71065","Godwin Lighting Depot:Store #303","Renaissance Collection, (100 watt max) Millstone Finish, One-light","Accounts Receivable",NA,131.82,134309.85
"822","Inventory Asset","Invoice","2018-03-26","71065","Godwin Lighting Depot:Store #303","Drop Opal w/Solid Oak Frame, 49 1/2 x 17, 120v HPF","Accounts Receivable",NA,40,134269.85
"823","Inventory Asset","Invoice","2018-03-26","71065","Godwin Lighting Depot:Store #303","Beveled Mirror, Etched Ribbed Glass (75 watt max)","Accounts Receivable",NA,72.38,134197.47
"824","Inventory Asset","Invoice","2018-03-26","71065","Godwin Lighting Depot:Store #303","Chestnut (3/60 watt)  Marble Glass","Accounts Receivable",NA,195.56,134001.91
"825","Inventory Asset","Invoice","2018-03-26","71065","Godwin Lighting Depot:Store #303","2032 Series, (3-60 watt, Med) Desert Stone Finish","Accounts Receivable",NA,60,133941.91
"826","Inventory Asset","Invoice","2018-03-26","71065","Godwin Lighting Depot:Store #303","Pearl Nickle, 5 Light, Medium Base (100 watt max)","Accounts Receivable",NA,80,133861.91
"827","Inventory Asset","Invoice","2018-03-26","71065","Godwin Lighting Depot:Store #303","Verona Collection, Pendant, Cobblestone, Etched Alabaster Glass, 150 watt max","Accounts Receivable",NA,280,133581.91
"828","Inventory Asset","Invoice","2018-03-26","71065","Godwin Lighting Depot:Store #303","Pendant Bar, Cobblestone, 50lbs. max","Accounts Receivable",NA,45.48,133536.43
"829","Inventory Asset","Invoice","2018-03-26","71065","Godwin Lighting Depot:Store #303","Cand. Light, 20 watts (8 pack)","Accounts Receivable",NA,36,133500.43
"830","Inventory Asset","Invoice","2018-03-26","71065","Godwin Lighting Depot:Store #303","Fluorescent Lamp, T-12, Medium Bipin  (30pack)","Accounts Receivable",NA,6.34,133494.09
"831","Inventory Asset","Invoice","2018-03-26","71065","Godwin Lighting Depot:Store #303","Halogen Lamp, 20 watts, Luminous Intensity","Accounts Receivable",NA,24,133470.09
"832","Inventory Asset","Invoice","2018-03-26","71065","Godwin Lighting Depot:Store #303","Specialty Bulbs, 100 watt (6 pack)","Accounts Receivable",NA,9.5,133460.59
"833","Inventory Asset","Invoice","2018-03-26","71065","Godwin Lighting Depot:Store #303","Specialty, Stage & Studio Bulbs  60 watt","Accounts Receivable",NA,22.5,133438.09
"834","Inventory Asset","Invoice","2018-03-27","71060","Godwin Lighting Depot:Store #404","Black Finish, Solid Brass, Clear Glass, Hanging, 2-60 watt max.","Accounts Receivable",NA,57.57,133380.52
"835","Inventory Asset","Invoice","2018-03-27","71060","Godwin Lighting Depot:Store #404","Black Finish, Solid Brass,Wall Mount w/Clear Glass (2x60watt max)","Accounts Receivable",NA,200,133180.52
"836","Inventory Asset","Invoice","2018-03-27","71060","Godwin Lighting Depot:Store #404","Tapestry (8/60 watt)  Faux Alabaster Glass","Accounts Receivable",NA,150,133030.52
"837","Inventory Asset","Invoice","2018-03-27","71060","Godwin Lighting Depot:Store #404","Athena Collection, (100 watt max) Copper Verde, Seeded Glass","Accounts Receivable",NA,160.71,132869.81
"838","Inventory Asset","Invoice","2018-03-27","71060","Godwin Lighting Depot:Store #404","Broadway Collection, Polished Chrome, 4 Light (60 watt max)","Accounts Receivable",NA,126,132743.81
"839","Inventory Asset","Invoice","2018-03-27","71060","Godwin Lighting Depot:Store #404","Halogen Lamp, Volts:3.5  Tubular","Accounts Receivable",NA,5,132738.81
"840","Inventory Asset","Invoice","2018-03-27","71060","Godwin Lighting Depot:Store #404","Specialty Bulbs, 100 watt (6 pack)","Accounts Receivable",NA,9.5,132729.31
"841","Inventory Asset","Invoice","2018-03-27","71060","Godwin Lighting Depot:Store #404","Specialty, Stage & Studio Bulbs  60 watt","Accounts Receivable",NA,17.5,132711.81
"842","Inventory Asset","Invoice","2018-03-27","71060","Godwin Lighting Depot:Store #404","Fluorescent Lamp, T-12, Medium Bipin  (30pack)","Accounts Receivable",NA,6.34,132705.47
"843","Inventory Asset","Invoice","2018-03-27","71060","Godwin Lighting Depot:Store #404","Domes, White, 59x21x6 5/8 ht, 120v HPF","Accounts Receivable",NA,36,132669.47
"844","Inventory Asset","Invoice","2018-03-28","71071","Dan A. North Builders:McCarthy Properties","Flat Glass, (25 watt max) Polished Brass, 4 light","Accounts Receivable",NA,750,131919.47
"845","Inventory Asset","Invoice","2018-03-28","71071","Dan A. North Builders:McCarthy Properties","Domes, White, 59x21x6 5/8 ht, 120v HPF","Accounts Receivable",NA,1800,130119.47
"846","Inventory Asset","Invoice","2018-03-28","71071","Dan A. North Builders:McCarthy Properties","Flush Mount, Polished Brass (2, 13 watt)  White acrylic diffuser","Accounts Receivable",NA,400,129719.47
"847","Inventory Asset","Invoice","2018-03-28","71071","Dan A. North Builders:McCarthy Properties","Halogen Lamp, Volts:3.5  Tubular","Accounts Receivable",NA,50,129669.47
"848","Inventory Asset","Invoice","2018-03-28","71071","Dan A. North Builders:McCarthy Properties","Fluorescent Lamp, T-5, Bipin","Accounts Receivable",NA,30,129639.47
"849","Inventory Asset","Invoice","2018-03-28","71071","Dan A. North Builders:McCarthy Properties","Fluorescent Lamp, T-12, Medium Bipin  (30pack)","Accounts Receivable",NA,63.43,129576.04
"850","Inventory Asset","Invoice","2018-03-28","71071","Dan A. North Builders:McCarthy Properties","Drop Opal w/Solid Oak Frame, 49 1/2 x 17, 120v HPF","Accounts Receivable",NA,640,128936.04
"851","Inventory Asset","Invoice","2018-03-28","71125","Kern Lighting Warehouse:Store #45","Vianne Lanterns, Satin Antiqued Solid Brass, 3-light wall latern, Candelabra base (60 watt max)","Accounts Receivable",NA,1396.14,127539.9
"852","Inventory Asset","Invoice","2018-03-28","71125","Kern Lighting Warehouse:Store #45","Cand. Light, 20 watts (8 pack)","Accounts Receivable",NA,2400,125139.9
"853","Inventory Asset","Invoice","2018-04-10","71057","Miscellaneous - Retail:Mr. Jay Jessen","Chestnut (3/60 watt)  Marble Glass","Accounts Receivable",NA,293.33,124846.57
"854","Inventory Asset","Invoice","2018-04-10","71057","Miscellaneous - Retail:Mr. Jay Jessen","Domes, White, 59x21x6 5/8 ht, 120v HPF","Accounts Receivable",NA,72,124774.57
"855","Inventory Asset","Invoice","2018-04-10","71057","Miscellaneous - Retail:Mr. Jay Jessen","Drop Opal w/Solid Oak Frame, 49 1/2 x 17, 120v HPF","Accounts Receivable",NA,40,124734.57
"856","Inventory Asset","Invoice","2018-04-13","71126","Kern Lighting Warehouse:Store #13","Golden Umber (100 watt)  Six Light Chandelier","Accounts Receivable",NA,3400,121334.57
"857","Inventory Asset","Bill","2018-04-16","0987","Foster Lighting","Die Cast Lanterns, Black, 1-100 watt, Medium Base, Clear Cracked Glass","Accounts Payable",3900,NA,125234.57
"858","Inventory Asset","Bill","2018-04-16","0987","Foster Lighting","18x8x10, Solid Brass, 3-60watt Medium Base, Satin Etched Glass","Accounts Payable",1650,NA,126884.57
"859","Inventory Asset","Bill","2018-04-16","8284","Hall Lighting & Accessories","Black Finish, Solid Brass, Clear Glass, Hanging, 2-60 watt max.","Accounts Payable",2310,NA,129194.57
"860","Inventory Asset","Bill","2018-04-16","8284","Hall Lighting & Accessories","Sunset, Clear Glass, 1-100 watt max.","Accounts Payable",2187.5,NA,131382.07
"861","Inventory Asset","Bill","2018-04-16","8284","Hall Lighting & Accessories","Beveled Mirror, Etched Ribbed Glass (75 watt max)","Accounts Payable",2250,NA,133632.07
"862","Inventory Asset","Bill","2018-04-16","0987","Paulsen's Lighting","Flat Glass, (25 watt max) Polished Brass, 4 light","Accounts Payable",1225,NA,134857.07
"863","Inventory Asset","Bill","2018-04-16","0987","Paulsen's Lighting","Domes, White, 59x21x6 5/8 ht, 120v HPF","Accounts Payable",1900,NA,136757.07
"864","Inventory Asset","Bill","2018-04-16","0987","Paulsen's Lighting","Flush Mount, Polished Brass (2, 13 watt)  White acrylic diffuser","Accounts Payable",2000,NA,138757.07
"865","Inventory Asset","Bill","2018-04-16","0987","Paulsen's Lighting","Drop Opal w/Solid Oak Frame, 49 1/2 x 17, 120v HPF","Accounts Payable",2150,NA,140907.07
"866","Inventory Asset","Bill","2018-04-16","0987","Paulsen's Lighting","Pendant Bar, Textured White, 50lbs max","Accounts Payable",550,NA,141457.07
"867","Inventory Asset","Invoice","2018-04-16","71087","Cole Home Builders:Phase 1 - Lot 5","Die Cast Lanterns, Black, 1-100 watt, Medium Base, Clear Cracked Glass","Accounts Receivable",NA,231.19,141225.88
"868","Inventory Asset","Invoice","2018-04-16","71087","Cole Home Builders:Phase 1 - Lot 5","Tapestry, (2-60 watt Med), Etched Cracked Glass, Finish 10","Accounts Receivable",NA,90,141135.88
"869","Inventory Asset","Invoice","2018-04-16","71087","Cole Home Builders:Phase 1 - Lot 5","Pearl Nickle, 5 Light, Medium Base (100 watt max)","Accounts Receivable",NA,160,140975.88
"870","Inventory Asset","Invoice","2018-04-16","71087","Cole Home Builders:Phase 1 - Lot 5","Sunset, Clear Glass, 1-100 watt max.","Accounts Receivable",NA,70,140905.88
"871","Inventory Asset","Invoice","2018-04-16","71087","Cole Home Builders:Phase 1 - Lot 5","Black Finish, Solid Brass, Clear Glass, Hanging, 2-60 watt max.","Accounts Receivable",NA,57.66,140848.22
"872","Inventory Asset","Invoice","2018-04-16","71087","Cole Home Builders:Phase 1 - Lot 5","Burnished Brass (60 watt)  w/Golden Umber Accents","Accounts Receivable",NA,75,140773.22
"873","Inventory Asset","Invoice","2018-04-16","71087","Cole Home Builders:Phase 1 - Lot 5","Chestnut (3/60 watt)  Marble Glass","Accounts Receivable",NA,97.78,140675.44
"874","Inventory Asset","Invoice","2018-04-16","71087","Cole Home Builders:Phase 1 - Lot 5","Pendant Bar, Textured White, 50lbs max","Accounts Receivable",NA,10.77,140664.67
"875","Inventory Asset","Invoice","2018-04-16","71087","Cole Home Builders:Phase 1 - Lot 5","Athena Collection, (100 watt max) Copper Verde, Seeded Glass","Accounts Receivable",NA,32.14,140632.53
"876","Inventory Asset","Invoice","2018-04-16","71087","Cole Home Builders:Phase 1 - Lot 5","Cand. Light, 20 watts (8 pack)","Accounts Receivable",NA,24,140608.53
"877","Inventory Asset","Invoice","2018-04-16","71087","Cole Home Builders:Phase 1 - Lot 5","Fluorescent Lamp, T-12, Medium Bipin  (30pack)","Accounts Receivable",NA,6.34,140602.19
"878","Inventory Asset","Invoice","2018-04-16","71087","Cole Home Builders:Phase 1 - Lot 5","Fluorescent Lamp, T-5, Bipin","Accounts Receivable",NA,6,140596.19
"879","Inventory Asset","Invoice","2018-04-16","71087","Cole Home Builders:Phase 1 - Lot 5","Halogen Lamp, Volts:3.5  Tubular","Accounts Receivable",NA,2.5,140593.69
"880","Inventory Asset","Invoice","2018-04-16","71087","Cole Home Builders:Phase 1 - Lot 5","Specialty Bulbs, 100 watt (6 pack)","Accounts Receivable",NA,9.5,140584.19
"881","Inventory Asset","Invoice","2018-04-16","71087","Cole Home Builders:Phase 1 - Lot 5","Specialty, Stage & Studio Bulbs  60 watt","Accounts Receivable",NA,20,140564.19
"882","Inventory Asset","Invoice","2018-04-16","71087","Cole Home Builders:Phase 1 - Lot 5","Flat Glass, (25 watt max) Polished Brass, 4 light","Accounts Receivable",NA,48.49,140515.7
"883","Inventory Asset","Invoice","2018-04-16","71087","Cole Home Builders:Phase 1 - Lot 5","Beveled Mirror, Etched Ribbed Glass (75 watt max)","Accounts Receivable",NA,48.99,140466.71
"884","Inventory Asset","Invoice","2018-04-17","71061","Godwin Lighting Depot:Store #202","Black Finish, Solid Brass, Clear Glass, Hanging, 2-60 watt max.","Accounts Receivable",NA,57.66,140409.05
"885","Inventory Asset","Invoice","2018-04-17","71061","Godwin Lighting Depot:Store #202","Black Finish, Solid Brass,Wall Mount w/Clear Glass (2x60watt max)","Accounts Receivable",NA,200,140209.05
"886","Inventory Asset","Invoice","2018-04-17","71061","Godwin Lighting Depot:Store #202","Tapestry (8/60 watt)  Faux Alabaster Glass","Accounts Receivable",NA,150,140059.05
"887","Inventory Asset","Invoice","2018-04-17","71061","Godwin Lighting Depot:Store #202","Athena Collection, (100 watt max) Copper Verde, Seeded Glass","Accounts Receivable",NA,160.71,139898.34
"888","Inventory Asset","Invoice","2018-04-17","71061","Godwin Lighting Depot:Store #202","Broadway Collection, Polished Chrome, 4 Light (60 watt max)","Accounts Receivable",NA,126,139772.34
"889","Inventory Asset","Invoice","2018-04-17","71061","Godwin Lighting Depot:Store #202","Halogen Lamp, Volts:3.5  Tubular","Accounts Receivable",NA,5,139767.34
"890","Inventory Asset","Invoice","2018-04-17","71061","Godwin Lighting Depot:Store #202","Specialty Bulbs, 100 watt (6 pack)","Accounts Receivable",NA,9.5,139757.84
"891","Inventory Asset","Invoice","2018-04-17","71061","Godwin Lighting Depot:Store #202","Specialty, Stage & Studio Bulbs  60 watt","Accounts Receivable",NA,17.5,139740.34
"892","Inventory Asset","Invoice","2018-04-17","71061","Godwin Lighting Depot:Store #202","Fluorescent Lamp, T-12, Medium Bipin  (30pack)","Accounts Receivable",NA,6.34,139734
"893","Inventory Asset","Invoice","2018-04-17","71061","Godwin Lighting Depot:Store #202","Domes, White, 59x21x6 5/8 ht, 120v HPF","Accounts Receivable",NA,38,139696
"894","Inventory Asset","Invoice","2018-04-22","71064","Godwin Lighting Depot:Store #404","Vianne Lanterns, Satin Antiqued Solid Brass, 3-light wall latern, Candelabra base (60 watt max)","Accounts Receivable",NA,192.57,139503.43
"895","Inventory Asset","Invoice","2018-04-22","71064","Godwin Lighting Depot:Store #404","Renaissance Collection, (100 watt max) Millstone Finish, One-light","Accounts Receivable",NA,131.82,139371.61
"896","Inventory Asset","Invoice","2018-04-22","71064","Godwin Lighting Depot:Store #404","Drop Opal w/Solid Oak Frame, 49 1/2 x 17, 120v HPF","Accounts Receivable",NA,42.88,139328.73
"897","Inventory Asset","Invoice","2018-04-22","71064","Godwin Lighting Depot:Store #404","Beveled Mirror, Etched Ribbed Glass (75 watt max)","Accounts Receivable",NA,73.49,139255.24
"898","Inventory Asset","Invoice","2018-04-22","71064","Godwin Lighting Depot:Store #404","Chestnut (3/60 watt)  Marble Glass","Accounts Receivable",NA,195.56,139059.68
"899","Inventory Asset","Invoice","2018-04-22","71064","Godwin Lighting Depot:Store #404","2032 Series, (3-60 watt, Med) Desert Stone Finish","Accounts Receivable",NA,60,138999.68
"900","Inventory Asset","Invoice","2018-04-22","71064","Godwin Lighting Depot:Store #404","Pearl Nickle, 5 Light, Medium Base (100 watt max)","Accounts Receivable",NA,80,138919.68
"901","Inventory Asset","Invoice","2018-04-22","71064","Godwin Lighting Depot:Store #404","Verona Collection, Pendant, Cobblestone, Etched Alabaster Glass, 150 watt max","Accounts Receivable",NA,280,138639.68
"902","Inventory Asset","Invoice","2018-04-22","71064","Godwin Lighting Depot:Store #404","Pendant Bar, Cobblestone, 50lbs. max","Accounts Receivable",NA,45.48,138594.2
"903","Inventory Asset","Invoice","2018-04-22","71064","Godwin Lighting Depot:Store #404","Cand. Light, 20 watts (8 pack)","Accounts Receivable",NA,36,138558.2
"904","Inventory Asset","Invoice","2018-04-22","71064","Godwin Lighting Depot:Store #404","Fluorescent Lamp, T-12, Medium Bipin  (30pack)","Accounts Receivable",NA,6.34,138551.86
"905","Inventory Asset","Invoice","2018-04-22","71064","Godwin Lighting Depot:Store #404","Halogen Lamp, 20 watts, Luminous Intensity","Accounts Receivable",NA,24,138527.86
"906","Inventory Asset","Invoice","2018-04-22","71064","Godwin Lighting Depot:Store #404","Specialty Bulbs, 100 watt (6 pack)","Accounts Receivable",NA,9.5,138518.36
"907","Inventory Asset","Invoice","2018-04-22","71064","Godwin Lighting Depot:Store #404","Specialty, Stage & Studio Bulbs  60 watt","Accounts Receivable",NA,22.5,138495.86
"908","Inventory Asset","Invoice","2018-04-25","71058","Miscellaneous - Retail:Mrs. Anne Hemp","River Rock (8/60 watt)  Faux Alabaster Glass","Accounts Receivable",NA,150,138345.86
"909","Inventory Asset","Invoice","2018-04-25","71058","Miscellaneous - Retail:Mrs. Anne Hemp","Tiffany Collection,Golden Baroque, 1-light lantern, medium base (100 watt max)","Accounts Receivable",NA,192,138153.86
"910","Inventory Asset","Invoice","2018-04-25","71058","Miscellaneous - Retail:Mrs. Anne Hemp","Brushed Nickel, Pendant, 1-100 watt Medium Base, Satin Etched Glass","Accounts Receivable",NA,100,138053.86
"911","Inventory Asset","Invoice","2018-04-25","71058","Miscellaneous - Retail:Mrs. Anne Hemp","Pendant Bar, Textured White, 50lbs max","Accounts Receivable",NA,21.54,138032.32
"912","Inventory Asset","Invoice","2018-04-25","71058","Miscellaneous - Retail:Mrs. Anne Hemp","Pearl Nickle, 5 Light, Medium Base (100 watt max)","Accounts Receivable",NA,120,137912.32
"913","Inventory Asset","Invoice","2018-04-28","71066","Godwin Lighting Depot:Store #909","Vianne Lanterns, Satin Antiqued Solid Brass, 3-light wall latern, Candelabra base (60 watt max)","Accounts Receivable",NA,192.57,137719.75
"914","Inventory Asset","Invoice","2018-04-28","71066","Godwin Lighting Depot:Store #909","Renaissance Collection, (100 watt max) Millstone Finish, One-light","Accounts Receivable",NA,131.82,137587.93
"915","Inventory Asset","Invoice","2018-04-28","71066","Godwin Lighting Depot:Store #909","Drop Opal w/Solid Oak Frame, 49 1/2 x 17, 120v HPF","Accounts Receivable",NA,42.88,137545.05
"916","Inventory Asset","Invoice","2018-04-28","71066","Godwin Lighting Depot:Store #909","Beveled Mirror, Etched Ribbed Glass (75 watt max)","Accounts Receivable",NA,73.49,137471.56
"917","Inventory Asset","Invoice","2018-04-28","71066","Godwin Lighting Depot:Store #909","Chestnut (3/60 watt)  Marble Glass","Accounts Receivable",NA,195.56,137276
"918","Inventory Asset","Invoice","2018-04-28","71066","Godwin Lighting Depot:Store #909","2032 Series, (3-60 watt, Med) Desert Stone Finish","Accounts Receivable",NA,60,137216
"919","Inventory Asset","Invoice","2018-04-28","71066","Godwin Lighting Depot:Store #909","Pearl Nickle, 5 Light, Medium Base (100 watt max)","Accounts Receivable",NA,80,137136
"920","Inventory Asset","Invoice","2018-04-28","71066","Godwin Lighting Depot:Store #909","Verona Collection, Pendant, Cobblestone, Etched Alabaster Glass, 150 watt max","Accounts Receivable",NA,280,136856
"921","Inventory Asset","Invoice","2018-04-28","71066","Godwin Lighting Depot:Store #909","Pendant Bar, Cobblestone, 50lbs. max","Accounts Receivable",NA,45.48,136810.52
"922","Inventory Asset","Invoice","2018-04-28","71066","Godwin Lighting Depot:Store #909","Cand. Light, 20 watts (8 pack)","Accounts Receivable",NA,36,136774.52
"923","Inventory Asset","Invoice","2018-04-28","71066","Godwin Lighting Depot:Store #909","Fluorescent Lamp, T-12, Medium Bipin  (30pack)","Accounts Receivable",NA,6.34,136768.18
"924","Inventory Asset","Invoice","2018-04-28","71066","Godwin Lighting Depot:Store #909","Halogen Lamp, 20 watts, Luminous Intensity","Accounts Receivable",NA,24,136744.18
"925","Inventory Asset","Invoice","2018-04-28","71066","Godwin Lighting Depot:Store #909","Specialty Bulbs, 100 watt (6 pack)","Accounts Receivable",NA,9.5,136734.68
"926","Inventory Asset","Invoice","2018-04-28","71066","Godwin Lighting Depot:Store #909","Specialty, Stage & Studio Bulbs  60 watt","Accounts Receivable",NA,22.5,136712.18
"927","Inventory Asset","Invoice","2018-04-28","71067","Dan A. North Builders:Wagner Suites","Colonial, Brushed Steel Finish, Opal White Glass (60 watt)","Accounts Receivable",NA,1000,135712.18
"928","Inventory Asset","Invoice","2018-04-28","71067","Dan A. North Builders:Wagner Suites","Beveled Mirror, Etched Ribbed Glass (75 watt max)","Accounts Receivable",NA,1224.85,134487.33
"929","Inventory Asset","Invoice","2018-04-28","71067","Dan A. North Builders:Wagner Suites","Specialty, Stage & Studio Bulbs  60 watt","Accounts Receivable",NA,25,134462.33
"930","Inventory Asset","Invoice","2018-04-28","71067","Dan A. North Builders:Wagner Suites","Specialty Bulbs, 100 watt (6 pack)","Accounts Receivable",NA,118.75,134343.58
"931","Inventory Asset","Invoice","2018-04-28","71067","Dan A. North Builders:Wagner Suites","Flush Mount, Polished Brass (2, 13 watt)  White acrylic diffuser","Accounts Receivable",NA,1602.9,132740.68
"932","Inventory Asset","Invoice","2018-04-28","71067","Dan A. North Builders:Wagner Suites","Fluorescent Lamp, T-12, Medium Bipin  (30pack)","Accounts Receivable",NA,31.71,132708.97
"933","Inventory Asset","Bill","2018-04-30","765-06","Foster Lighting","Acid Verde, 10x21x10, 2-60 watt cand.","Accounts Payable",600,NA,133308.97
"934","Inventory Asset","Bill","2018-04-30","765-06","Foster Lighting","2032 Series, (3-60 watt, Med) Desert Stone Finish","Accounts Payable",540,NA,133848.97
"935","Inventory Asset","Bill","2018-04-30","765-06","Foster Lighting","Tapestry, (2-60 watt Med), Etched Cracked Glass, Finish 10","Accounts Payable",750,NA,134598.97
"936","Inventory Asset","Bill","2018-04-30","765-06","Foster Lighting","Chestnut (3/60 watt)  Marble Glass","Accounts Payable",950,NA,135548.97
"937","Inventory Asset","Invoice","2018-05-02","71062","Godwin Lighting Depot:Store #404","Black Finish, Solid Brass, Clear Glass, Hanging, 2-60 watt max.","Accounts Receivable",NA,57.66,135491.31
"938","Inventory Asset","Invoice","2018-05-02","71062","Godwin Lighting Depot:Store #404","Black Finish, Solid Brass,Wall Mount w/Clear Glass (2x60watt max)","Accounts Receivable",NA,200,135291.31
"939","Inventory Asset","Invoice","2018-05-02","71062","Godwin Lighting Depot:Store #404","Tapestry (8/60 watt)  Faux Alabaster Glass","Accounts Receivable",NA,150,135141.31
"940","Inventory Asset","Invoice","2018-05-02","71062","Godwin Lighting Depot:Store #404","Athena Collection, (100 watt max) Copper Verde, Seeded Glass","Accounts Receivable",NA,160.71,134980.6
"941","Inventory Asset","Invoice","2018-05-02","71062","Godwin Lighting Depot:Store #404","Broadway Collection, Polished Chrome, 4 Light (60 watt max)","Accounts Receivable",NA,126,134854.6
"942","Inventory Asset","Invoice","2018-05-02","71062","Godwin Lighting Depot:Store #404","Halogen Lamp, Volts:3.5  Tubular","Accounts Receivable",NA,5,134849.6
"943","Inventory Asset","Invoice","2018-05-02","71062","Godwin Lighting Depot:Store #404","Specialty Bulbs, 100 watt (6 pack)","Accounts Receivable",NA,9.5,134840.1
"944","Inventory Asset","Invoice","2018-05-02","71062","Godwin Lighting Depot:Store #404","Specialty, Stage & Studio Bulbs  60 watt","Accounts Receivable",NA,17.5,134822.6
"945","Inventory Asset","Invoice","2018-05-02","71062","Godwin Lighting Depot:Store #404","Fluorescent Lamp, T-12, Medium Bipin  (30pack)","Accounts Receivable",NA,6.34,134816.26
"946","Inventory Asset","Invoice","2018-05-02","71062","Godwin Lighting Depot:Store #404","Domes, White, 59x21x6 5/8 ht, 120v HPF","Accounts Receivable",NA,38,134778.26
"947","Inventory Asset","Invoice","2018-05-09","71111","Baker's Professional Lighting:Store #10","Acid Verde, 10x21x10, 2-60 watt cand.","Accounts Receivable",NA,240,134538.26
"948","Inventory Asset","Invoice","2018-05-09","71111","Baker's Professional Lighting:Store #10","Beveled Mirror, Etched Ribbed Glass (75 watt max)","Accounts Receivable",NA,122.49,134415.77
"949","Inventory Asset","Invoice","2018-05-09","71111","Baker's Professional Lighting:Store #10","Golden Umber (100 watt)  Six Light Chandelier","Accounts Receivable",NA,170,134245.77
"950","Inventory Asset","Invoice","2018-05-09","71111","Baker's Professional Lighting:Store #10","Burnished Brass (60 watt)  w/Golden Umber Accents","Accounts Receivable",NA,150,134095.77
"951","Inventory Asset","Invoice","2018-05-09","71111","Baker's Professional Lighting:Store #10","Specialty Bulbs, 100 watt (6 pack)","Accounts Receivable",NA,9.5,134086.27
"952","Inventory Asset","Invoice","2018-05-09","71111","Baker's Professional Lighting:Store #10","Specialty, Stage & Studio Bulbs  60 watt","Accounts Receivable",NA,10,134076.27
"953","Inventory Asset","Invoice","2018-05-09","71111","Baker's Professional Lighting:Store #10","Cand. Light, 20 watts (8 pack)","Accounts Receivable",NA,24,134052.27
"954","Inventory Asset","Invoice","2018-05-10","71068","Godwin Lighting Depot:Store #909","Vianne Lanterns, Satin Antiqued Solid Brass, 3-light wall latern, Candelabra base (60 watt max)","Accounts Receivable",NA,192.57,133859.7
"955","Inventory Asset","Invoice","2018-05-10","71068","Godwin Lighting Depot:Store #909","Renaissance Collection, (100 watt max) Millstone Finish, One-light","Accounts Receivable",NA,131.82,133727.88
"956","Inventory Asset","Invoice","2018-05-10","71068","Godwin Lighting Depot:Store #909","Drop Opal w/Solid Oak Frame, 49 1/2 x 17, 120v HPF","Accounts Receivable",NA,42.88,133685
"957","Inventory Asset","Invoice","2018-05-10","71068","Godwin Lighting Depot:Store #909","Beveled Mirror, Etched Ribbed Glass (75 watt max)","Accounts Receivable",NA,73.49,133611.51
"958","Inventory Asset","Invoice","2018-05-10","71068","Godwin Lighting Depot:Store #909","Chestnut (3/60 watt)  Marble Glass","Accounts Receivable",NA,194.4,133417.11
"959","Inventory Asset","Invoice","2018-05-10","71068","Godwin Lighting Depot:Store #909","2032 Series, (3-60 watt, Med) Desert Stone Finish","Accounts Receivable",NA,60,133357.11
"960","Inventory Asset","Invoice","2018-05-10","71068","Godwin Lighting Depot:Store #909","Pearl Nickle, 5 Light, Medium Base (100 watt max)","Accounts Receivable",NA,80,133277.11
"961","Inventory Asset","Invoice","2018-05-10","71068","Godwin Lighting Depot:Store #909","Verona Collection, Pendant, Cobblestone, Etched Alabaster Glass, 150 watt max","Accounts Receivable",NA,280,132997.11
"962","Inventory Asset","Invoice","2018-05-10","71068","Godwin Lighting Depot:Store #909","Pendant Bar, Cobblestone, 50lbs. max","Accounts Receivable",NA,45.48,132951.63
"963","Inventory Asset","Invoice","2018-05-10","71068","Godwin Lighting Depot:Store #909","Cand. Light, 20 watts (8 pack)","Accounts Receivable",NA,36,132915.63
"964","Inventory Asset","Invoice","2018-05-10","71068","Godwin Lighting Depot:Store #909","Fluorescent Lamp, T-12, Medium Bipin  (30pack)","Accounts Receivable",NA,6.34,132909.29
"965","Inventory Asset","Invoice","2018-05-10","71068","Godwin Lighting Depot:Store #909","Halogen Lamp, 20 watts, Luminous Intensity","Accounts Receivable",NA,24,132885.29
"966","Inventory Asset","Invoice","2018-05-10","71068","Godwin Lighting Depot:Store #909","Specialty Bulbs, 100 watt (6 pack)","Accounts Receivable",NA,9.5,132875.79
"967","Inventory Asset","Invoice","2018-05-10","71068","Godwin Lighting Depot:Store #909","Specialty, Stage & Studio Bulbs  60 watt","Accounts Receivable",NA,22.5,132853.29
"968","Inventory Asset","Invoice","2018-05-16","71095","Miscellaneous - Retail:Carlos Nazar","Acid Verde, 10x21x10, 2-60 watt cand.","Accounts Receivable",NA,300,132553.29
"969","Inventory Asset","Invoice","2018-05-16","71095","Miscellaneous - Retail:Carlos Nazar","Frosted Taupe (3/60 watt)  Marble Glass  ","Accounts Receivable",NA,178.42,132374.87
"970","Inventory Asset","Invoice","2018-05-16","71095","Miscellaneous - Retail:Carlos Nazar","Black Finish, Solid Brass, Clear Glass, Hanging, 2-60 watt max.","Accounts Receivable",NA,76.88,132297.99
"971","Inventory Asset","Invoice","2018-05-16","71095","Miscellaneous - Retail:Carlos Nazar","Beveled Mirror, Etched Ribbed Glass (75 watt max)","Accounts Receivable",NA,97.99,132200
"972","Inventory Asset","Invoice","2018-05-16","71095","Miscellaneous - Retail:Carlos Nazar","Athena Collection, Pendant, Textured White, Med. Base, 100 watt max.","Accounts Receivable",NA,180,132020
"973","Inventory Asset","Invoice","2018-05-16","71095","Miscellaneous - Retail:Carlos Nazar","Pendant Bar, Cobblestone, 50lbs. max","Accounts Receivable",NA,34.11,131985.89
"974","Inventory Asset","Invoice","2018-05-16","71113","Thompson Lighting Stores:Store #20","Acid Verde, 10x21x10, 2-60 watt cand.","Accounts Receivable",NA,180,131805.89
"975","Inventory Asset","Invoice","2018-05-16","71113","Thompson Lighting Stores:Store #20","Die Cast Lanterns, Black, 1-100 watt, Medium Base, Clear Cracked Glass","Accounts Receivable",NA,154.13,131651.76
"976","Inventory Asset","Invoice","2018-05-16","71113","Thompson Lighting Stores:Store #20","Polished Brass Pendant, 1-100 watt Medium Base, Clear Ribbed Glass","Accounts Receivable",NA,128,131523.76
"977","Inventory Asset","Invoice","2018-05-16","71113","Thompson Lighting Stores:Store #20","2032 Series, (3-60 watt, Med) Desert Stone Finish","Accounts Receivable",NA,48,131475.76
"978","Inventory Asset","Invoice","2018-05-16","71113","Thompson Lighting Stores:Store #20","Brushed Nickel, 18x7.75x6, 3-60 watt Medium Base, Satin Opal Glass","Accounts Receivable",NA,74,131401.76
"979","Inventory Asset","Invoice","2018-05-16","71113","Thompson Lighting Stores:Store #20","Tapestry (8/60 watt)  Faux Alabaster Glass","Accounts Receivable",NA,75,131326.76
"980","Inventory Asset","Invoice","2018-05-16","71113","Thompson Lighting Stores:Store #20","Frosted Taupe (3/60 watt)  Marble Glass  ","Accounts Receivable",NA,89.21,131237.55
"981","Inventory Asset","Invoice","2018-05-16","71113","Thompson Lighting Stores:Store #20","Roman Bronze, 1-light Lantern, w/tail, (100 watt max)","Accounts Receivable",NA,152,131085.55
"982","Inventory Asset","Invoice","2018-05-16","71113","Thompson Lighting Stores:Store #20","Domes, White, 59x21x6 5/8 ht, 120v HPF","Accounts Receivable",NA,57,131028.55
"983","Inventory Asset","Invoice","2018-05-16","71113","Thompson Lighting Stores:Store #20","Flat Glass, (25 watt max) Polished Brass, 4 light","Accounts Receivable",NA,60.61,130967.94
"984","Inventory Asset","Invoice","2018-05-16","71113","Thompson Lighting Stores:Store #20","Burnished Brass (60 watt)  w/Golden Umber Accents","Accounts Receivable",NA,75,130892.94
"985","Inventory Asset","Invoice","2018-05-16","71113","Thompson Lighting Stores:Store #20","Pearl Nickle, 5 Light, Medium Base (100 watt max)","Accounts Receivable",NA,200,130692.94
"986","Inventory Asset","Invoice","2018-05-18","71084","Cole Home Builders:Phase 1 - Lot 5","Acid Verde, 10x21x10, 2-60 watt cand.","Accounts Receivable",NA,60,130632.94
"987","Inventory Asset","Invoice","2018-05-18","71084","Cole Home Builders:Phase 1 - Lot 5","Sunset, Clear Glass, 1-100 watt max.","Accounts Receivable",NA,52.5,130580.44
"988","Inventory Asset","Invoice","2018-05-18","71084","Cole Home Builders:Phase 1 - Lot 5","Tapestry (8/60 watt)  Faux Alabaster Glass","Accounts Receivable",NA,75,130505.44
"989","Inventory Asset","Invoice","2018-05-18","71084","Cole Home Builders:Phase 1 - Lot 5","Chestnut (3/60 watt)  Marble Glass","Accounts Receivable",NA,97.2,130408.24
"990","Inventory Asset","Invoice","2018-05-18","71084","Cole Home Builders:Phase 1 - Lot 5","Tiffany Collection,Golden Baroque, 1-light lantern, medium base (100 watt max)","Accounts Receivable",NA,96,130312.24
"991","Inventory Asset","Invoice","2018-05-18","71084","Cole Home Builders:Phase 1 - Lot 5","2032 Series, (3-60 watt, Med) Desert Stone Finish","Accounts Receivable",NA,36,130276.24
"992","Inventory Asset","Invoice","2018-05-18","71084","Cole Home Builders:Phase 1 - Lot 5","Tapestry, (2-60 watt Med), Etched Cracked Glass, Finish 10","Accounts Receivable",NA,30,130246.24
"993","Inventory Asset","Invoice","2018-05-18","71084","Cole Home Builders:Phase 1 - Lot 5","18x8x10, Solid Brass, 3-60watt Medium Base, Satin Etched Glass","Accounts Receivable",NA,65.19,130181.05
"994","Inventory Asset","Invoice","2018-05-18","71084","Cole Home Builders:Phase 1 - Lot 5","White, 4.5x7.5, 1-100 watt Medium Base, Satin White Glass","Accounts Receivable",NA,45,130136.05
"995","Inventory Asset","Invoice","2018-05-18","71084","Cole Home Builders:Phase 1 - Lot 5","Drop Opal w/Solid Oak Frame, 49 1/2 x 17, 120v HPF","Accounts Receivable",NA,64.33,130071.72
"996","Inventory Asset","Invoice","2018-05-18","71084","Cole Home Builders:Phase 1 - Lot 5","Verona Collection, Pendant, Cobblestone, Etched Alabaster Glass, 150 watt max","Accounts Receivable",NA,70,130001.72
"997","Inventory Asset","Invoice","2018-05-18","71084","Cole Home Builders:Phase 1 - Lot 5","Fluorescent Lamp, T-12, Medium Bipin  (30pack)","Accounts Receivable",NA,6.34,129995.38
"998","Inventory Asset","Invoice","2018-05-18","71084","Cole Home Builders:Phase 1 - Lot 5","Specialty Bulbs, 100 watt (6 pack)","Accounts Receivable",NA,23.75,129971.63
"999","Inventory Asset","Invoice","2018-05-18","71084","Cole Home Builders:Phase 1 - Lot 5","Specialty, Stage & Studio Bulbs  60 watt","Accounts Receivable",NA,15,129956.63
"1000","Inventory Asset","Invoice","2018-05-19","71063","Godwin Lighting Depot:Store #404","Black Finish, Solid Brass, Clear Glass, Hanging, 2-60 watt max.","Accounts Receivable",NA,57.66,129898.97
"1001","Inventory Asset","Invoice","2018-05-19","71063","Godwin Lighting Depot:Store #404","Black Finish, Solid Brass,Wall Mount w/Clear Glass (2x60watt max)","Accounts Receivable",NA,200,129698.97
"1002","Inventory Asset","Invoice","2018-05-19","71063","Godwin Lighting Depot:Store #404","Tapestry (8/60 watt)  Faux Alabaster Glass","Accounts Receivable",NA,150,129548.97
"1003","Inventory Asset","Invoice","2018-05-19","71063","Godwin Lighting Depot:Store #404","Athena Collection, (100 watt max) Copper Verde, Seeded Glass","Accounts Receivable",NA,160.71,129388.26
"1004","Inventory Asset","Invoice","2018-05-19","71063","Godwin Lighting Depot:Store #404","Broadway Collection, Polished Chrome, 4 Light (60 watt max)","Accounts Receivable",NA,126,129262.26
"1005","Inventory Asset","Invoice","2018-05-19","71063","Godwin Lighting Depot:Store #404","Halogen Lamp, Volts:3.5  Tubular","Accounts Receivable",NA,5,129257.26
"1006","Inventory Asset","Invoice","2018-05-19","71063","Godwin Lighting Depot:Store #404","Specialty Bulbs, 100 watt (6 pack)","Accounts Receivable",NA,9.5,129247.76
"1007","Inventory Asset","Invoice","2018-05-19","71063","Godwin Lighting Depot:Store #404","Specialty, Stage & Studio Bulbs  60 watt","Accounts Receivable",NA,17.5,129230.26
"1008","Inventory Asset","Invoice","2018-05-19","71063","Godwin Lighting Depot:Store #404","Fluorescent Lamp, T-12, Medium Bipin  (30pack)","Accounts Receivable",NA,6.34,129223.92
"1009","Inventory Asset","Invoice","2018-05-19","71063","Godwin Lighting Depot:Store #404","Domes, White, 59x21x6 5/8 ht, 120v HPF","Accounts Receivable",NA,38,129185.92
"1010","Inventory Asset","Invoice","2018-05-22","71127","Kern Lighting Warehouse:Store #34","Domes, White, 59x21x6 5/8 ht, 120v HPF","Accounts Receivable",NA,2850,126335.92
"1011","Inventory Asset","Invoice","2018-05-22","71127","Kern Lighting Warehouse:Store #34","Flush Mount, Polished Brass (2, 13 watt)  White acrylic diffuser","Accounts Receivable",NA,915.94,125419.98
"1012","Inventory Asset","Invoice","2018-05-22","71127","Kern Lighting Warehouse:Store #34","Tiffany Collection,Golden Baroque, 1-light lantern, medium base (100 watt max)","Accounts Receivable",NA,144,125275.98
"1013","Inventory Asset","Invoice","2018-05-24","71086","Cole Home Builders:Phase 1 - Lot 4","Die Cast Lanterns, Black, 1-100 watt, Medium Base, Clear Cracked Glass","Accounts Receivable",NA,231.19,125044.79
"1014","Inventory Asset","Invoice","2018-05-24","71086","Cole Home Builders:Phase 1 - Lot 4","Tapestry, (2-60 watt Med), Etched Cracked Glass, Finish 10","Accounts Receivable",NA,90,124954.79
"1015","Inventory Asset","Invoice","2018-05-24","71086","Cole Home Builders:Phase 1 - Lot 4","Pearl Nickle, 5 Light, Medium Base (100 watt max)","Accounts Receivable",NA,160,124794.79
"1016","Inventory Asset","Invoice","2018-05-24","71086","Cole Home Builders:Phase 1 - Lot 4","Sunset, Clear Glass, 1-100 watt max.","Accounts Receivable",NA,70,124724.79
"1017","Inventory Asset","Invoice","2018-05-24","71086","Cole Home Builders:Phase 1 - Lot 4","Black Finish, Solid Brass, Clear Glass, Hanging, 2-60 watt max.","Accounts Receivable",NA,57.66,124667.13
"1018","Inventory Asset","Invoice","2018-05-24","71086","Cole Home Builders:Phase 1 - Lot 4","Burnished Brass (60 watt)  w/Golden Umber Accents","Accounts Receivable",NA,75,124592.13
"1019","Inventory Asset","Invoice","2018-05-24","71086","Cole Home Builders:Phase 1 - Lot 4","Chestnut (3/60 watt)  Marble Glass","Accounts Receivable",NA,97.2,124494.93
"1020","Inventory Asset","Invoice","2018-05-24","71086","Cole Home Builders:Phase 1 - Lot 4","Pendant Bar, Textured White, 50lbs max","Accounts Receivable",NA,10.77,124484.16
"1021","Inventory Asset","Invoice","2018-05-24","71086","Cole Home Builders:Phase 1 - Lot 4","Athena Collection, (100 watt max) Copper Verde, Seeded Glass","Accounts Receivable",NA,32.14,124452.02
"1022","Inventory Asset","Invoice","2018-05-24","71086","Cole Home Builders:Phase 1 - Lot 4","Cand. Light, 20 watts (8 pack)","Accounts Receivable",NA,24,124428.02
"1023","Inventory Asset","Invoice","2018-05-24","71086","Cole Home Builders:Phase 1 - Lot 4","Fluorescent Lamp, T-12, Medium Bipin  (30pack)","Accounts Receivable",NA,6.34,124421.68
"1024","Inventory Asset","Invoice","2018-05-24","71086","Cole Home Builders:Phase 1 - Lot 4","Fluorescent Lamp, T-5, Bipin","Accounts Receivable",NA,6,124415.68
"1025","Inventory Asset","Invoice","2018-05-24","71086","Cole Home Builders:Phase 1 - Lot 4","Halogen Lamp, Volts:3.5  Tubular","Accounts Receivable",NA,2.5,124413.18
"1026","Inventory Asset","Invoice","2018-05-24","71086","Cole Home Builders:Phase 1 - Lot 4","Specialty Bulbs, 100 watt (6 pack)","Accounts Receivable",NA,9.5,124403.68
"1027","Inventory Asset","Invoice","2018-05-24","71086","Cole Home Builders:Phase 1 - Lot 4","Specialty, Stage & Studio Bulbs  60 watt","Accounts Receivable",NA,20,124383.68
"1028","Inventory Asset","Invoice","2018-05-24","71086","Cole Home Builders:Phase 1 - Lot 4","Flat Glass, (25 watt max) Polished Brass, 4 light","Accounts Receivable",NA,48.49,124335.19
"1029","Inventory Asset","Invoice","2018-05-24","71086","Cole Home Builders:Phase 1 - Lot 4","Beveled Mirror, Etched Ribbed Glass (75 watt max)","Accounts Receivable",NA,48.99,124286.2
"1030","Inventory Asset","Invoice","2018-05-30","71069","Godwin Lighting Depot:Store #1020","Vianne Lanterns, Satin Antiqued Solid Brass, 3-light wall latern, Candelabra base (60 watt max)","Accounts Receivable",NA,192.57,124093.63
"1031","Inventory Asset","Invoice","2018-05-30","71069","Godwin Lighting Depot:Store #1020","Renaissance Collection, (100 watt max) Millstone Finish, One-light","Accounts Receivable",NA,131.82,123961.81
"1032","Inventory Asset","Invoice","2018-05-30","71069","Godwin Lighting Depot:Store #1020","Drop Opal w/Solid Oak Frame, 49 1/2 x 17, 120v HPF","Accounts Receivable",NA,42.88,123918.93
"1033","Inventory Asset","Invoice","2018-05-30","71069","Godwin Lighting Depot:Store #1020","Beveled Mirror, Etched Ribbed Glass (75 watt max)","Accounts Receivable",NA,73.49,123845.44
"1034","Inventory Asset","Invoice","2018-05-30","71069","Godwin Lighting Depot:Store #1020","Chestnut (3/60 watt)  Marble Glass","Accounts Receivable",NA,194.4,123651.04
"1035","Inventory Asset","Invoice","2018-05-30","71069","Godwin Lighting Depot:Store #1020","2032 Series, (3-60 watt, Med) Desert Stone Finish","Accounts Receivable",NA,60,123591.04
"1036","Inventory Asset","Invoice","2018-05-30","71069","Godwin Lighting Depot:Store #1020","Pearl Nickle, 5 Light, Medium Base (100 watt max)","Accounts Receivable",NA,80,123511.04
"1037","Inventory Asset","Invoice","2018-05-30","71069","Godwin Lighting Depot:Store #1020","Verona Collection, Pendant, Cobblestone, Etched Alabaster Glass, 150 watt max","Accounts Receivable",NA,280,123231.04
"1038","Inventory Asset","Invoice","2018-05-30","71069","Godwin Lighting Depot:Store #1020","Pendant Bar, Cobblestone, 50lbs. max","Accounts Receivable",NA,45.48,123185.56
"1039","Inventory Asset","Invoice","2018-05-30","71069","Godwin Lighting Depot:Store #1020","Cand. Light, 20 watts (8 pack)","Accounts Receivable",NA,36,123149.56
"1040","Inventory Asset","Invoice","2018-05-30","71069","Godwin Lighting Depot:Store #1020","Fluorescent Lamp, T-12, Medium Bipin  (30pack)","Accounts Receivable",NA,6.34,123143.22
"1041","Inventory Asset","Invoice","2018-05-30","71069","Godwin Lighting Depot:Store #1020","Halogen Lamp, 20 watts, Luminous Intensity","Accounts Receivable",NA,24,123119.22
"1042","Inventory Asset","Invoice","2018-05-30","71069","Godwin Lighting Depot:Store #1020","Specialty Bulbs, 100 watt (6 pack)","Accounts Receivable",NA,9.5,123109.72
"1043","Inventory Asset","Invoice","2018-05-30","71069","Godwin Lighting Depot:Store #1020","Specialty, Stage & Studio Bulbs  60 watt","Accounts Receivable",NA,22.5,123087.22
"1044","Inventory Asset","Invoice","2018-05-31","71083","Cole Home Builders:Phase 2 - Lot 5","Acid Verde, 10x21x10, 2-60 watt cand.","Accounts Receivable",NA,60,123027.22
"1045","Inventory Asset","Invoice","2018-05-31","71083","Cole Home Builders:Phase 2 - Lot 5","Sunset, Clear Glass, 1-100 watt max.","Accounts Receivable",NA,52.5,122974.72
"1046","Inventory Asset","Invoice","2018-05-31","71083","Cole Home Builders:Phase 2 - Lot 5","Tapestry (8/60 watt)  Faux Alabaster Glass","Accounts Receivable",NA,75,122899.72
"1047","Inventory Asset","Invoice","2018-05-31","71083","Cole Home Builders:Phase 2 - Lot 5","Chestnut (3/60 watt)  Marble Glass","Accounts Receivable",NA,97.2,122802.52
"1048","Inventory Asset","Invoice","2018-05-31","71083","Cole Home Builders:Phase 2 - Lot 5","Tiffany Collection,Golden Baroque, 1-light lantern, medium base (100 watt max)","Accounts Receivable",NA,96,122706.52
"1049","Inventory Asset","Invoice","2018-05-31","71083","Cole Home Builders:Phase 2 - Lot 5","2032 Series, (3-60 watt, Med) Desert Stone Finish","Accounts Receivable",NA,36,122670.52
"1050","Inventory Asset","Invoice","2018-05-31","71083","Cole Home Builders:Phase 2 - Lot 5","Tapestry, (2-60 watt Med), Etched Cracked Glass, Finish 10","Accounts Receivable",NA,30,122640.52
"1051","Inventory Asset","Invoice","2018-05-31","71083","Cole Home Builders:Phase 2 - Lot 5","18x8x10, Solid Brass, 3-60watt Medium Base, Satin Etched Glass","Accounts Receivable",NA,65.19,122575.33
"1052","Inventory Asset","Invoice","2018-05-31","71083","Cole Home Builders:Phase 2 - Lot 5","White, 4.5x7.5, 1-100 watt Medium Base, Satin White Glass","Accounts Receivable",NA,45,122530.33
"1053","Inventory Asset","Invoice","2018-05-31","71083","Cole Home Builders:Phase 2 - Lot 5","Drop Opal w/Solid Oak Frame, 49 1/2 x 17, 120v HPF","Accounts Receivable",NA,64.33,122466
"1054","Inventory Asset","Invoice","2018-05-31","71083","Cole Home Builders:Phase 2 - Lot 5","Verona Collection, Pendant, Cobblestone, Etched Alabaster Glass, 150 watt max","Accounts Receivable",NA,70,122396
"1055","Inventory Asset","Invoice","2018-05-31","71083","Cole Home Builders:Phase 2 - Lot 5","Fluorescent Lamp, T-12, Medium Bipin  (30pack)","Accounts Receivable",NA,6.34,122389.66
"1056","Inventory Asset","Invoice","2018-05-31","71083","Cole Home Builders:Phase 2 - Lot 5","Specialty Bulbs, 100 watt (6 pack)","Accounts Receivable",NA,23.75,122365.91
"1057","Inventory Asset","Invoice","2018-05-31","71083","Cole Home Builders:Phase 2 - Lot 5","Specialty, Stage & Studio Bulbs  60 watt","Accounts Receivable",NA,15,122350.91
"1058","Inventory Asset","Invoice","2018-06-05","71096","Miscellaneous - Retail:Anne Loomis","Die Cast Lanterns, Black, 1-100 watt, Medium Base, Clear Cracked Glass","Accounts Receivable",NA,385.32,121965.59
"1059","Inventory Asset","Invoice","2018-06-05","71096","Miscellaneous - Retail:Anne Loomis","Brushed Nickel, Pendant, 1-100 watt Medium Base, Satin Etched Glass","Accounts Receivable",NA,250,121715.59
"1060","Inventory Asset","Invoice","2018-06-05","71096","Miscellaneous - Retail:Anne Loomis","Colonial, Brushed Steel Finish, Opal White Glass (60 watt)","Accounts Receivable",NA,40,121675.59
"1061","Inventory Asset","Invoice","2018-06-05","71096","Miscellaneous - Retail:Anne Loomis","Solid Brass, 4-light, 25x13x10.75, 4-60 watt, Medium Base, Satin Etched Glass","Accounts Receivable",NA,76,121599.59
"1062","Inventory Asset","Invoice","2018-06-05","71096","Miscellaneous - Retail:Anne Loomis","Drop Opal w/Solid Oak Frame, 49 1/2 x 17, 120v HPF","Accounts Receivable",NA,64.33,121535.26
"1063","Inventory Asset","Bill","2018-06-07","90897","Foster Lighting","White, 4.5x7.5, 1-100 watt Medium Base, Satin White Glass","Accounts Payable",750,NA,122285.26
"1064","Inventory Asset","Bill","2018-06-07","90897","Foster Lighting","Acid Verde, 10x21x10, 2-60 watt cand.","Accounts Payable",2400,NA,124685.26
"1065","Inventory Asset","Bill","2018-06-07","45674","Paulsen's Lighting","Verona Collection, Pendant, Cobblestone, Etched Alabaster Glass, 150 watt max","Accounts Payable",3500,NA,128185.26
"1066","Inventory Asset","Invoice","2018-06-07","71085","Cole Home Builders:Phase 1 - Lot 5","Die Cast Lanterns, Black, 1-100 watt, Medium Base, Clear Cracked Glass","Accounts Receivable",NA,231.19,127954.07
"1067","Inventory Asset","Invoice","2018-06-07","71085","Cole Home Builders:Phase 1 - Lot 5","Tapestry, (2-60 watt Med), Etched Cracked Glass, Finish 10","Accounts Receivable",NA,90,127864.07
"1068","Inventory Asset","Invoice","2018-06-07","71085","Cole Home Builders:Phase 1 - Lot 5","Pearl Nickle, 5 Light, Medium Base (100 watt max)","Accounts Receivable",NA,160,127704.07
"1069","Inventory Asset","Invoice","2018-06-07","71085","Cole Home Builders:Phase 1 - Lot 5","Sunset, Clear Glass, 1-100 watt max.","Accounts Receivable",NA,70,127634.07
"1070","Inventory Asset","Invoice","2018-06-07","71085","Cole Home Builders:Phase 1 - Lot 5","Black Finish, Solid Brass, Clear Glass, Hanging, 2-60 watt max.","Accounts Receivable",NA,57.66,127576.41
"1071","Inventory Asset","Invoice","2018-06-07","71085","Cole Home Builders:Phase 1 - Lot 5","Burnished Brass (60 watt)  w/Golden Umber Accents","Accounts Receivable",NA,75,127501.41
"1072","Inventory Asset","Invoice","2018-06-07","71085","Cole Home Builders:Phase 1 - Lot 5","Chestnut (3/60 watt)  Marble Glass","Accounts Receivable",NA,97.2,127404.21
"1073","Inventory Asset","Invoice","2018-06-07","71085","Cole Home Builders:Phase 1 - Lot 5","Pendant Bar, Textured White, 50lbs max","Accounts Receivable",NA,10.77,127393.44
"1074","Inventory Asset","Invoice","2018-06-07","71085","Cole Home Builders:Phase 1 - Lot 5","Athena Collection, (100 watt max) Copper Verde, Seeded Glass","Accounts Receivable",NA,32.14,127361.3
"1075","Inventory Asset","Invoice","2018-06-07","71085","Cole Home Builders:Phase 1 - Lot 5","Cand. Light, 20 watts (8 pack)","Accounts Receivable",NA,24,127337.3
"1076","Inventory Asset","Invoice","2018-06-07","71085","Cole Home Builders:Phase 1 - Lot 5","Fluorescent Lamp, T-12, Medium Bipin  (30pack)","Accounts Receivable",NA,6.34,127330.96
"1077","Inventory Asset","Invoice","2018-06-07","71085","Cole Home Builders:Phase 1 - Lot 5","Fluorescent Lamp, T-5, Bipin","Accounts Receivable",NA,6,127324.96
"1078","Inventory Asset","Invoice","2018-06-07","71085","Cole Home Builders:Phase 1 - Lot 5","Halogen Lamp, Volts:3.5  Tubular","Accounts Receivable",NA,2.5,127322.46
"1079","Inventory Asset","Invoice","2018-06-07","71085","Cole Home Builders:Phase 1 - Lot 5","Specialty Bulbs, 100 watt (6 pack)","Accounts Receivable",NA,9.5,127312.96
"1080","Inventory Asset","Invoice","2018-06-07","71085","Cole Home Builders:Phase 1 - Lot 5","Specialty, Stage & Studio Bulbs  60 watt","Accounts Receivable",NA,20,127292.96
"1081","Inventory Asset","Invoice","2018-06-07","71085","Cole Home Builders:Phase 1 - Lot 5","Flat Glass, (25 watt max) Polished Brass, 4 light","Accounts Receivable",NA,48.49,127244.47
"1082","Inventory Asset","Invoice","2018-06-07","71085","Cole Home Builders:Phase 1 - Lot 5","Beveled Mirror, Etched Ribbed Glass (75 watt max)","Accounts Receivable",NA,48.99,127195.48
"1083","Inventory Asset","Invoice","2018-06-10","71128","Kern Lighting Warehouse:Store #45","Fluorescent Lamp, T-12, Medium Bipin  (30pack)","Accounts Receivable",NA,1902.88,125292.6
"1084","Inventory Asset","Invoice","2018-06-10","71128","Kern Lighting Warehouse:Store #45","Specialty, Stage & Studio Bulbs  60 watt","Accounts Receivable",NA,375,124917.6
"1085","Inventory Asset","Invoice","2018-06-10","71128","Kern Lighting Warehouse:Store #45","Drop Opal w/Solid Oak Frame, 49 1/2 x 17, 120v HPF","Accounts Receivable",NA,643.27,124274.33
"1086","Inventory Asset","Invoice","2018-06-10","71128","Kern Lighting Warehouse:Store #45","Sunset, Clear Glass, 1-100 watt max.","Accounts Receivable",NA,700,123574.33
"1087","Inventory Asset","Invoice","2018-06-10","71128","Kern Lighting Warehouse:Store #45","Black Finish, Solid Brass, Clear Glass, Hanging, 2-60 watt max.","Accounts Receivable",NA,961.04,122613.29
"1088","Inventory Asset","Invoice","2018-06-10","71128","Kern Lighting Warehouse:Store #45","Solid Brass, 4-light, 25x13x10.75, 4-60 watt, Medium Base, Satin Etched Glass","Accounts Receivable",NA,380,122233.29
"1089","Inventory Asset","Invoice","2018-06-10","71128","Kern Lighting Warehouse:Store #45","Brushed Nickel, (3-60 watt, Med) Ribbed Glass","Accounts Receivable",NA,240,121993.29
"1090","Inventory Asset","Invoice","2018-06-10","71128","Kern Lighting Warehouse:Store #45","Halogen Lamp, 20 watts, Luminous Intensity","Accounts Receivable",NA,60,121933.29
"1091","Inventory Asset","Invoice","2018-06-10","71128","Kern Lighting Warehouse:Store #45","Halogen Lamp, Volts:3.5  Tubular","Accounts Receivable",NA,25,121908.29
"1092","Inventory Asset","Invoice","2018-06-10","71128","Kern Lighting Warehouse:Store #45","Roman Bronze, 1-light Lantern, w/tail, (100 watt max)","Accounts Receivable",NA,950,120958.29
"1093","Inventory Asset","Invoice","2018-06-11","71070","Godwin Lighting Depot:Store #303","Vianne Lanterns, Satin Antiqued Solid Brass, 3-light wall latern, Candelabra base (60 watt max)","Accounts Receivable",NA,192.57,120765.72
"1094","Inventory Asset","Invoice","2018-06-11","71070","Godwin Lighting Depot:Store #303","Renaissance Collection, (100 watt max) Millstone Finish, One-light","Accounts Receivable",NA,131.82,120633.9
"1095","Inventory Asset","Invoice","2018-06-11","71070","Godwin Lighting Depot:Store #303","Drop Opal w/Solid Oak Frame, 49 1/2 x 17, 120v HPF","Accounts Receivable",NA,42.88,120591.02
"1096","Inventory Asset","Invoice","2018-06-11","71070","Godwin Lighting Depot:Store #303","Beveled Mirror, Etched Ribbed Glass (75 watt max)","Accounts Receivable",NA,73.49,120517.53
"1097","Inventory Asset","Invoice","2018-06-11","71070","Godwin Lighting Depot:Store #303","Chestnut (3/60 watt)  Marble Glass","Accounts Receivable",NA,194.4,120323.13
"1098","Inventory Asset","Invoice","2018-06-11","71070","Godwin Lighting Depot:Store #303","2032 Series, (3-60 watt, Med) Desert Stone Finish","Accounts Receivable",NA,60,120263.13
"1099","Inventory Asset","Invoice","2018-06-11","71070","Godwin Lighting Depot:Store #303","Pearl Nickle, 5 Light, Medium Base (100 watt max)","Accounts Receivable",NA,80,120183.13
"1100","Inventory Asset","Invoice","2018-06-11","71070","Godwin Lighting Depot:Store #303","Verona Collection, Pendant, Cobblestone, Etched Alabaster Glass, 150 watt max","Accounts Receivable",NA,280,119903.13
"1101","Inventory Asset","Invoice","2018-06-11","71070","Godwin Lighting Depot:Store #303","Pendant Bar, Cobblestone, 50lbs. max","Accounts Receivable",NA,45.48,119857.65
"1102","Inventory Asset","Invoice","2018-06-11","71070","Godwin Lighting Depot:Store #303","Cand. Light, 20 watts (8 pack)","Accounts Receivable",NA,36,119821.65
"1103","Inventory Asset","Invoice","2018-06-11","71070","Godwin Lighting Depot:Store #303","Fluorescent Lamp, T-12, Medium Bipin  (30pack)","Accounts Receivable",NA,6.34,119815.31
"1104","Inventory Asset","Invoice","2018-06-11","71070","Godwin Lighting Depot:Store #303","Halogen Lamp, 20 watts, Luminous Intensity","Accounts Receivable",NA,24,119791.31
"1105","Inventory Asset","Invoice","2018-06-11","71070","Godwin Lighting Depot:Store #303","Specialty Bulbs, 100 watt (6 pack)","Accounts Receivable",NA,9.5,119781.81
"1106","Inventory Asset","Invoice","2018-06-11","71070","Godwin Lighting Depot:Store #303","Specialty, Stage & Studio Bulbs  60 watt","Accounts Receivable",NA,22.5,119759.31
"1107","Inventory Asset","Invoice","2018-06-12","71080","Cole Home Builders:Phase 1 - Lot 5","BrassGuard Lanterns, Polished Brass, 1-light Wall, (100 watt max)","Accounts Receivable",NA,140,119619.31
"1108","Inventory Asset","Invoice","2018-06-12","71080","Cole Home Builders:Phase 1 - Lot 5","Die Cast Lanterns, Black, 1-100 watt, Medium Base, Clear Cracked Glass","Accounts Receivable",NA,77.06,119542.25
"1109","Inventory Asset","Invoice","2018-06-12","71080","Cole Home Builders:Phase 1 - Lot 5","Sunset, Clear Glass, 1-100 watt max.","Accounts Receivable",NA,35,119507.25
"1110","Inventory Asset","Invoice","2018-06-12","71080","Cole Home Builders:Phase 1 - Lot 5","Beveled Mirror, Etched Ribbed Glass (75 watt max)","Accounts Receivable",NA,73.49,119433.76
"1111","Inventory Asset","Invoice","2018-06-12","71080","Cole Home Builders:Phase 1 - Lot 5","Broadway Collection, Polished Brass, 6 Light (60 watt max)","Accounts Receivable",NA,60,119373.76
"1112","Inventory Asset","Invoice","2018-06-12","71080","Cole Home Builders:Phase 1 - Lot 5","Brushed Nickel, 18x7.75x6, 3-60 watt Medium Base, Satin Opal Glass","Accounts Receivable",NA,37,119336.76
"1113","Inventory Asset","Invoice","2018-06-12","71080","Cole Home Builders:Phase 1 - Lot 5","Brushed Nickel, (3-60 watt, Med) Ribbed Glass","Accounts Receivable",NA,60,119276.76
"1114","Inventory Asset","Invoice","2018-06-12","71080","Cole Home Builders:Phase 1 - Lot 5","Brushed Nickel, Pendant, 1-100 watt Medium Base, Satin Etched Glass","Accounts Receivable",NA,100,119176.76
"1115","Inventory Asset","Invoice","2018-06-12","71080","Cole Home Builders:Phase 1 - Lot 5","Pendant Bar, Cobblestone, 50lbs. max","Accounts Receivable",NA,11.37,119165.39
"1116","Inventory Asset","Invoice","2018-06-12","71080","Cole Home Builders:Phase 1 - Lot 5","Verona Collection, Pendant, Cobblestone, Etched Alabaster Glass, 150 watt max","Accounts Receivable",NA,70,119095.39
"1117","Inventory Asset","Invoice","2018-06-12","71080","Cole Home Builders:Phase 1 - Lot 5","Chestnut (3/60 watt)  Marble Glass","Accounts Receivable",NA,97.2,118998.19
"1118","Inventory Asset","Invoice","2018-06-12","71080","Cole Home Builders:Phase 1 - Lot 5","Frosted Taupe (3/60 watt)  Marble Glass  ","Accounts Receivable",NA,89.21,118908.98
"1119","Inventory Asset","Invoice","2018-06-12","71080","Cole Home Builders:Phase 1 - Lot 5","Cand. Light, 20 watts (8 pack)","Accounts Receivable",NA,36,118872.98
"1120","Inventory Asset","Invoice","2018-06-12","71080","Cole Home Builders:Phase 1 - Lot 5","Specialty Bulbs, 100 watt (6 pack)","Accounts Receivable",NA,9.5,118863.48
"1121","Inventory Asset","Invoice","2018-06-12","71080","Cole Home Builders:Phase 1 - Lot 5","Specialty, Stage & Studio Bulbs  60 watt","Accounts Receivable",NA,12.5,118850.98
"1122","Inventory Asset","Invoice","2018-06-12","71081","Cole Home Builders:Phase 2 - Lot 5","Acid Verde, 10x21x10, 2-60 watt cand.","Accounts Receivable",NA,60,118790.98
"1123","Inventory Asset","Invoice","2018-06-12","71081","Cole Home Builders:Phase 2 - Lot 5","Sunset, Clear Glass, 1-100 watt max.","Accounts Receivable",NA,52.5,118738.48
"1124","Inventory Asset","Invoice","2018-06-12","71081","Cole Home Builders:Phase 2 - Lot 5","Tapestry (8/60 watt)  Faux Alabaster Glass","Accounts Receivable",NA,75,118663.48
"1125","Inventory Asset","Invoice","2018-06-12","71081","Cole Home Builders:Phase 2 - Lot 5","Chestnut (3/60 watt)  Marble Glass","Accounts Receivable",NA,97.2,118566.28
"1126","Inventory Asset","Invoice","2018-06-12","71081","Cole Home Builders:Phase 2 - Lot 5","Tiffany Collection,Golden Baroque, 1-light lantern, medium base (100 watt max)","Accounts Receivable",NA,96,118470.28
"1127","Inventory Asset","Invoice","2018-06-12","71081","Cole Home Builders:Phase 2 - Lot 5","2032 Series, (3-60 watt, Med) Desert Stone Finish","Accounts Receivable",NA,36,118434.28
"1128","Inventory Asset","Invoice","2018-06-12","71081","Cole Home Builders:Phase 2 - Lot 5","Tapestry, (2-60 watt Med), Etched Cracked Glass, Finish 10","Accounts Receivable",NA,30,118404.28
"1129","Inventory Asset","Invoice","2018-06-12","71081","Cole Home Builders:Phase 2 - Lot 5","18x8x10, Solid Brass, 3-60watt Medium Base, Satin Etched Glass","Accounts Receivable",NA,65.19,118339.09
"1130","Inventory Asset","Invoice","2018-06-12","71081","Cole Home Builders:Phase 2 - Lot 5","White, 4.5x7.5, 1-100 watt Medium Base, Satin White Glass","Accounts Receivable",NA,45,118294.09
"1131","Inventory Asset","Invoice","2018-06-12","71081","Cole Home Builders:Phase 2 - Lot 5","Drop Opal w/Solid Oak Frame, 49 1/2 x 17, 120v HPF","Accounts Receivable",NA,64.33,118229.76
"1132","Inventory Asset","Invoice","2018-06-12","71081","Cole Home Builders:Phase 2 - Lot 5","Verona Collection, Pendant, Cobblestone, Etched Alabaster Glass, 150 watt max","Accounts Receivable",NA,70,118159.76
"1133","Inventory Asset","Invoice","2018-06-12","71081","Cole Home Builders:Phase 2 - Lot 5","Fluorescent Lamp, T-12, Medium Bipin  (30pack)","Accounts Receivable",NA,6.34,118153.42
"1134","Inventory Asset","Invoice","2018-06-12","71081","Cole Home Builders:Phase 2 - Lot 5","Specialty Bulbs, 100 watt (6 pack)","Accounts Receivable",NA,23.75,118129.67
"1135","Inventory Asset","Invoice","2018-06-12","71081","Cole Home Builders:Phase 2 - Lot 5","Specialty, Stage & Studio Bulbs  60 watt","Accounts Receivable",NA,15,118114.67
"1136","Inventory Asset","Invoice","2018-06-12","71114","Thompson Lighting Stores:Store #30","Acid Verde, 10x21x10, 2-60 watt cand.","Accounts Receivable",NA,180,117934.67
"1137","Inventory Asset","Invoice","2018-06-12","71114","Thompson Lighting Stores:Store #30","Die Cast Lanterns, Black, 1-100 watt, Medium Base, Clear Cracked Glass","Accounts Receivable",NA,154.13,117780.54
"1138","Inventory Asset","Invoice","2018-06-12","71114","Thompson Lighting Stores:Store #30","Polished Brass Pendant, 1-100 watt Medium Base, Clear Ribbed Glass","Accounts Receivable",NA,128,117652.54
"1139","Inventory Asset","Invoice","2018-06-12","71114","Thompson Lighting Stores:Store #30","2032 Series, (3-60 watt, Med) Desert Stone Finish","Accounts Receivable",NA,48,117604.54
"1140","Inventory Asset","Invoice","2018-06-12","71114","Thompson Lighting Stores:Store #30","Brushed Nickel, 18x7.75x6, 3-60 watt Medium Base, Satin Opal Glass","Accounts Receivable",NA,74,117530.54
"1141","Inventory Asset","Invoice","2018-06-12","71114","Thompson Lighting Stores:Store #30","Tapestry (8/60 watt)  Faux Alabaster Glass","Accounts Receivable",NA,75,117455.54
"1142","Inventory Asset","Invoice","2018-06-12","71114","Thompson Lighting Stores:Store #30","Frosted Taupe (3/60 watt)  Marble Glass  ","Accounts Receivable",NA,89.21,117366.33
"1143","Inventory Asset","Invoice","2018-06-12","71114","Thompson Lighting Stores:Store #30","Roman Bronze, 1-light Lantern, w/tail, (100 watt max)","Accounts Receivable",NA,152,117214.33
"1144","Inventory Asset","Invoice","2018-06-12","71114","Thompson Lighting Stores:Store #30","Domes, White, 59x21x6 5/8 ht, 120v HPF","Accounts Receivable",NA,57,117157.33
"1145","Inventory Asset","Invoice","2018-06-12","71114","Thompson Lighting Stores:Store #30","Flat Glass, (25 watt max) Polished Brass, 4 light","Accounts Receivable",NA,60.61,117096.72
"1146","Inventory Asset","Invoice","2018-06-12","71114","Thompson Lighting Stores:Store #30","Burnished Brass (60 watt)  w/Golden Umber Accents","Accounts Receivable",NA,75,117021.72
"1147","Inventory Asset","Invoice","2018-06-12","71114","Thompson Lighting Stores:Store #30","Pearl Nickle, 5 Light, Medium Base (100 watt max)","Accounts Receivable",NA,200,116821.72
"1148","Inventory Asset","Invoice","2018-06-15","71082","Cole Home Builders:Phase 1 - Lot 5","Acid Verde, 10x21x10, 2-60 watt cand.","Accounts Receivable",NA,60,116761.72
"1149","Inventory Asset","Invoice","2018-06-15","71082","Cole Home Builders:Phase 1 - Lot 5","Sunset, Clear Glass, 1-100 watt max.","Accounts Receivable",NA,52.5,116709.22
"1150","Inventory Asset","Invoice","2018-06-15","71082","Cole Home Builders:Phase 1 - Lot 5","Tapestry (8/60 watt)  Faux Alabaster Glass","Accounts Receivable",NA,75,116634.22
"1151","Inventory Asset","Invoice","2018-06-15","71082","Cole Home Builders:Phase 1 - Lot 5","Chestnut (3/60 watt)  Marble Glass","Accounts Receivable",NA,97.2,116537.02
"1152","Inventory Asset","Invoice","2018-06-15","71082","Cole Home Builders:Phase 1 - Lot 5","Tiffany Collection,Golden Baroque, 1-light lantern, medium base (100 watt max)","Accounts Receivable",NA,96,116441.02
"1153","Inventory Asset","Invoice","2018-06-15","71082","Cole Home Builders:Phase 1 - Lot 5","2032 Series, (3-60 watt, Med) Desert Stone Finish","Accounts Receivable",NA,36,116405.02
"1154","Inventory Asset","Invoice","2018-06-15","71082","Cole Home Builders:Phase 1 - Lot 5","Tapestry, (2-60 watt Med), Etched Cracked Glass, Finish 10","Accounts Receivable",NA,30,116375.02
"1155","Inventory Asset","Invoice","2018-06-15","71082","Cole Home Builders:Phase 1 - Lot 5","18x8x10, Solid Brass, 3-60watt Medium Base, Satin Etched Glass","Accounts Receivable",NA,65.19,116309.83
"1156","Inventory Asset","Invoice","2018-06-15","71082","Cole Home Builders:Phase 1 - Lot 5","White, 4.5x7.5, 1-100 watt Medium Base, Satin White Glass","Accounts Receivable",NA,45,116264.83
"1157","Inventory Asset","Invoice","2018-06-15","71082","Cole Home Builders:Phase 1 - Lot 5","Drop Opal w/Solid Oak Frame, 49 1/2 x 17, 120v HPF","Accounts Receivable",NA,64.33,116200.5
"1158","Inventory Asset","Invoice","2018-06-15","71082","Cole Home Builders:Phase 1 - Lot 5","Verona Collection, Pendant, Cobblestone, Etched Alabaster Glass, 150 watt max","Accounts Receivable",NA,70,116130.5
"1159","Inventory Asset","Invoice","2018-06-15","71082","Cole Home Builders:Phase 1 - Lot 5","Fluorescent Lamp, T-12, Medium Bipin  (30pack)","Accounts Receivable",NA,6.34,116124.16
"1160","Inventory Asset","Invoice","2018-06-15","71082","Cole Home Builders:Phase 1 - Lot 5","Specialty Bulbs, 100 watt (6 pack)","Accounts Receivable",NA,23.75,116100.41
"1161","Inventory Asset","Invoice","2018-06-15","71082","Cole Home Builders:Phase 1 - Lot 5","Specialty, Stage & Studio Bulbs  60 watt","Accounts Receivable",NA,15,116085.41
"1162","Inventory Asset","Invoice","2018-06-28","71116","Thompson Lighting Stores:Store #50","Acid Verde, 10x21x10, 2-60 watt cand.","Accounts Receivable",NA,180,115905.41
"1163","Inventory Asset","Invoice","2018-06-28","71116","Thompson Lighting Stores:Store #50","Die Cast Lanterns, Black, 1-100 watt, Medium Base, Clear Cracked Glass","Accounts Receivable",NA,154.13,115751.28
"1164","Inventory Asset","Invoice","2018-06-28","71116","Thompson Lighting Stores:Store #50","Polished Brass Pendant, 1-100 watt Medium Base, Clear Ribbed Glass","Accounts Receivable",NA,128,115623.28
"1165","Inventory Asset","Invoice","2018-06-28","71116","Thompson Lighting Stores:Store #50","2032 Series, (3-60 watt, Med) Desert Stone Finish","Accounts Receivable",NA,48,115575.28
"1166","Inventory Asset","Invoice","2018-06-28","71116","Thompson Lighting Stores:Store #50","Brushed Nickel, 18x7.75x6, 3-60 watt Medium Base, Satin Opal Glass","Accounts Receivable",NA,74,115501.28
"1167","Inventory Asset","Invoice","2018-06-28","71116","Thompson Lighting Stores:Store #50","Tapestry (8/60 watt)  Faux Alabaster Glass","Accounts Receivable",NA,75,115426.28
"1168","Inventory Asset","Invoice","2018-06-28","71116","Thompson Lighting Stores:Store #50","Frosted Taupe (3/60 watt)  Marble Glass  ","Accounts Receivable",NA,89.21,115337.07
"1169","Inventory Asset","Invoice","2018-06-28","71116","Thompson Lighting Stores:Store #50","Roman Bronze, 1-light Lantern, w/tail, (100 watt max)","Accounts Receivable",NA,152,115185.07
"1170","Inventory Asset","Invoice","2018-06-28","71116","Thompson Lighting Stores:Store #50","Domes, White, 59x21x6 5/8 ht, 120v HPF","Accounts Receivable",NA,57,115128.07
"1171","Inventory Asset","Invoice","2018-06-28","71116","Thompson Lighting Stores:Store #50","Flat Glass, (25 watt max) Polished Brass, 4 light","Accounts Receivable",NA,60.61,115067.46
"1172","Inventory Asset","Invoice","2018-06-28","71116","Thompson Lighting Stores:Store #50","Burnished Brass (60 watt)  w/Golden Umber Accents","Accounts Receivable",NA,75,114992.46
"1173","Inventory Asset","Invoice","2018-06-28","71116","Thompson Lighting Stores:Store #50","Pearl Nickle, 5 Light, Medium Base (100 watt max)","Accounts Receivable",NA,200,114792.46
"1174","Inventory Asset","Invoice","2018-07-05","71089","Cole Home Builders:Phase 1 - Lot 5","Acid Verde, 10x21x10, 2-60 watt cand.","Accounts Receivable",NA,60,114732.46
"1175","Inventory Asset","Invoice","2018-07-05","71089","Cole Home Builders:Phase 1 - Lot 5","Sunset, Clear Glass, 1-100 watt max.","Accounts Receivable",NA,52.5,114679.96
"1176","Inventory Asset","Invoice","2018-07-05","71089","Cole Home Builders:Phase 1 - Lot 5","Tapestry (8/60 watt)  Faux Alabaster Glass","Accounts Receivable",NA,75,114604.96
"1177","Inventory Asset","Invoice","2018-07-05","71089","Cole Home Builders:Phase 1 - Lot 5","Chestnut (3/60 watt)  Marble Glass","Accounts Receivable",NA,97.2,114507.76
"1178","Inventory Asset","Invoice","2018-07-05","71089","Cole Home Builders:Phase 1 - Lot 5","Tiffany Collection,Golden Baroque, 1-light lantern, medium base (100 watt max)","Accounts Receivable",NA,96,114411.76
"1179","Inventory Asset","Invoice","2018-07-05","71089","Cole Home Builders:Phase 1 - Lot 5","2032 Series, (3-60 watt, Med) Desert Stone Finish","Accounts Receivable",NA,36,114375.76
"1180","Inventory Asset","Invoice","2018-07-05","71089","Cole Home Builders:Phase 1 - Lot 5","Tapestry, (2-60 watt Med), Etched Cracked Glass, Finish 10","Accounts Receivable",NA,30,114345.76
"1181","Inventory Asset","Invoice","2018-07-05","71089","Cole Home Builders:Phase 1 - Lot 5","18x8x10, Solid Brass, 3-60watt Medium Base, Satin Etched Glass","Accounts Receivable",NA,65.19,114280.57
"1182","Inventory Asset","Invoice","2018-07-05","71089","Cole Home Builders:Phase 1 - Lot 5","White, 4.5x7.5, 1-100 watt Medium Base, Satin White Glass","Accounts Receivable",NA,45,114235.57
"1183","Inventory Asset","Invoice","2018-07-05","71089","Cole Home Builders:Phase 1 - Lot 5","Drop Opal w/Solid Oak Frame, 49 1/2 x 17, 120v HPF","Accounts Receivable",NA,64.33,114171.24
"1184","Inventory Asset","Invoice","2018-07-05","71089","Cole Home Builders:Phase 1 - Lot 5","Verona Collection, Pendant, Cobblestone, Etched Alabaster Glass, 150 watt max","Accounts Receivable",NA,70,114101.24
"1185","Inventory Asset","Invoice","2018-07-05","71089","Cole Home Builders:Phase 1 - Lot 5","Fluorescent Lamp, T-12, Medium Bipin  (30pack)","Accounts Receivable",NA,6.34,114094.9
"1186","Inventory Asset","Invoice","2018-07-05","71089","Cole Home Builders:Phase 1 - Lot 5","Specialty Bulbs, 100 watt (6 pack)","Accounts Receivable",NA,23.75,114071.15
"1187","Inventory Asset","Invoice","2018-07-05","71089","Cole Home Builders:Phase 1 - Lot 5","Specialty, Stage & Studio Bulbs  60 watt","Accounts Receivable",NA,15,114056.15
"1188","Inventory Asset","Invoice","2018-07-12","71079","Cole Home Builders:Phase 1 - Lot 5","BrassGuard Lanterns, Polished Brass, 1-light Wall, (100 watt max)","Accounts Receivable",NA,140,113916.15
"1189","Inventory Asset","Invoice","2018-07-12","71079","Cole Home Builders:Phase 1 - Lot 5","Die Cast Lanterns, Black, 1-100 watt, Medium Base, Clear Cracked Glass","Accounts Receivable",NA,77.06,113839.09
"1190","Inventory Asset","Invoice","2018-07-12","71079","Cole Home Builders:Phase 1 - Lot 5","Sunset, Clear Glass, 1-100 watt max.","Accounts Receivable",NA,35,113804.09
"1191","Inventory Asset","Invoice","2018-07-12","71079","Cole Home Builders:Phase 1 - Lot 5","Beveled Mirror, Etched Ribbed Glass (75 watt max)","Accounts Receivable",NA,73.49,113730.6
"1192","Inventory Asset","Invoice","2018-07-12","71079","Cole Home Builders:Phase 1 - Lot 5","Broadway Collection, Polished Brass, 6 Light (60 watt max)","Accounts Receivable",NA,60,113670.6
"1193","Inventory Asset","Invoice","2018-07-12","71079","Cole Home Builders:Phase 1 - Lot 5","Brushed Nickel, 18x7.75x6, 3-60 watt Medium Base, Satin Opal Glass","Accounts Receivable",NA,37,113633.6
"1194","Inventory Asset","Invoice","2018-07-12","71079","Cole Home Builders:Phase 1 - Lot 5","Brushed Nickel, (3-60 watt, Med) Ribbed Glass","Accounts Receivable",NA,60,113573.6
"1195","Inventory Asset","Invoice","2018-07-12","71079","Cole Home Builders:Phase 1 - Lot 5","Brushed Nickel, Pendant, 1-100 watt Medium Base, Satin Etched Glass","Accounts Receivable",NA,100,113473.6
"1196","Inventory Asset","Invoice","2018-07-12","71079","Cole Home Builders:Phase 1 - Lot 5","Pendant Bar, Cobblestone, 50lbs. max","Accounts Receivable",NA,11.37,113462.23
"1197","Inventory Asset","Invoice","2018-07-12","71079","Cole Home Builders:Phase 1 - Lot 5","Verona Collection, Pendant, Cobblestone, Etched Alabaster Glass, 150 watt max","Accounts Receivable",NA,70,113392.23
"1198","Inventory Asset","Invoice","2018-07-12","71079","Cole Home Builders:Phase 1 - Lot 5","Chestnut (3/60 watt)  Marble Glass","Accounts Receivable",NA,97.2,113295.03
"1199","Inventory Asset","Invoice","2018-07-12","71079","Cole Home Builders:Phase 1 - Lot 5","Frosted Taupe (3/60 watt)  Marble Glass  ","Accounts Receivable",NA,89.21,113205.82
"1200","Inventory Asset","Invoice","2018-07-12","71079","Cole Home Builders:Phase 1 - Lot 5","Cand. Light, 20 watts (8 pack)","Accounts Receivable",NA,36,113169.82
"1201","Inventory Asset","Invoice","2018-07-12","71079","Cole Home Builders:Phase 1 - Lot 5","Specialty Bulbs, 100 watt (6 pack)","Accounts Receivable",NA,9.5,113160.32
"1202","Inventory Asset","Invoice","2018-07-12","71079","Cole Home Builders:Phase 1 - Lot 5","Specialty, Stage & Studio Bulbs  60 watt","Accounts Receivable",NA,12.5,113147.82
"1203","Inventory Asset","Invoice","2018-07-13","71119","Kern Lighting Warehouse:Store #01","Golden Umber (100 watt)  Six Light Chandelier","Accounts Receivable",NA,850,112297.82
"1204","Inventory Asset","Invoice","2018-07-13","71119","Kern Lighting Warehouse:Store #01","Burnished Brass (60 watt)  w/Golden Umber Accents","Accounts Receivable",NA,750,111547.82
"1205","Inventory Asset","Invoice","2018-07-16","71076","Cole Home Builders:Phase 1 - Lot 5","Golden Umber (100 watt)  Six Light Chandelier","Accounts Receivable",NA,85,111462.82
"1206","Inventory Asset","Invoice","2018-07-16","71076","Cole Home Builders:Phase 1 - Lot 5","Tapestry (8/60 watt)  Faux Alabaster Glass","Accounts Receivable",NA,75,111387.82
"1207","Inventory Asset","Invoice","2018-07-16","71076","Cole Home Builders:Phase 1 - Lot 5","Polished Brass Pendant, 1-100 watt Medium Base, Clear Ribbed Glass","Accounts Receivable",NA,160,111227.82
"1208","Inventory Asset","Invoice","2018-07-16","71076","Cole Home Builders:Phase 1 - Lot 5","Tapestry, (2-60 watt Med), Etched Cracked Glass, Finish 10","Accounts Receivable",NA,60,111167.82
"1209","Inventory Asset","Invoice","2018-07-16","71076","Cole Home Builders:Phase 1 - Lot 5","Verona Collection, Pendant, Cobblestone, Etched Alabaster Glass, 150 watt max","Accounts Receivable",NA,140,111027.82
"1210","Inventory Asset","Invoice","2018-07-16","71076","Cole Home Builders:Phase 1 - Lot 5","Pendant Bar, Cobblestone, 50lbs. max","Accounts Receivable",NA,22.74,111005.08
"1211","Inventory Asset","Invoice","2018-07-16","71076","Cole Home Builders:Phase 1 - Lot 5","Pearl Nickle, 5 Light, Medium Base (100 watt max)","Accounts Receivable",NA,80,110925.08
"1212","Inventory Asset","Invoice","2018-07-16","71076","Cole Home Builders:Phase 1 - Lot 5","White, 4.5x7.5, 1-100 watt Medium Base, Satin White Glass","Accounts Receivable",NA,30,110895.08
"1213","Inventory Asset","Invoice","2018-07-16","71076","Cole Home Builders:Phase 1 - Lot 5","Solid Brass, 4-light, 25x13x10.75, 4-60 watt, Medium Base, Satin Etched Glass","Accounts Receivable",NA,19,110876.08
"1214","Inventory Asset","Invoice","2018-07-16","71076","Cole Home Builders:Phase 1 - Lot 5","Acid Verde, 10x21x10, 2-60 watt cand.","Accounts Receivable",NA,60,110816.08
"1215","Inventory Asset","Invoice","2018-07-16","71076","Cole Home Builders:Phase 1 - Lot 5","BrassGuard Lanterns, Polished Brass, 1-light Wall, (100 watt max)","Accounts Receivable",NA,105,110711.08
"1216","Inventory Asset","Invoice","2018-07-16","71076","Cole Home Builders:Phase 1 - Lot 5","Black Finish, Solid Brass, Clear Glass, Hanging, 2-60 watt max.","Accounts Receivable",NA,38.44,110672.64
"1217","Inventory Asset","Invoice","2018-07-16","71076","Cole Home Builders:Phase 1 - Lot 5","Specialty, Stage & Studio Bulbs  60 watt","Accounts Receivable",NA,15,110657.64
"1218","Inventory Asset","Invoice","2018-07-16","71076","Cole Home Builders:Phase 1 - Lot 5","Specialty Bulbs, 100 watt (6 pack)","Accounts Receivable",NA,47.5,110610.14
"1219","Inventory Asset","Invoice","2018-07-16","71076","Cole Home Builders:Phase 1 - Lot 5","Cand. Light, 20 watts (8 pack)","Accounts Receivable",NA,24,110586.14
"1220","Inventory Asset","Invoice","2018-07-16","71115","Thompson Lighting Stores:Store #40","Acid Verde, 10x21x10, 2-60 watt cand.","Accounts Receivable",NA,180,110406.14
"1221","Inventory Asset","Invoice","2018-07-16","71115","Thompson Lighting Stores:Store #40","Die Cast Lanterns, Black, 1-100 watt, Medium Base, Clear Cracked Glass","Accounts Receivable",NA,154.13,110252.01
"1222","Inventory Asset","Invoice","2018-07-16","71115","Thompson Lighting Stores:Store #40","Polished Brass Pendant, 1-100 watt Medium Base, Clear Ribbed Glass","Accounts Receivable",NA,128,110124.01
"1223","Inventory Asset","Invoice","2018-07-16","71115","Thompson Lighting Stores:Store #40","2032 Series, (3-60 watt, Med) Desert Stone Finish","Accounts Receivable",NA,48,110076.01
"1224","Inventory Asset","Invoice","2018-07-16","71115","Thompson Lighting Stores:Store #40","Brushed Nickel, 18x7.75x6, 3-60 watt Medium Base, Satin Opal Glass","Accounts Receivable",NA,74,110002.01
"1225","Inventory Asset","Invoice","2018-07-16","71115","Thompson Lighting Stores:Store #40","Tapestry (8/60 watt)  Faux Alabaster Glass","Accounts Receivable",NA,75,109927.01
"1226","Inventory Asset","Invoice","2018-07-16","71115","Thompson Lighting Stores:Store #40","Frosted Taupe (3/60 watt)  Marble Glass  ","Accounts Receivable",NA,89.21,109837.8
"1227","Inventory Asset","Invoice","2018-07-16","71115","Thompson Lighting Stores:Store #40","Roman Bronze, 1-light Lantern, w/tail, (100 watt max)","Accounts Receivable",NA,152,109685.8
"1228","Inventory Asset","Invoice","2018-07-16","71115","Thompson Lighting Stores:Store #40","Domes, White, 59x21x6 5/8 ht, 120v HPF","Accounts Receivable",NA,57,109628.8
"1229","Inventory Asset","Invoice","2018-07-16","71115","Thompson Lighting Stores:Store #40","Flat Glass, (25 watt max) Polished Brass, 4 light","Accounts Receivable",NA,60.61,109568.19
"1230","Inventory Asset","Invoice","2018-07-16","71115","Thompson Lighting Stores:Store #40","Burnished Brass (60 watt)  w/Golden Umber Accents","Accounts Receivable",NA,75,109493.19
"1231","Inventory Asset","Invoice","2018-07-16","71115","Thompson Lighting Stores:Store #40","Pearl Nickle, 5 Light, Medium Base (100 watt max)","Accounts Receivable",NA,200,109293.19
"1232","Inventory Asset","Invoice","2018-07-17","71129","Kern Lighting Warehouse:Store #01","Sunset, Clear Glass, 1-100 watt max.","Accounts Receivable",NA,612.5,108680.69
"1233","Inventory Asset","Invoice","2018-07-17","71129","Kern Lighting Warehouse:Store #01","Beveled Mirror, Etched Ribbed Glass (75 watt max)","Accounts Receivable",NA,489.94,108190.75
"1234","Inventory Asset","Invoice","2018-07-17","71129","Kern Lighting Warehouse:Store #01","Pendant Bar, Textured White, 50lbs max","Accounts Receivable",NA,269.23,107921.52
"1235","Inventory Asset","Invoice","2018-07-17","71129","Kern Lighting Warehouse:Store #01","Drop Opal w/Solid Oak Frame, 49 1/2 x 17, 120v HPF","Accounts Receivable",NA,321.63,107599.89
"1236","Inventory Asset","Invoice","2018-07-17","71129","Kern Lighting Warehouse:Store #01","Flat Glass, (25 watt max) Polished Brass, 4 light","Accounts Receivable",NA,303.07,107296.82
"1237","Inventory Asset","Invoice","2018-07-17","71129","Kern Lighting Warehouse:Store #01","Verona Collection, Pendant, Cobblestone, Etched Alabaster Glass, 150 watt max","Accounts Receivable",NA,1750,105546.82
"1238","Inventory Asset","Invoice","2018-07-17","71129","Kern Lighting Warehouse:Store #01","Athena Collection, Pendant, Textured White, Med. Base, 100 watt max.","Accounts Receivable",NA,1500,104046.82
"1239","Inventory Asset","Invoice","2018-07-17","71129","Kern Lighting Warehouse:Store #01","Golden Umber (100 watt)  Six Light Chandelier","Accounts Receivable",NA,2125,101921.82
"1240","Inventory Asset","Invoice","2018-07-24","71097","Miscellaneous - Retail:Sean Martin","Black Finish, Solid Brass,Wall Mount w/Clear Glass (2x60watt max)","Accounts Receivable",NA,400,101521.82
"1241","Inventory Asset","Invoice","2018-07-24","71097","Miscellaneous - Retail:Sean Martin","Golden Umber (100 watt)  Six Light Chandelier","Accounts Receivable",NA,170,101351.82
"1242","Inventory Asset","Invoice","2018-07-24","71097","Miscellaneous - Retail:Sean Martin","Brushed Nickel, 18x7.75x6, 3-60 watt Medium Base, Satin Opal Glass","Accounts Receivable",NA,55.5,101296.32
"1243","Inventory Asset","Invoice","2018-07-24","71097","Miscellaneous - Retail:Sean Martin","Domes, White, 59x21x6 5/8 ht, 120v HPF","Accounts Receivable",NA,19,101277.32
"1244","Inventory Asset","Invoice","2018-07-24","71097","Miscellaneous - Retail:Sean Martin","Drop Opal w/Solid Oak Frame, 49 1/2 x 17, 120v HPF","Accounts Receivable",NA,21.44,101255.88
"1245","Inventory Asset","Invoice","2018-07-27","71078","Cole Home Builders:Phase 1 - Lot 5","BrassGuard Lanterns, Polished Brass, 1-light Wall, (100 watt max)","Accounts Receivable",NA,140,101115.88
"1246","Inventory Asset","Invoice","2018-07-27","71078","Cole Home Builders:Phase 1 - Lot 5","Die Cast Lanterns, Black, 1-100 watt, Medium Base, Clear Cracked Glass","Accounts Receivable",NA,77.06,101038.82
"1247","Inventory Asset","Invoice","2018-07-27","71078","Cole Home Builders:Phase 1 - Lot 5","Sunset, Clear Glass, 1-100 watt max.","Accounts Receivable",NA,35,101003.82
"1248","Inventory Asset","Invoice","2018-07-27","71078","Cole Home Builders:Phase 1 - Lot 5","Beveled Mirror, Etched Ribbed Glass (75 watt max)","Accounts Receivable",NA,73.49,100930.33
"1249","Inventory Asset","Invoice","2018-07-27","71078","Cole Home Builders:Phase 1 - Lot 5","Broadway Collection, Polished Brass, 6 Light (60 watt max)","Accounts Receivable",NA,60,100870.33
"1250","Inventory Asset","Invoice","2018-07-27","71078","Cole Home Builders:Phase 1 - Lot 5","Brushed Nickel, 18x7.75x6, 3-60 watt Medium Base, Satin Opal Glass","Accounts Receivable",NA,37,100833.33
"1251","Inventory Asset","Invoice","2018-07-27","71078","Cole Home Builders:Phase 1 - Lot 5","Brushed Nickel, (3-60 watt, Med) Ribbed Glass","Accounts Receivable",NA,60,100773.33
"1252","Inventory Asset","Invoice","2018-07-27","71078","Cole Home Builders:Phase 1 - Lot 5","Brushed Nickel, Pendant, 1-100 watt Medium Base, Satin Etched Glass","Accounts Receivable",NA,100,100673.33
"1253","Inventory Asset","Invoice","2018-07-27","71078","Cole Home Builders:Phase 1 - Lot 5","Pendant Bar, Cobblestone, 50lbs. max","Accounts Receivable",NA,11.37,100661.96
"1254","Inventory Asset","Invoice","2018-07-27","71078","Cole Home Builders:Phase 1 - Lot 5","Verona Collection, Pendant, Cobblestone, Etched Alabaster Glass, 150 watt max","Accounts Receivable",NA,70,100591.96
"1255","Inventory Asset","Invoice","2018-07-27","71078","Cole Home Builders:Phase 1 - Lot 5","Chestnut (3/60 watt)  Marble Glass","Accounts Receivable",NA,97.2,100494.76
"1256","Inventory Asset","Invoice","2018-07-27","71078","Cole Home Builders:Phase 1 - Lot 5","Frosted Taupe (3/60 watt)  Marble Glass  ","Accounts Receivable",NA,89.21,100405.55
"1257","Inventory Asset","Invoice","2018-07-27","71078","Cole Home Builders:Phase 1 - Lot 5","Cand. Light, 20 watts (8 pack)","Accounts Receivable",NA,36,100369.55
"1258","Inventory Asset","Invoice","2018-07-27","71078","Cole Home Builders:Phase 1 - Lot 5","Specialty Bulbs, 100 watt (6 pack)","Accounts Receivable",NA,9.5,100360.05
"1259","Inventory Asset","Invoice","2018-07-27","71078","Cole Home Builders:Phase 1 - Lot 5","Specialty, Stage & Studio Bulbs  60 watt","Accounts Receivable",NA,12.5,100347.55
"1260","Inventory Asset","Invoice","2018-07-31","71077","Cole Home Builders:Phase 1 - Lot 5","BrassGuard Lanterns, Polished Brass, 1-light Wall, (100 watt max)","Accounts Receivable",NA,140,100207.55
"1261","Inventory Asset","Invoice","2018-07-31","71077","Cole Home Builders:Phase 1 - Lot 5","Die Cast Lanterns, Black, 1-100 watt, Medium Base, Clear Cracked Glass","Accounts Receivable",NA,77.06,100130.49
"1262","Inventory Asset","Invoice","2018-07-31","71077","Cole Home Builders:Phase 1 - Lot 5","Sunset, Clear Glass, 1-100 watt max.","Accounts Receivable",NA,35,100095.49
"1263","Inventory Asset","Invoice","2018-07-31","71077","Cole Home Builders:Phase 1 - Lot 5","Beveled Mirror, Etched Ribbed Glass (75 watt max)","Accounts Receivable",NA,73.49,100022
"1264","Inventory Asset","Invoice","2018-07-31","71077","Cole Home Builders:Phase 1 - Lot 5","Broadway Collection, Polished Brass, 6 Light (60 watt max)","Accounts Receivable",NA,60,99962
"1265","Inventory Asset","Invoice","2018-07-31","71077","Cole Home Builders:Phase 1 - Lot 5","Brushed Nickel, 18x7.75x6, 3-60 watt Medium Base, Satin Opal Glass","Accounts Receivable",NA,37,99925
"1266","Inventory Asset","Invoice","2018-07-31","71077","Cole Home Builders:Phase 1 - Lot 5","Brushed Nickel, (3-60 watt, Med) Ribbed Glass","Accounts Receivable",NA,60,99865
"1267","Inventory Asset","Invoice","2018-07-31","71077","Cole Home Builders:Phase 1 - Lot 5","Brushed Nickel, Pendant, 1-100 watt Medium Base, Satin Etched Glass","Accounts Receivable",NA,100,99765
"1268","Inventory Asset","Invoice","2018-07-31","71077","Cole Home Builders:Phase 1 - Lot 5","Pendant Bar, Cobblestone, 50lbs. max","Accounts Receivable",NA,11.37,99753.63
"1269","Inventory Asset","Invoice","2018-07-31","71077","Cole Home Builders:Phase 1 - Lot 5","Verona Collection, Pendant, Cobblestone, Etched Alabaster Glass, 150 watt max","Accounts Receivable",NA,70,99683.63
"1270","Inventory Asset","Invoice","2018-07-31","71077","Cole Home Builders:Phase 1 - Lot 5","Chestnut (3/60 watt)  Marble Glass","Accounts Receivable",NA,97.2,99586.43
"1271","Inventory Asset","Invoice","2018-07-31","71077","Cole Home Builders:Phase 1 - Lot 5","Frosted Taupe (3/60 watt)  Marble Glass  ","Accounts Receivable",NA,89.21,99497.22
"1272","Inventory Asset","Invoice","2018-07-31","71077","Cole Home Builders:Phase 1 - Lot 5","Cand. Light, 20 watts (8 pack)","Accounts Receivable",NA,36,99461.22
"1273","Inventory Asset","Invoice","2018-07-31","71077","Cole Home Builders:Phase 1 - Lot 5","Specialty Bulbs, 100 watt (6 pack)","Accounts Receivable",NA,9.5,99451.72
"1274","Inventory Asset","Invoice","2018-07-31","71077","Cole Home Builders:Phase 1 - Lot 5","Specialty, Stage & Studio Bulbs  60 watt","Accounts Receivable",NA,12.5,99439.22
"1275","Inventory Asset","Bill","2018-08-01","34566","Foster Lighting","Tapestry (8/60 watt)  Faux Alabaster Glass","Accounts Payable",750,NA,100189.22
"1276","Inventory Asset","Invoice","2018-08-07","71098","Miscellaneous - Retail:Jann Minor","Acid Verde, 10x21x10, 2-60 watt cand.","Accounts Receivable",NA,450,99739.22
"1277","Inventory Asset","Invoice","2018-08-07","71098","Miscellaneous - Retail:Jann Minor","Beveled Mirror, Etched Ribbed Glass (75 watt max)","Accounts Receivable",NA,122.49,99616.73
"1278","Inventory Asset","Invoice","2018-08-07","71098","Miscellaneous - Retail:Jann Minor","Chestnut (3/60 watt)  Marble Glass","Accounts Receivable",NA,291.6,99325.13
"1279","Inventory Asset","Invoice","2018-08-10","71090","Cole Home Builders:Phase 2 - Lot 5","BrassGuard Lanterns, Polished Brass, 1-light Wall, (100 watt max)","Accounts Receivable",NA,140,99185.13
"1280","Inventory Asset","Invoice","2018-08-10","71090","Cole Home Builders:Phase 2 - Lot 5","Die Cast Lanterns, Black, 1-100 watt, Medium Base, Clear Cracked Glass","Accounts Receivable",NA,77.06,99108.07
"1281","Inventory Asset","Invoice","2018-08-10","71090","Cole Home Builders:Phase 2 - Lot 5","Sunset, Clear Glass, 1-100 watt max.","Accounts Receivable",NA,35,99073.07
"1282","Inventory Asset","Invoice","2018-08-10","71090","Cole Home Builders:Phase 2 - Lot 5","Beveled Mirror, Etched Ribbed Glass (75 watt max)","Accounts Receivable",NA,73.49,98999.58
"1283","Inventory Asset","Invoice","2018-08-10","71090","Cole Home Builders:Phase 2 - Lot 5","Broadway Collection, Polished Brass, 6 Light (60 watt max)","Accounts Receivable",NA,60,98939.58
"1284","Inventory Asset","Invoice","2018-08-10","71090","Cole Home Builders:Phase 2 - Lot 5","Brushed Nickel, 18x7.75x6, 3-60 watt Medium Base, Satin Opal Glass","Accounts Receivable",NA,37,98902.58
"1285","Inventory Asset","Invoice","2018-08-10","71090","Cole Home Builders:Phase 2 - Lot 5","Brushed Nickel, (3-60 watt, Med) Ribbed Glass","Accounts Receivable",NA,60,98842.58
"1286","Inventory Asset","Invoice","2018-08-10","71090","Cole Home Builders:Phase 2 - Lot 5","Brushed Nickel, Pendant, 1-100 watt Medium Base, Satin Etched Glass","Accounts Receivable",NA,100,98742.58
"1287","Inventory Asset","Invoice","2018-08-10","71090","Cole Home Builders:Phase 2 - Lot 5","Pendant Bar, Cobblestone, 50lbs. max","Accounts Receivable",NA,11.37,98731.21
"1288","Inventory Asset","Invoice","2018-08-10","71090","Cole Home Builders:Phase 2 - Lot 5","Verona Collection, Pendant, Cobblestone, Etched Alabaster Glass, 150 watt max","Accounts Receivable",NA,70,98661.21
"1289","Inventory Asset","Invoice","2018-08-10","71090","Cole Home Builders:Phase 2 - Lot 5","Chestnut (3/60 watt)  Marble Glass","Accounts Receivable",NA,97.2,98564.01
"1290","Inventory Asset","Invoice","2018-08-10","71090","Cole Home Builders:Phase 2 - Lot 5","Frosted Taupe (3/60 watt)  Marble Glass  ","Accounts Receivable",NA,89.21,98474.8
"1291","Inventory Asset","Invoice","2018-08-10","71090","Cole Home Builders:Phase 2 - Lot 5","Cand. Light, 20 watts (8 pack)","Accounts Receivable",NA,36,98438.8
"1292","Inventory Asset","Invoice","2018-08-10","71090","Cole Home Builders:Phase 2 - Lot 5","Specialty Bulbs, 100 watt (6 pack)","Accounts Receivable",NA,9.5,98429.3
"1293","Inventory Asset","Invoice","2018-08-10","71090","Cole Home Builders:Phase 2 - Lot 5","Specialty, Stage & Studio Bulbs  60 watt","Accounts Receivable",NA,12.5,98416.8
"1294","Inventory Asset","Invoice","2018-08-17","71075","Cole Home Builders:Phase 1 - Lot 5","Golden Umber (100 watt)  Six Light Chandelier","Accounts Receivable",NA,85,98331.8
"1295","Inventory Asset","Invoice","2018-08-17","71075","Cole Home Builders:Phase 1 - Lot 5","Tapestry (8/60 watt)  Faux Alabaster Glass","Accounts Receivable",NA,75,98256.8
"1296","Inventory Asset","Invoice","2018-08-17","71075","Cole Home Builders:Phase 1 - Lot 5","Polished Brass Pendant, 1-100 watt Medium Base, Clear Ribbed Glass","Accounts Receivable",NA,160,98096.8
"1297","Inventory Asset","Invoice","2018-08-17","71075","Cole Home Builders:Phase 1 - Lot 5","Tapestry, (2-60 watt Med), Etched Cracked Glass, Finish 10","Accounts Receivable",NA,60,98036.8
"1298","Inventory Asset","Invoice","2018-08-17","71075","Cole Home Builders:Phase 1 - Lot 5","Verona Collection, Pendant, Cobblestone, Etched Alabaster Glass, 150 watt max","Accounts Receivable",NA,140,97896.8
"1299","Inventory Asset","Invoice","2018-08-17","71075","Cole Home Builders:Phase 1 - Lot 5","Pendant Bar, Cobblestone, 50lbs. max","Accounts Receivable",NA,22.74,97874.06
"1300","Inventory Asset","Invoice","2018-08-17","71075","Cole Home Builders:Phase 1 - Lot 5","Pearl Nickle, 5 Light, Medium Base (100 watt max)","Accounts Receivable",NA,80,97794.06
"1301","Inventory Asset","Invoice","2018-08-17","71075","Cole Home Builders:Phase 1 - Lot 5","White, 4.5x7.5, 1-100 watt Medium Base, Satin White Glass","Accounts Receivable",NA,30,97764.06
"1302","Inventory Asset","Invoice","2018-08-17","71075","Cole Home Builders:Phase 1 - Lot 5","Solid Brass, 4-light, 25x13x10.75, 4-60 watt, Medium Base, Satin Etched Glass","Accounts Receivable",NA,19,97745.06
"1303","Inventory Asset","Invoice","2018-08-17","71075","Cole Home Builders:Phase 1 - Lot 5","Acid Verde, 10x21x10, 2-60 watt cand.","Accounts Receivable",NA,60,97685.06
"1304","Inventory Asset","Invoice","2018-08-17","71075","Cole Home Builders:Phase 1 - Lot 5","BrassGuard Lanterns, Polished Brass, 1-light Wall, (100 watt max)","Accounts Receivable",NA,105,97580.06
"1305","Inventory Asset","Invoice","2018-08-17","71075","Cole Home Builders:Phase 1 - Lot 5","Black Finish, Solid Brass, Clear Glass, Hanging, 2-60 watt max.","Accounts Receivable",NA,38.44,97541.62
"1306","Inventory Asset","Invoice","2018-08-17","71075","Cole Home Builders:Phase 1 - Lot 5","Specialty, Stage & Studio Bulbs  60 watt","Accounts Receivable",NA,15,97526.62
"1307","Inventory Asset","Invoice","2018-08-17","71075","Cole Home Builders:Phase 1 - Lot 5","Specialty Bulbs, 100 watt (6 pack)","Accounts Receivable",NA,47.5,97479.12
"1308","Inventory Asset","Invoice","2018-08-17","71075","Cole Home Builders:Phase 1 - Lot 5","Cand. Light, 20 watts (8 pack)","Accounts Receivable",NA,24,97455.12
"1309","Inventory Asset","Invoice","2018-08-22","71109","Dan A. North Builders:Turner Suites","Tapestry, (2-60 watt Med), Etched Cracked Glass, Finish 10","Accounts Receivable",NA,1500,95955.12
"1310","Inventory Asset","Invoice","2018-08-22","71109","Dan A. North Builders:Turner Suites","Vianne Lanterns, Satin Antiqued Solid Brass, 3-light wall latern, Candelabra base (60 watt max)","Accounts Receivable",NA,2407.14,93547.98
"1311","Inventory Asset","Invoice","2018-08-22","71109","Dan A. North Builders:Turner Suites","Black Finish, Solid Brass, Clear Glass, Hanging, 2-60 watt max.","Accounts Receivable",NA,1441.56,92106.42
"1312","Inventory Asset","Invoice","2018-08-22","71109","Dan A. North Builders:Turner Suites","Specialty, Stage & Studio Bulbs  60 watt","Accounts Receivable",NA,250,91856.42
"1313","Inventory Asset","Invoice","2018-08-24","71074","Cole Home Builders:Phase 1 - Lot 5","Golden Umber (100 watt)  Six Light Chandelier","Accounts Receivable",NA,85,91771.42
"1314","Inventory Asset","Invoice","2018-08-24","71074","Cole Home Builders:Phase 1 - Lot 5","Tapestry (8/60 watt)  Faux Alabaster Glass","Accounts Receivable",NA,75,91696.42
"1315","Inventory Asset","Invoice","2018-08-24","71074","Cole Home Builders:Phase 1 - Lot 5","Polished Brass Pendant, 1-100 watt Medium Base, Clear Ribbed Glass","Accounts Receivable",NA,160,91536.42
"1316","Inventory Asset","Invoice","2018-08-24","71074","Cole Home Builders:Phase 1 - Lot 5","Tapestry, (2-60 watt Med), Etched Cracked Glass, Finish 10","Accounts Receivable",NA,60,91476.42
"1317","Inventory Asset","Invoice","2018-08-24","71074","Cole Home Builders:Phase 1 - Lot 5","Verona Collection, Pendant, Cobblestone, Etched Alabaster Glass, 150 watt max","Accounts Receivable",NA,140,91336.42
"1318","Inventory Asset","Invoice","2018-08-24","71074","Cole Home Builders:Phase 1 - Lot 5","Pendant Bar, Cobblestone, 50lbs. max","Accounts Receivable",NA,22.74,91313.68
"1319","Inventory Asset","Invoice","2018-08-24","71074","Cole Home Builders:Phase 1 - Lot 5","Pearl Nickle, 5 Light, Medium Base (100 watt max)","Accounts Receivable",NA,80,91233.68
"1320","Inventory Asset","Invoice","2018-08-24","71074","Cole Home Builders:Phase 1 - Lot 5","White, 4.5x7.5, 1-100 watt Medium Base, Satin White Glass","Accounts Receivable",NA,30,91203.68
"1321","Inventory Asset","Invoice","2018-08-24","71074","Cole Home Builders:Phase 1 - Lot 5","Solid Brass, 4-light, 25x13x10.75, 4-60 watt, Medium Base, Satin Etched Glass","Accounts Receivable",NA,19,91184.68
"1322","Inventory Asset","Invoice","2018-08-24","71074","Cole Home Builders:Phase 1 - Lot 5","Acid Verde, 10x21x10, 2-60 watt cand.","Accounts Receivable",NA,60,91124.68
"1323","Inventory Asset","Invoice","2018-08-24","71074","Cole Home Builders:Phase 1 - Lot 5","BrassGuard Lanterns, Polished Brass, 1-light Wall, (100 watt max)","Accounts Receivable",NA,105,91019.68
"1324","Inventory Asset","Invoice","2018-08-24","71074","Cole Home Builders:Phase 1 - Lot 5","Black Finish, Solid Brass, Clear Glass, Hanging, 2-60 watt max.","Accounts Receivable",NA,38.44,90981.24
"1325","Inventory Asset","Invoice","2018-08-24","71074","Cole Home Builders:Phase 1 - Lot 5","Specialty, Stage & Studio Bulbs  60 watt","Accounts Receivable",NA,15,90966.24
"1326","Inventory Asset","Invoice","2018-08-24","71074","Cole Home Builders:Phase 1 - Lot 5","Specialty Bulbs, 100 watt (6 pack)","Accounts Receivable",NA,47.5,90918.74
"1327","Inventory Asset","Invoice","2018-08-24","71074","Cole Home Builders:Phase 1 - Lot 5","Cand. Light, 20 watts (8 pack)","Accounts Receivable",NA,24,90894.74
"1328","Inventory Asset","Invoice","2018-08-30","71130","Kern Lighting Warehouse:Store #45","Renaissance Collection, (100 watt max) Millstone Finish, One-light","Accounts Receivable",NA,411.93,90482.81
"1329","Inventory Asset","Invoice","2018-08-30","71130","Kern Lighting Warehouse:Store #45","Pearl Nickle, 5 Light, Medium Base (100 watt max)","Accounts Receivable",NA,1600,88882.81
"1330","Inventory Asset","Invoice","2018-08-30","71130","Kern Lighting Warehouse:Store #45","Specialty Bulbs, 100 watt (6 pack)","Accounts Receivable",NA,118.75,88764.06
"1331","Inventory Asset","Invoice","2018-08-30","71130","Kern Lighting Warehouse:Store #45","Cand. Light, 20 watts (8 pack)","Accounts Receivable",NA,1200,87564.06
"1332","Inventory Asset","Invoice","2018-08-31","71073","Cole Home Builders:Phase 1 - Lot 5","Golden Umber (100 watt)  Six Light Chandelier","Accounts Receivable",NA,85,87479.06
"1333","Inventory Asset","Invoice","2018-08-31","71073","Cole Home Builders:Phase 1 - Lot 5","Tapestry (8/60 watt)  Faux Alabaster Glass","Accounts Receivable",NA,75,87404.06
"1334","Inventory Asset","Invoice","2018-08-31","71073","Cole Home Builders:Phase 1 - Lot 5","Polished Brass Pendant, 1-100 watt Medium Base, Clear Ribbed Glass","Accounts Receivable",NA,160,87244.06
"1335","Inventory Asset","Invoice","2018-08-31","71073","Cole Home Builders:Phase 1 - Lot 5","Tapestry, (2-60 watt Med), Etched Cracked Glass, Finish 10","Accounts Receivable",NA,60,87184.06
"1336","Inventory Asset","Invoice","2018-08-31","71073","Cole Home Builders:Phase 1 - Lot 5","Verona Collection, Pendant, Cobblestone, Etched Alabaster Glass, 150 watt max","Accounts Receivable",NA,140,87044.06
"1337","Inventory Asset","Invoice","2018-08-31","71073","Cole Home Builders:Phase 1 - Lot 5","Pendant Bar, Cobblestone, 50lbs. max","Accounts Receivable",NA,22.74,87021.32
"1338","Inventory Asset","Invoice","2018-08-31","71073","Cole Home Builders:Phase 1 - Lot 5","Pearl Nickle, 5 Light, Medium Base (100 watt max)","Accounts Receivable",NA,80,86941.32
"1339","Inventory Asset","Invoice","2018-08-31","71073","Cole Home Builders:Phase 1 - Lot 5","White, 4.5x7.5, 1-100 watt Medium Base, Satin White Glass","Accounts Receivable",NA,30,86911.32
"1340","Inventory Asset","Invoice","2018-08-31","71073","Cole Home Builders:Phase 1 - Lot 5","Solid Brass, 4-light, 25x13x10.75, 4-60 watt, Medium Base, Satin Etched Glass","Accounts Receivable",NA,19,86892.32
"1341","Inventory Asset","Invoice","2018-08-31","71073","Cole Home Builders:Phase 1 - Lot 5","Acid Verde, 10x21x10, 2-60 watt cand.","Accounts Receivable",NA,60,86832.32
"1342","Inventory Asset","Invoice","2018-08-31","71073","Cole Home Builders:Phase 1 - Lot 5","BrassGuard Lanterns, Polished Brass, 1-light Wall, (100 watt max)","Accounts Receivable",NA,105,86727.32
"1343","Inventory Asset","Invoice","2018-08-31","71073","Cole Home Builders:Phase 1 - Lot 5","Black Finish, Solid Brass, Clear Glass, Hanging, 2-60 watt max.","Accounts Receivable",NA,38.44,86688.88
"1344","Inventory Asset","Invoice","2018-08-31","71073","Cole Home Builders:Phase 1 - Lot 5","Specialty, Stage & Studio Bulbs  60 watt","Accounts Receivable",NA,15,86673.88
"1345","Inventory Asset","Invoice","2018-08-31","71073","Cole Home Builders:Phase 1 - Lot 5","Specialty Bulbs, 100 watt (6 pack)","Accounts Receivable",NA,47.5,86626.38
"1346","Inventory Asset","Invoice","2018-08-31","71073","Cole Home Builders:Phase 1 - Lot 5","Cand. Light, 20 watts (8 pack)","Accounts Receivable",NA,24,86602.38
"1347","Inventory Asset","Bill","2018-09-06","6785","Hall Lighting & Accessories","Colonial, Brushed Steel Finish, Opal White Glass (60 watt)","Accounts Payable",800,NA,87402.38
"1348","Inventory Asset","Bill","2018-09-06","6785","Hall Lighting & Accessories","Colonial, Finished in Gold (60 watt)  ","Accounts Payable",500,NA,87902.38
"1349","Inventory Asset","Bill","2018-09-06","6785","Hall Lighting & Accessories","Sunset, Clear Glass, 1-100 watt max.","Accounts Payable",7500,NA,95402.38
"1350","Inventory Asset","Bill","2018-09-10","9087","Foster Lighting","White, 4.5x7.5, 1-100 watt Medium Base, Satin White Glass","Accounts Payable",6000,NA,101402.38
"1351","Inventory Asset","Bill","2018-09-10","H8765","Paulsen's Lighting","Renaissance Collection, (100 watt max) Millstone Finish, One-light","Accounts Payable",1500,NA,102902.38
"1352","Inventory Asset","Bill","2018-09-10","H8765","Paulsen's Lighting","Domes, White, 59x21x6 5/8 ht, 120v HPF","Accounts Payable",5400,NA,108302.38
"1353","Inventory Asset","Bill","2018-09-10","H8765","Paulsen's Lighting","Domes, White, 59x21x6 5/8 ht, 120v HPF","Accounts Payable",69,NA,108371.38
"1354","Inventory Asset","Bill","2018-09-10","H8765","Paulsen's Lighting","Flush Mount, Polished Brass (2, 13 watt)  White acrylic diffuser","Accounts Payable",2200,NA,110571.38
"1355","Inventory Asset","Invoice","2018-09-11","71099","Miscellaneous - Retail:Jason Helper","Sunset, Clear Glass, 1-100 watt max.","Accounts Receivable",NA,310.06,110261.32
"1356","Inventory Asset","Invoice","2018-09-11","71099","Miscellaneous - Retail:Jason Helper","Black Finish, Solid Brass, Clear Glass, Hanging, 2-60 watt max.","Accounts Receivable",NA,38.44,110222.88
"1357","Inventory Asset","Invoice","2018-09-11","71099","Miscellaneous - Retail:Jason Helper","White, 4.5x7.5, 1-100 watt Medium Base, Satin White Glass","Accounts Receivable",NA,60,110162.88
"1358","Inventory Asset","Invoice","2018-09-11","71099","Miscellaneous - Retail:Jason Helper","Golden Umber (100 watt)  Six Light Chandelier","Accounts Receivable",NA,170,109992.88
"1359","Inventory Asset","Invoice","2018-09-11","71099","Miscellaneous - Retail:Jason Helper","Brushed Nickel, Pendant, 1-100 watt Medium Base, Satin Etched Glass","Accounts Receivable",NA,100,109892.88
"1360","Inventory Asset","Invoice","2018-09-11","71099","Miscellaneous - Retail:Jason Helper","Pendant Bar, Textured White, 50lbs max","Accounts Receivable",NA,21.54,109871.34
"1361","Inventory Asset","Invoice","2018-09-14","71091","Cole Home Builders:Phase 2 - Lot 5","Golden Umber (100 watt)  Six Light Chandelier","Accounts Receivable",NA,85,109786.34
"1362","Inventory Asset","Invoice","2018-09-14","71091","Cole Home Builders:Phase 2 - Lot 5","Tapestry (8/60 watt)  Faux Alabaster Glass","Accounts Receivable",NA,75,109711.34
"1363","Inventory Asset","Invoice","2018-09-14","71091","Cole Home Builders:Phase 2 - Lot 5","Polished Brass Pendant, 1-100 watt Medium Base, Clear Ribbed Glass","Accounts Receivable",NA,160,109551.34
"1364","Inventory Asset","Invoice","2018-09-14","71091","Cole Home Builders:Phase 2 - Lot 5","Tapestry, (2-60 watt Med), Etched Cracked Glass, Finish 10","Accounts Receivable",NA,60,109491.34
"1365","Inventory Asset","Invoice","2018-09-14","71091","Cole Home Builders:Phase 2 - Lot 5","Verona Collection, Pendant, Cobblestone, Etched Alabaster Glass, 150 watt max","Accounts Receivable",NA,140,109351.34
"1366","Inventory Asset","Invoice","2018-09-14","71091","Cole Home Builders:Phase 2 - Lot 5","Pendant Bar, Cobblestone, 50lbs. max","Accounts Receivable",NA,22.74,109328.6
"1367","Inventory Asset","Invoice","2018-09-14","71091","Cole Home Builders:Phase 2 - Lot 5","Pearl Nickle, 5 Light, Medium Base (100 watt max)","Accounts Receivable",NA,80,109248.6
"1368","Inventory Asset","Invoice","2018-09-14","71091","Cole Home Builders:Phase 2 - Lot 5","White, 4.5x7.5, 1-100 watt Medium Base, Satin White Glass","Accounts Receivable",NA,30,109218.6
"1369","Inventory Asset","Invoice","2018-09-14","71091","Cole Home Builders:Phase 2 - Lot 5","Solid Brass, 4-light, 25x13x10.75, 4-60 watt, Medium Base, Satin Etched Glass","Accounts Receivable",NA,19,109199.6
"1370","Inventory Asset","Invoice","2018-09-14","71091","Cole Home Builders:Phase 2 - Lot 5","Acid Verde, 10x21x10, 2-60 watt cand.","Accounts Receivable",NA,60,109139.6
"1371","Inventory Asset","Invoice","2018-09-14","71091","Cole Home Builders:Phase 2 - Lot 5","BrassGuard Lanterns, Polished Brass, 1-light Wall, (100 watt max)","Accounts Receivable",NA,105,109034.6
"1372","Inventory Asset","Invoice","2018-09-14","71091","Cole Home Builders:Phase 2 - Lot 5","Black Finish, Solid Brass, Clear Glass, Hanging, 2-60 watt max.","Accounts Receivable",NA,38.44,108996.16
"1373","Inventory Asset","Invoice","2018-09-14","71091","Cole Home Builders:Phase 2 - Lot 5","Specialty, Stage & Studio Bulbs  60 watt","Accounts Receivable",NA,15,108981.16
"1374","Inventory Asset","Invoice","2018-09-14","71091","Cole Home Builders:Phase 2 - Lot 5","Specialty Bulbs, 100 watt (6 pack)","Accounts Receivable",NA,47.5,108933.66
"1375","Inventory Asset","Invoice","2018-09-14","71091","Cole Home Builders:Phase 2 - Lot 5","Cand. Light, 20 watts (8 pack)","Accounts Receivable",NA,24,108909.66
"1376","Inventory Asset","Invoice","2018-09-19","71131","Kern Lighting Warehouse:Store #13","White, 4.5x7.5, 1-100 watt Medium Base, Satin White Glass","Accounts Receivable",NA,240,108669.66
"1377","Inventory Asset","Invoice","2018-09-19","71131","Kern Lighting Warehouse:Store #13","Solid Brass, 4-light, 25x13x10.75, 4-60 watt, Medium Base, Satin Etched Glass","Accounts Receivable",NA,304,108365.66
"1378","Inventory Asset","Invoice","2018-09-19","71131","Kern Lighting Warehouse:Store #13","Brushed Nickel, 18x7.75x6, 3-60 watt Medium Base, Satin Opal Glass","Accounts Receivable",NA,462.5,107903.16
"1379","Inventory Asset","Invoice","2018-09-19","71131","Kern Lighting Warehouse:Store #13","River Rock (8/60 watt)  Faux Alabaster Glass","Accounts Receivable",NA,600,107303.16
"1380","Inventory Asset","Invoice","2018-09-19","71131","Kern Lighting Warehouse:Store #13","Die Cast Lanterns, Black, 1-100 watt, Medium Base, Clear Cracked Glass","Accounts Receivable",NA,770.64,106532.52
"1381","Inventory Asset","Invoice","2018-09-25","71100","Miscellaneous - Retail:John Huhn","Roman Bronze, 1-light Lantern, w/tail, (100 watt max)","Accounts Receivable",NA,570,105962.52
"1382","Inventory Asset","Invoice","2018-09-25","71100","Miscellaneous - Retail:John Huhn","18x8x10, Solid Brass, 3-60watt Medium Base, Satin Etched Glass","Accounts Receivable",NA,130.38,105832.14
"1383","Inventory Asset","Invoice","2018-09-25","71100","Miscellaneous - Retail:John Huhn","Verona Collection, Pendant, Cobblestone, Etched Alabaster Glass, 150 watt max","Accounts Receivable",NA,280,105552.14
"1384","Inventory Asset","Invoice","2018-09-25","71100","Miscellaneous - Retail:John Huhn","Pendant Bar, Cobblestone, 50lbs. max","Accounts Receivable",NA,45.48,105506.66
"1385","Inventory Asset","Invoice","2018-09-25","71107","Stern Commercial Contractor's:Tittle Properties","White, 4.5x7.5, 1-100 watt Medium Base, Satin White Glass","Accounts Receivable",NA,3000,102506.66
"1386","Inventory Asset","Invoice","2018-09-25","71107","Stern Commercial Contractor's:Tittle Properties","Colonial, Brushed Steel Finish, Opal White Glass (60 watt)","Accounts Receivable",NA,1000,101506.66
"1387","Inventory Asset","Invoice","2018-09-25","71107","Stern Commercial Contractor's:Tittle Properties","Colonial, Finished in Gold (60 watt)  ","Accounts Receivable",NA,1000,100506.66
"1388","Inventory Asset","Invoice","2018-09-25","71107","Stern Commercial Contractor's:Tittle Properties","Sunset, Clear Glass, 1-100 watt max.","Accounts Receivable",NA,3100.64,97406.02
"1389","Inventory Asset","Invoice","2018-09-25","71107","Stern Commercial Contractor's:Tittle Properties","Specialty Bulbs, 100 watt (6 pack)","Accounts Receivable",NA,95,97311.02
"1390","Inventory Asset","Invoice","2018-09-25","71107","Stern Commercial Contractor's:Tittle Properties","Fluorescent Lamp, T-12, Medium Bipin  (30pack)","Accounts Receivable",NA,634.29,96676.73
"1391","Inventory Asset","Bill","2018-10-05","9807-02","Peacock Bulb Manufacturing Company","Fluorescent Lamp, T-12, Medium Bipin  (30pack)","Accounts Payable",112.5,NA,96789.23
"1392","Inventory Asset","Bill","2018-10-05","9807-02","Peacock Bulb Manufacturing Company","Halogen Lamp, Volts:3.5  Tubular","Accounts Payable",62.5,NA,96851.73
"1393","Inventory Asset","Invoice","2018-10-09","71101","Miscellaneous - Retail:Doug Jacobsen","Die Cast Lanterns, Black, 1-100 watt, Medium Base, Clear Cracked Glass","Accounts Receivable",NA,308.26,96543.47
"1394","Inventory Asset","Invoice","2018-10-09","71101","Miscellaneous - Retail:Doug Jacobsen","Black Finish, Solid Brass, Clear Glass, Hanging, 2-60 watt max.","Accounts Receivable",NA,38.44,96505.03
"1395","Inventory Asset","Invoice","2018-10-09","71101","Miscellaneous - Retail:Doug Jacobsen","Tapestry (8/60 watt)  Faux Alabaster Glass","Accounts Receivable",NA,225,96280.03
"1396","Inventory Asset","Invoice","2018-10-09","71101","Miscellaneous - Retail:Doug Jacobsen","Broadway Collection, Polished Chrome, 4 Light (60 watt max)","Accounts Receivable",NA,126,96154.03
"1397","Inventory Asset","Invoice","2018-10-09","71101","Miscellaneous - Retail:Doug Jacobsen","Flat Glass, (25 watt max) Polished Brass, 4 light","Accounts Receivable",NA,24.25,96129.78
"1398","Inventory Asset","Invoice","2018-10-15","71132","Kern Lighting Warehouse:Store #34","Acid Verde, 10x21x10, 2-60 watt cand.","Accounts Receivable",NA,1050,95079.78
"1399","Inventory Asset","Invoice","2018-10-15","71132","Kern Lighting Warehouse:Store #34","Die Cast Lanterns, Black, 1-100 watt, Medium Base, Clear Cracked Glass","Accounts Receivable",NA,770.64,94309.14
"1400","Inventory Asset","Invoice","2018-10-15","71132","Kern Lighting Warehouse:Store #34","Polished Brass Pendant, 1-100 watt Medium Base, Clear Ribbed Glass","Accounts Receivable",NA,32,94277.14
"1401","Inventory Asset","Invoice","2018-10-15","71132","Kern Lighting Warehouse:Store #34","Brushed Nickel, 18x7.75x6, 3-60 watt Medium Base, Satin Opal Glass","Accounts Receivable",NA,185,94092.14
"1402","Inventory Asset","Invoice","2018-10-15","71132","Kern Lighting Warehouse:Store #34","Brushed Nickel, (3-60 watt, Med) Ribbed Glass","Accounts Receivable",NA,120,93972.14
"1403","Inventory Asset","Invoice","2018-10-15","71132","Kern Lighting Warehouse:Store #34","Fluorescent Lamp, T-12, Medium Bipin  (30pack)","Accounts Receivable",NA,320.13,93652.01
"1404","Inventory Asset","Invoice","2018-10-15","71132","Kern Lighting Warehouse:Store #34","Halogen Lamp, 20 watts, Luminous Intensity","Accounts Receivable",NA,34.8,93617.21
"1405","Inventory Asset","Invoice","2018-10-15","71132","Kern Lighting Warehouse:Store #34","Halogen Lamp, Volts:3.5  Tubular","Accounts Receivable",NA,50,93567.21
"1406","Inventory Asset","Invoice","2018-10-15","71132","Kern Lighting Warehouse:Store #34","Cand. Light, 20 watts (8 pack)","Accounts Receivable",NA,84,93483.21
"1407","Inventory Asset","Invoice","2018-10-15","71132","Kern Lighting Warehouse:Store #34","Broadway Collection, Polished Chrome, 4 Light (60 watt max)","Accounts Receivable",NA,2100,91383.21
"1408","Inventory Asset","Invoice","2018-10-15","71132","Kern Lighting Warehouse:Store #34","Golden Umber (100 watt)  Six Light Chandelier","Accounts Receivable",NA,850,90533.21
"1409","Inventory Asset","Invoice","2018-10-25","71102","Miscellaneous - Retail:Peter Karpas","Roman Bronze, 1-light Lantern, w/tail, (100 watt max)","Accounts Receivable",NA,304,90229.21
"1410","Inventory Asset","Invoice","2018-10-25","71102","Miscellaneous - Retail:Peter Karpas","Black Finish, Solid Brass, Clear Glass, Hanging, 2-60 watt max.","Accounts Receivable",NA,57.66,90171.55
"1411","Inventory Asset","Invoice","2018-10-25","71102","Miscellaneous - Retail:Peter Karpas","Broadway Collection, Polished Brass, 6 Light (60 watt max)","Accounts Receivable",NA,120,90051.55
"1412","Inventory Asset","Invoice","2018-10-25","71102","Miscellaneous - Retail:Peter Karpas","Frosted Taupe (3/60 watt)  Marble Glass  ","Accounts Receivable",NA,178.42,89873.13
"1413","Inventory Asset","Invoice","2018-10-26","71108","Stern Commercial Contractor's:Wilson Suites","Flush Mount, Polished Brass (2, 13 watt)  White acrylic diffuser","Accounts Receivable",NA,1235.29,88637.84
"1414","Inventory Asset","Invoice","2018-10-26","71108","Stern Commercial Contractor's:Wilson Suites","Sunset, Clear Glass, 1-100 watt max.","Accounts Receivable",NA,3100.64,85537.2
"1415","Inventory Asset","Invoice","2018-10-26","71108","Stern Commercial Contractor's:Wilson Suites","White, 4.5x7.5, 1-100 watt Medium Base, Satin White Glass","Accounts Receivable",NA,3000,82537.2
"1416","Inventory Asset","Invoice","2018-11-01","71120","Kern Lighting Warehouse:Store #13","18x8x10, Solid Brass, 3-60watt Medium Base, Satin Etched Glass","Accounts Receivable",NA,1629.76,80907.44
"1417","Inventory Asset","Invoice","2018-11-01","71120","Kern Lighting Warehouse:Store #13","Burnished Brass (60 watt)  w/Golden Umber Accents","Accounts Receivable",NA,750,80157.44
"1418","Inventory Asset","Invoice","2018-11-01","71120","Kern Lighting Warehouse:Store #13","2032 Series, (3-60 watt, Med) Desert Stone Finish","Accounts Receivable",NA,540,79617.44
"1419","Inventory Asset","Invoice","2018-11-01","71120","Kern Lighting Warehouse:Store #13","Tapestry, (2-60 watt Med), Etched Cracked Glass, Finish 10","Accounts Receivable",NA,300,79317.44
"1420","Inventory Asset","Invoice","2018-11-05","71103","Miscellaneous - Retail:Valesha Jones","Acid Verde, 10x21x10, 2-60 watt cand.","Accounts Receivable",NA,450,78867.44
"1421","Inventory Asset","Invoice","2018-11-05","71103","Miscellaneous - Retail:Valesha Jones","Black Finish, Solid Brass, Clear Glass, Hanging, 2-60 watt max.","Accounts Receivable",NA,38.44,78829
"1422","Inventory Asset","Invoice","2018-11-05","71103","Miscellaneous - Retail:Valesha Jones","Golden Umber (100 watt)  Six Light Chandelier","Accounts Receivable",NA,255,78574
"1423","Inventory Asset","Invoice","2018-11-05","71103","Miscellaneous - Retail:Valesha Jones","18x8x10, Solid Brass, 3-60watt Medium Base, Satin Etched Glass","Accounts Receivable",NA,130.38,78443.62
"1424","Inventory Asset","Invoice","2018-11-05","71103","Miscellaneous - Retail:Valesha Jones","Polished Brass Pendant, 1-100 watt Medium Base, Clear Ribbed Glass","Accounts Receivable",NA,128,78315.62
"1425","Inventory Asset","Invoice","2018-11-05","71117","Lavery Lighting & Design:Store #JL-01","Chestnut (3/60 watt)  Marble Glass","Accounts Receivable",NA,194.4,78121.22
"1426","Inventory Asset","Invoice","2018-11-05","71117","Lavery Lighting & Design:Store #JL-01","Tiffany Collection,Golden Baroque, 1-light lantern, medium base (100 watt max)","Accounts Receivable",NA,336,77785.22
"1427","Inventory Asset","Invoice","2018-11-05","71117","Lavery Lighting & Design:Store #JL-01","Die Cast Lanterns, Black, 1-100 watt, Medium Base, Clear Cracked Glass","Accounts Receivable",NA,577.98,77207.24
"1428","Inventory Asset","Invoice","2018-11-05","71117","Lavery Lighting & Design:Store #JL-01","Golden Umber (100 watt)  Six Light Chandelier","Accounts Receivable",NA,170,77037.24
"1429","Inventory Asset","Invoice","2018-11-05","71117","Lavery Lighting & Design:Store #JL-01","Beveled Mirror, Etched Ribbed Glass (75 watt max)","Accounts Receivable",NA,244.97,76792.27
"1430","Inventory Asset","Invoice","2018-11-05","71117","Lavery Lighting & Design:Store #JL-01","Pearl Nickle, 5 Light, Medium Base (100 watt max)","Accounts Receivable",NA,200,76592.27
"1431","Inventory Asset","Invoice","2018-11-05","71117","Lavery Lighting & Design:Store #JL-01","Polished Brass Pendant, 1-100 watt Medium Base, Clear Ribbed Glass","Accounts Receivable",NA,64,76528.27
"1432","Inventory Asset","Invoice","2018-11-05","71117","Lavery Lighting & Design:Store #JL-01","Athena Collection, Pendant, Textured White, Med. Base, 100 watt max.","Accounts Receivable",NA,120,76408.27
"1433","Inventory Asset","Invoice","2018-11-05","71117","Lavery Lighting & Design:Store #JL-01","Verona Collection, Pendant, Cobblestone, Etched Alabaster Glass, 150 watt max","Accounts Receivable",NA,140,76268.27
"1434","Inventory Asset","Invoice","2018-11-05","71117","Lavery Lighting & Design:Store #JL-01","Black Finish, Solid Brass, Clear Glass, Hanging, 2-60 watt max.","Accounts Receivable",NA,38.44,76229.83
"1435","Inventory Asset","Invoice","2018-11-05","71117","Lavery Lighting & Design:Store #JL-01","Fluorescent Lamp, T-12, Medium Bipin  (30pack)","Accounts Receivable",NA,12.81,76217.02
"1436","Inventory Asset","Invoice","2018-11-05","71117","Lavery Lighting & Design:Store #JL-01","Cand. Light, 20 watts (8 pack)","Accounts Receivable",NA,120,76097.02
"1437","Inventory Asset","Invoice","2018-11-05","71117","Lavery Lighting & Design:Store #JL-01","Specialty Bulbs, 100 watt (6 pack)","Accounts Receivable",NA,47.5,76049.52
"1438","Inventory Asset","Invoice","2018-11-05","71117","Lavery Lighting & Design:Store #JL-01","Specialty, Stage & Studio Bulbs  60 watt","Accounts Receivable",NA,50,75999.52
"1439","Inventory Asset","Bill","2018-11-15",NA,"Peacock Bulb Manufacturing Company","3370-4658  Fluorescent Lamp, T-12, Medium Blipping  (30pack)","Accounts Payable",750,NA,76749.52
"1440","Inventory Asset","Bill","2018-11-15",NA,"Peacock Bulb Manufacturing Company","3370-4563  Fluorescent Lamp, T-5, Blipping","Accounts Payable",45,NA,76794.52
"1441","Inventory Asset","Bill","2018-11-15",NA,"Peacock Bulb Manufacturing Company","3370-4673  Halogen Lamp, Volts:3.5  Tubular","Accounts Payable",100,NA,76894.52
"1442","Inventory Asset","Bill","2018-11-15",NA,"Peacock Bulb Manufacturing Company","3370-4443  Halogen Lamp, 20 watts, Luminous Intensity","Accounts Payable",105,NA,76999.52
"1443","Inventory Asset","Bill","2018-11-15",NA,"Peacock Bulb Manufacturing Company","3380-0008  Specialty Bulbs, 100 watt (6 pack)","Accounts Payable",950,NA,77949.52
"1444","Inventory Asset","Bill","2018-11-15",NA,"Peacock Bulb Manufacturing Company","3380-0013  Specialty, Stage & Studio Bulbs  60 watt (set of 4)","Accounts Payable",500,NA,78449.52
"1445","Inventory Asset","Invoice","2018-11-16","71118","Lavery Lighting & Design:Store #JL-04","Acid Verde, 10x21x10, 2-60 watt cand.","Accounts Receivable",NA,900,77549.52
"1446","Inventory Asset","Invoice","2018-11-16","71118","Lavery Lighting & Design:Store #JL-04","Die Cast Lanterns, Black, 1-100 watt, Medium Base, Clear Cracked Glass","Accounts Receivable",NA,577.98,76971.54
"1447","Inventory Asset","Invoice","2018-11-16","71118","Lavery Lighting & Design:Store #JL-04","Vianne Lanterns, Satin Antiqued Solid Brass, 3-light wall latern, Candelabra base (60 watt max)","Accounts Receivable",NA,1203.57,75767.97
"1448","Inventory Asset","Invoice","2018-11-16","71118","Lavery Lighting & Design:Store #JL-04","Tapestry (8/60 watt)  Faux Alabaster Glass","Accounts Receivable",NA,375,75392.97
"1449","Inventory Asset","Invoice","2018-11-16","71118","Lavery Lighting & Design:Store #JL-04","Frosted Taupe (3/60 watt)  Marble Glass  ","Accounts Receivable",NA,267.63,75125.34
"1450","Inventory Asset","Invoice","2018-11-16","71118","Lavery Lighting & Design:Store #JL-04","Chestnut (3/60 watt)  Marble Glass","Accounts Receivable",NA,291.6,74833.74
"1451","Inventory Asset","Invoice","2018-11-16","71118","Lavery Lighting & Design:Store #JL-04","Black Finish, Solid Brass, Clear Glass, Hanging, 2-60 watt max.","Accounts Receivable",NA,384.42,74449.32
"1452","Inventory Asset","Invoice","2018-11-16","71118","Lavery Lighting & Design:Store #JL-04","Tiffany Collection,Golden Baroque, 1-light lantern, medium base (100 watt max)","Accounts Receivable",NA,480,73969.32
"1453","Inventory Asset","Invoice","2018-11-16","71118","Lavery Lighting & Design:Store #JL-04","Beveled Mirror, Etched Ribbed Glass (75 watt max)","Accounts Receivable",NA,489.94,73479.38
"1454","Inventory Asset","Invoice","2018-11-16","71118","Lavery Lighting & Design:Store #JL-04","Specialty Bulbs, 100 watt (6 pack)","Accounts Receivable",NA,71.25,73408.13
"1455","Inventory Asset","Invoice","2018-11-16","71118","Lavery Lighting & Design:Store #JL-04","Specialty, Stage & Studio Bulbs  60 watt","Accounts Receivable",NA,25,73383.13
"1456","Inventory Asset","Invoice","2018-11-20","71104","Miscellaneous - Retail:Melanie Hall","Vianne Lanterns, Satin Antiqued Solid Brass, 3-light wall latern, Candelabra base (60 watt max)","Accounts Receivable",NA,240.71,73142.42
"1457","Inventory Asset","Invoice","2018-11-20","71104","Miscellaneous - Retail:Melanie Hall","Broadway Collection, Polished Chrome, 4 Light (60 watt max)","Accounts Receivable",NA,210,72932.42
"1458","Inventory Asset","Invoice","2018-11-20","71104","Miscellaneous - Retail:Melanie Hall","Brushed Nickel, Pendant, 1-100 watt Medium Base, Satin Etched Glass","Accounts Receivable",NA,200,72732.42
"1459","Inventory Asset","Invoice","2018-11-20","71104","Miscellaneous - Retail:Melanie Hall","Pendant Bar, Textured White, 50lbs max","Accounts Receivable",NA,43.08,72689.34
"1460","Inventory Asset","Invoice","2018-11-20","71104","Miscellaneous - Retail:Melanie Hall","Chestnut (3/60 watt)  Marble Glass","Accounts Receivable",NA,97.2,72592.14
"1461","Inventory Asset","Invoice","2018-11-22","71133","Kern Lighting Warehouse:Store #01","Sunset, Clear Glass, 1-100 watt max.","Accounts Receivable",NA,77.52,72514.62
"1462","Inventory Asset","Invoice","2018-11-22","71133","Kern Lighting Warehouse:Store #01","Beveled Mirror, Etched Ribbed Glass (75 watt max)","Accounts Receivable",NA,857.4,71657.22
"1463","Inventory Asset","Invoice","2018-11-22","71133","Kern Lighting Warehouse:Store #01","Pendant Bar, Textured White, 50lbs max","Accounts Receivable",NA,204.62,71452.6
"1464","Inventory Asset","Invoice","2018-11-22","71133","Kern Lighting Warehouse:Store #01","Pendant Bar, Cobblestone, 50lbs. max","Accounts Receivable",NA,68.22,71384.38
"1465","Inventory Asset","Invoice","2018-11-22","71133","Kern Lighting Warehouse:Store #01","Domes, White, 59x21x6 5/8 ht, 120v HPF","Accounts Receivable",NA,180,71204.38
"1466","Inventory Asset","Invoice","2018-11-22","71133","Kern Lighting Warehouse:Store #01","Flat Glass, (25 watt max) Polished Brass, 4 light","Accounts Receivable",NA,36.37,71168.01
"1467","Inventory Asset","Invoice","2018-11-22","71133","Kern Lighting Warehouse:Store #01","Verona Collection, Pendant, Cobblestone, Etched Alabaster Glass, 150 watt max","Accounts Receivable",NA,595,70573.01
"1468","Inventory Asset","Invoice","2018-11-22","71133","Kern Lighting Warehouse:Store #01","Burnished Brass (60 watt)  w/Golden Umber Accents","Accounts Receivable",NA,3525,67048.01
"1469","Inventory Asset","Invoice","2018-11-22","71133","Kern Lighting Warehouse:Store #01","Renaissance Collection, (100 watt max) Millstone Finish, One-light","Accounts Receivable",NA,261.78,66786.23
"1470","Inventory Asset","Invoice","2018-11-22","71133","Kern Lighting Warehouse:Store #01","Broadway Collection, Polished Chrome, 4 Light (60 watt max)","Accounts Receivable",NA,84,66702.23
"1471","Inventory Asset","Invoice","2018-11-29","71123","Kern Lighting Warehouse:Store #13","18x8x10, Solid Brass, 3-60watt Medium Base, Satin Etched Glass","Accounts Receivable",0,NA,66702.23
"1472","Inventory Asset","Invoice","2018-11-29","71123","Kern Lighting Warehouse:Store #13","Burnished Brass (60 watt)  w/Golden Umber Accents","Accounts Receivable",0,NA,66702.23
"1473","Inventory Asset","Invoice","2018-11-29","71123","Kern Lighting Warehouse:Store #13","2032 Series, (3-60 watt, Med) Desert Stone Finish","Accounts Receivable",NA,60,66642.23
"1474","Inventory Asset","Invoice","2018-11-29","71123","Kern Lighting Warehouse:Store #13","Tapestry, (2-60 watt Med), Etched Cracked Glass, Finish 10","Accounts Receivable",0,NA,66642.23
"1475","Inventory Asset","Invoice","2018-12-03","71139","Lavery Lighting & Design:Store #JL-08","Acid Verde, 10x21x10, 2-60 watt cand.","Accounts Receivable",NA,300,66342.23
"1476","Inventory Asset","Invoice","2018-12-03","71139","Lavery Lighting & Design:Store #JL-08","Brushed Nickel, Pendant, 1-100 watt Medium Base, Satin Etched Glass","Accounts Receivable",NA,250,66092.23
"1477","Inventory Asset","Invoice","2018-12-03","71139","Lavery Lighting & Design:Store #JL-08","White, 4.5x7.5, 1-100 watt Medium Base, Satin White Glass","Accounts Receivable",NA,225,65867.23
"1478","Inventory Asset","Invoice","2018-12-03","71139","Lavery Lighting & Design:Store #JL-08","River Rock (8/60 watt)  Faux Alabaster Glass","Accounts Receivable",NA,375,65492.23
"1479","Inventory Asset","Invoice","2018-12-03","71139","Lavery Lighting & Design:Store #JL-08","Specialty, Stage & Studio Bulbs  60 watt","Accounts Receivable",NA,25,65467.23
"1480","Inventory Asset","Invoice","2018-12-03","71139","Lavery Lighting & Design:Store #JL-08","Halogen Lamp, Volts:3.5  Tubular","Accounts Receivable",NA,5,65462.23
"1481","Inventory Asset","Invoice","2018-12-03","71139","Lavery Lighting & Design:Store #JL-08","Cand. Light, 20 watts (8 pack)","Accounts Receivable",0,NA,65462.23
"1482","Inventory Asset","Bill","2018-12-06","FL0987","Foster Lighting","057-AV102110  Acid Verde, 10x21x10, 2-60 watt cand.","Accounts Payable",150,NA,65612.23
"1483","Inventory Asset","Bill","2018-12-06","FL0987","Foster Lighting","057-FAG8-60  Tapestry (8/60 watt)  Faux Alabaster Glass","Accounts Payable",375,NA,65987.23
"1484","Inventory Asset","Bill","2018-12-06","FL0987","Foster Lighting","057-RR8-60  River Rock (8/60 watt)  Faux Alabaster Glass","Accounts Payable",375,NA,66362.23
"1485","Inventory Asset","Bill","2018-12-06","FL0987","Foster Lighting","057-PBP1-100  Polished Brass Pendant, 1-100 watt Medium Base, Clear Ribbed Glass","Accounts Payable",320,NA,66682.23
"1486","Inventory Asset","Bill","2018-12-06","FL0987","Foster Lighting","057-C3-60  Chestnut (3/60 watt)  Marble Glass","Accounts Payable",950,NA,67632.23
"1487","Inventory Asset","Invoice","2018-12-07","71138","Baker's Professional Lighting:Store #10","Fluorescent Lamp, Medium Bipin (30pack)","Accounts Receivable",NA,1412.32,66219.91
"1488","Inventory Asset","Invoice","2018-12-07","71138","Baker's Professional Lighting:Store #10","Fluorescent Lamp, Large Bipin (30 pack)","Accounts Receivable",NA,90,66129.91
"1489","Inventory Asset","Invoice","2018-12-07","71138","Baker's Professional Lighting:Store #10","Halogen Lamp, 3.5 Volts, Tubular","Accounts Receivable",NA,150,65979.91
"1490","Inventory Asset","Invoice","2018-12-07","71138","Baker's Professional Lighting:Store #10","Cand. Light, 20 watts (8 pack)","Accounts Receivable",NA,384,65595.91
"1491","Inventory Asset","Invoice","2018-12-07","71138","Baker's Professional Lighting:Store #10","100 watt (6 pack)","Accounts Receivable",NA,1425,64170.91
"1492","Inventory Asset","Invoice","2018-12-07","71138","Baker's Professional Lighting:Store #10","Stage & Studio, 60 watt (set of 4)","Accounts Receivable",NA,750,63420.91
"1493","Inventory Asset","Invoice","2018-12-10","71105","Miscellaneous - Retail:Lara Gussman","Die Cast Lanterns, Black, 1-100 watt, Medium Base, Clear Cracked Glass","Accounts Receivable",NA,423.85,62997.06
"1494","Inventory Asset","Invoice","2018-12-10","71105","Miscellaneous - Retail:Lara Gussman","Black Finish, Solid Brass, Clear Glass, Hanging, 2-60 watt max.","Accounts Receivable",NA,38.44,62958.62
"1495","Inventory Asset","Invoice","2018-12-10","71105","Miscellaneous - Retail:Lara Gussman","Beveled Mirror, Etched Ribbed Glass (75 watt max)","Accounts Receivable",NA,97.99,62860.63
"1496","Inventory Asset","Invoice","2018-12-10","71105","Miscellaneous - Retail:Lara Gussman","Chestnut (3/60 watt)  Marble Glass","Accounts Receivable",NA,96.49,62764.14
"1497","Inventory Asset","Invoice","2018-12-10","71105","Miscellaneous - Retail:Lara Gussman","Brushed Nickel, (3-60 watt, Med) Ribbed Glass","Accounts Receivable",NA,60,62704.14
"1498","Inventory Asset","Invoice","2018-12-10","71105","Miscellaneous - Retail:Lara Gussman","2032 Series, (3-60 watt, Med) Desert Stone Finish","Accounts Receivable",NA,48,62656.14
"1499","Inventory Asset","Invoice","2018-12-10","71105","Miscellaneous - Retail:Lara Gussman","Colonial, Brushed Steel Finish, Opal White Glass (60 watt)","Accounts Receivable",NA,20,62636.14
"1500","Inventory Asset","Bill","2018-12-11","TB-0987","Peacock Bulb Manufacturing Company","3370-4658  Fluorescent Lamp, T-12, Medium Bipin  (30pack)","Accounts Payable",150,NA,62786.14
"1501","Inventory Asset","Bill","2018-12-11","TB-0987","Peacock Bulb Manufacturing Company","3370-4673  Halogen Lamp, Volts:3.5  Tubular","Accounts Payable",50,NA,62836.14
"1502","Inventory Asset","Bill","2018-12-11","TB-0987","Peacock Bulb Manufacturing Company","3380-0008  Specialty Bulbs, 100 watt (6 pack)","Accounts Payable",475,NA,63311.14
"1503","Inventory Asset","Bill","2018-12-11","TB-0987","Peacock Bulb Manufacturing Company","3380-0013  Specialty, Stage & Studio Bulbs  60 watt (set of 4)","Accounts Payable",125,NA,63436.14
"1504","Inventory Asset","Invoice","2018-12-12","71106","Stern Commercial Contractor's:Walker Properties","Renaissance Collection, (100 watt max) Millstone Finish, One-light","Accounts Receivable",NA,1539.89,61896.25
"1505","Inventory Asset","Invoice","2018-12-12","71106","Stern Commercial Contractor's:Walker Properties","Sunset, Clear Glass, 1-100 watt max.","Accounts Receivable",NA,3100.64,58795.61
"1506","Inventory Asset","Invoice","2018-12-12","71106","Stern Commercial Contractor's:Walker Properties","Domes, White, 59x21x6 5/8 ht, 120v HPF","Accounts Receivable",NA,3600,55195.61
"1507","Inventory Asset","Invoice","2018-12-12","71106","Stern Commercial Contractor's:Walker Properties","Flush Mount, Polished Brass (2, 13 watt)  White acrylic diffuser","Accounts Receivable",NA,823.53,54372.08
"1508","Inventory Asset","Invoice","2018-12-12","71106","Stern Commercial Contractor's:Walker Properties","Fluorescent Lamp, T-12, Medium Bipin  (30pack)","Accounts Receivable",NA,682.86,53689.22
"1509","Inventory Asset","Bill","2018-12-15",NA,"Paulsen's Lighting","Pearl Nickel, 5 Light","Accounts Payable",400,NA,54089.22
"1510","Inventory Asset","Bill","2018-12-15",NA,"Paulsen's Lighting","Polished Brass, 6 Light","Accounts Payable",450,NA,54539.22
"1511","Inventory Asset","Bill","2018-12-15",NA,"Paulsen's Lighting","Exterior Fixture- Golden Lantern, 1 Light","Accounts Payable",960,NA,55499.22
"1512","Inventory Asset","Invoice","2018-12-15","71140","Thompson Lighting Stores:Store #15","Die Cast Lanterns, Black, 1-100 watt, Medium Base, Clear Cracked Glass","Accounts Receivable",NA,577.98,54921.24
"1513","Inventory Asset","Invoice","2018-12-15","71140","Thompson Lighting Stores:Store #15","Tapestry, (2-60 watt Med), Etched Cracked Glass, Finish 10","Accounts Receivable",NA,225,54696.24
"1514","Inventory Asset","Invoice","2018-12-15","71140","Thompson Lighting Stores:Store #15","18x8x10, Solid Brass, 3-60watt Medium Base, Satin Etched Glass","Accounts Receivable",NA,358.55,54337.69
"1515","Inventory Asset","Invoice","2018-12-15","71140","Thompson Lighting Stores:Store #15","Fluorescent Lamp, T-12, Medium Bipin  (30pack)","Accounts Receivable",0,NA,54337.69
"1516","Inventory Asset","Invoice","2018-12-15","71140","Thompson Lighting Stores:Store #15","Specialty Bulbs, 100 watt (6 pack)","Accounts Receivable",NA,47.5,54290.19
"1517","Inventory Asset","Invoice","2018-12-15","71140","Thompson Lighting Stores:Store #15","Golden Umber (100 watt)  Six Light Chandelier","Accounts Receivable",NA,425,53865.19
"1518","Inventory Asset","Invoice","2018-12-15","71140","Thompson Lighting Stores:Store #15","Golden Umber, 6 Light","Accounts Receivable",NA,425,53440.19
"1519","Inventory Asset","Invoice","2018-12-15","71140","Thompson Lighting Stores:Store #15","Frosted Taupe with Marble Glass","Accounts Receivable",NA,624.47,52815.72
"1520","Inventory Asset","Invoice","2018-12-15","71140","Thompson Lighting Stores:Store #15","Tapestry with Faux Alabaster Glass","Accounts Receivable",NA,525,52290.72
"1521","Inventory Asset","Invoice","2018-12-15","71140","Thompson Lighting Stores:Store #15","Beveled Mirror with Etched Ribbed Glass","Accounts Receivable",NA,244.97,52045.75
"1522","Inventory Asset","Invoice","2018-12-15","71140","Thompson Lighting Stores:Store #15","Polished Brass, 6 Light","Accounts Receivable",NA,150,51895.75
"1523","Inventory Asset","Invoice","2018-12-15","71140","Thompson Lighting Stores:Store #15","White with Satin White Glass","Accounts Receivable",NA,105,51790.75
"1524","Inventory Asset","Invoice","2018-12-15","71140","Thompson Lighting Stores:Store #15","Steel Colonial with Opal White Glass","Accounts Receivable",NA,100,51690.75
"1525","Inventory Asset","Invoice","2018-12-15","71140","Thompson Lighting Stores:Store #15","Gold Colonial","Accounts Receivable",NA,100,51590.75
"1526","Inventory Asset","Invoice","2018-12-15","71140","Thompson Lighting Stores:Store #15","Copper Verde, Seeded Glass","Accounts Receivable",NA,128.57,51462.18
"1527","Inventory Asset","Inventory Adjust","2018-12-15",NA,NA,"Indoor Electrical Wire Opening balance","Opening Bal Equity",375,NA,51837.18
"1528","Inventory Asset","Invoice","2018-12-15","71134","Kern Lighting Warehouse:Store #13","Acid Verde","Accounts Receivable",NA,690,51147.18
"1529","Inventory Asset","Invoice","2018-12-15","71134","Kern Lighting Warehouse:Store #13","Brushed Nickel Pendant with Etched Glass","Accounts Receivable",NA,175,50972.18
"1530","Inventory Asset","Invoice","2018-12-15","71134","Kern Lighting Warehouse:Store #13","Tapestry with Etched Glass","Accounts Receivable",NA,45,50927.18
"1531","Inventory Asset","Invoice","2018-12-15","71134","Kern Lighting Warehouse:Store #13","Brushed Nickel with Ribbed Glass","Accounts Receivable",NA,180,50747.18
"1532","Inventory Asset","Invoice","2018-12-15","71134","Kern Lighting Warehouse:Store #13","Fluorescent Lamp, Medium Bipin (30pack)","Accounts Receivable",NA,341.43,50405.75
"1533","Inventory Asset","Invoice","2018-12-15","71134","Kern Lighting Warehouse:Store #13","Halogen Lamp, 3.5 Volts, Tubular","Accounts Receivable",NA,50,50355.75
"1534","Inventory Asset","Invoice","2018-12-15","71134","Kern Lighting Warehouse:Store #13","Stage & Studio, 60 watt (set of 4)","Accounts Receivable",NA,57.5,50298.25
"1535","Inventory Asset","Invoice","2018-12-15","71134","Kern Lighting Warehouse:Store #13","Copper Verde, Seeded Glass","Accounts Receivable",NA,642.86,49655.39
"1536","Inventory Asset","Invoice","2018-12-15","71134","Kern Lighting Warehouse:Store #13","Bronze Lantern with Tail","Accounts Receivable",NA,1216,48439.39
"1537","Inventory Asset","Invoice","2018-12-15","71134","Kern Lighting Warehouse:Store #13","Hanging Brass and Black Finish with Clear Glass","Accounts Receivable",NA,480.52,47958.87
"1538","Inventory Asset","Invoice","2018-12-15","71136","Kern Lighting Warehouse:Store #13","Black Die Cast Lanterns with Clear Glass","Accounts Receivable",NA,192.66,47766.21
"1539","Inventory Asset","Invoice","2018-12-15","71136","Kern Lighting Warehouse:Store #13","Solid Brass with Etched Glass, 2 Light","Accounts Receivable",NA,162.98,47603.23
"1540","Inventory Asset","Invoice","2018-12-15","71136","Kern Lighting Warehouse:Store #13","Textured White Pendant","Accounts Receivable",NA,150,47453.23
"1541","Inventory Asset","Invoice","2018-12-15","71136","Kern Lighting Warehouse:Store #13","Steel Colonial with Opal White Glass","Accounts Receivable",NA,50,47403.23
"1542","Inventory Asset","Invoice","2018-12-15","71136","Kern Lighting Warehouse:Store #13","Brass with Black Finish and Clear Glass","Accounts Receivable",NA,200,47203.23
"1543","Inventory Asset","Invoice","2018-12-15","71136","Kern Lighting Warehouse:Store #13","Hanging Brass and Black Finish with Clear Glass","Accounts Receivable",NA,96.1,47107.13
"1544","Inventory Asset","Invoice","2018-12-15","71136","Kern Lighting Warehouse:Store #13","Drop Opal with Solid Oak Frame","Accounts Receivable",NA,107.21,46999.92
"1545","Inventory Asset","Invoice","2018-12-15","71136","Kern Lighting Warehouse:Store #13","Textured White Pendant","Accounts Receivable",NA,150,46849.92
"1546","Inventory Asset","Invoice","2018-12-15","71135","Baker's Professional Lighting:Store #15","Gold Colonial","Accounts Receivable",NA,20,46829.92
"1547","Inventory Asset","Invoice","2018-12-15","71135","Baker's Professional Lighting:Store #15","Steel Colonial with Opal White Glass","Accounts Receivable",NA,40,46789.92
"1548","Inventory Asset","Invoice","2018-12-15","71135","Baker's Professional Lighting:Store #15","Brushed Nickel with Opal Glass","Accounts Receivable",NA,74,46715.92
"1549","Inventory Asset","Invoice","2018-12-15","71135","Baker's Professional Lighting:Store #15","Textured White Pendant","Accounts Receivable",NA,150,46565.92
"1550","Inventory Asset","Invoice","2018-12-15","71135","Baker's Professional Lighting:Store #15","Brass Guard Lanterns, 1 Light","Accounts Receivable",NA,140,46425.92
"1551","Inventory Asset","Invoice","2018-12-15","71135","Baker's Professional Lighting:Store #15","Drop Opal with Solid Oak Frame","Accounts Receivable",NA,107.21,46318.71
"1552","Inventory Asset","Invoice","2018-12-15","71135","Baker's Professional Lighting:Store #15","Black Die Cast Lanterns with Clear Glass","Accounts Receivable",NA,192.66,46126.05
"1556","Prepaids","Check","2018-01-29","5021","Gretton Insurance Co.","Policy #203654","Company Checking Account",6875,NA,6875
"1557","Prepaids","General Journal","2018-02-28","PPDIns",NA,"Feb 03  Ins. Expense","Professional Liability Insuranc",NA,625,6250
"1558","Prepaids","General Journal","2018-03-31","PPDIns",NA,"Mar 03  Ins. Expense","Professional Liability Insuranc",NA,625,5625
"1559","Prepaids","General Journal","2018-04-30","PPDIns",NA,"Apr 03  Ins. Expense","Professional Liability Insuranc",NA,625,5000
"1560","Prepaids","General Journal","2018-05-31","PPDIns",NA,"May 03  Ins. Expense","Professional Liability Insuranc",NA,625,4375
"1561","Prepaids","General Journal","2018-06-30","PPDIns",NA,"June 03  Ins. Expense","Professional Liability Insuranc",NA,625,3750
"1562","Prepaids","General Journal","2018-07-31","PPDIns",NA,"July 03  Ins. Expense","Professional Liability Insuranc",NA,625,3125
"1563","Prepaids","General Journal","2018-08-31","PPDIns",NA,"Aug 03  Ins. Expense","Professional Liability Insuranc",NA,625,2500
"1564","Prepaids","General Journal","2018-09-30","PPDIns",NA,"Sept 03  Ins. Expense","Professional Liability Insuranc",NA,625,1875
"1565","Prepaids","General Journal","2018-10-31","PPDIns",NA,"Oct 03  Ins. Expense","Professional Liability Insuranc",NA,625,1250
"1566","Prepaids","General Journal","2018-11-30","PPDIns",NA,"Nov 03  Ins. Expense","Professional Liability Insuranc",NA,625,625
"1577","Undeposited Funds","Deposit","2018-01-01","11301","Lavery Lighting & Design:Store #JL-01","71117","Company Checking Account",NA,5279,-5279
"1578","Undeposited Funds","Deposit","2018-01-01","1098","Stern Commercial Contractor's:Wilson Suites","71108","Company Checking Account",NA,14355,-19634
"1579","Undeposited Funds","Deposit","2018-01-01","11311","Lavery Lighting & Design:Store #JL-04","71118","Company Checking Account",NA,11715,-31349
"1580","Undeposited Funds","Payment","2018-01-17","555","Miscellaneous - Retail:Ms. Jann Minor","71055","Accounts Receivable",1084,NA,-30265
"1581","Undeposited Funds","Payment","2018-01-18","11124","Miscellaneous - Retail:Brian Stern","71092","Accounts Receivable",1126,NA,-29139
"1582","Undeposited Funds","Payment","2018-01-28","254","Miscellaneous - Retail:Alison Johnson","71053","Accounts Receivable",854,NA,-28285
"1583","Undeposited Funds","Deposit","2018-01-30","555","Miscellaneous - Retail:Ms. Jann Minor","71055","Company Checking Account",NA,1084,-29369
"1584","Undeposited Funds","Deposit","2018-01-30","11124","Miscellaneous - Retail:Brian Stern","71092","Company Checking Account",NA,1126,-30495
"1585","Undeposited Funds","Deposit","2018-01-30","254","Miscellaneous - Retail:Alison Johnson","71053","Company Checking Account",NA,854,-31349
"1586","Undeposited Funds","Payment","2018-02-09","130","Baker's Professional Lighting:Store #25","71047","Accounts Receivable",2381,NA,-28968
"1587","Undeposited Funds","Payment","2018-02-15","1103","Stern Commercial Contractor's:Walker Properties","71106","Accounts Receivable",21330,NA,-7638
"1588","Undeposited Funds","Deposit","2018-02-15","130","Baker's Professional Lighting:Store #25","71047","Company Checking Account",NA,2381,-10019
"1589","Undeposited Funds","Deposit","2018-02-17","1103","Stern Commercial Contractor's:Walker Properties","71106","Company Checking Account",NA,21330,-31349
"1590","Undeposited Funds","Payment","2018-02-18","5467","Miscellaneous - Retail:Ruth Kuver","71093","Accounts Receivable",1366,NA,-29983
"1591","Undeposited Funds","Payment","2018-02-20","305","Miscellaneous - Retail:Mrs. Chris Holly","71054","Accounts Receivable",1300,NA,-28683
"1592","Undeposited Funds","Payment","2018-02-23","12357","Miscellaneous - Retail:David Lo","71094","Accounts Receivable",1932,NA,-26751
"1593","Undeposited Funds","Payment","2018-02-28","57702","Godwin Lighting Depot:Store #202","71050","Accounts Receivable",7786.4,NA,-18964.6
"1594","Undeposited Funds","Payment","2018-02-28","57713","Godwin Lighting Depot:Store #303","71059","Accounts Receivable",1687.95,NA,-17276.65
"1595","Undeposited Funds","Deposit","2018-02-28","5467","Miscellaneous - Retail:Ruth Kuver","71093","Company Checking Account",NA,1366,-18642.65
"1596","Undeposited Funds","Deposit","2018-02-28","305","Miscellaneous - Retail:Mrs. Chris Holly","71054","Company Checking Account",NA,1300,-19942.65
"1597","Undeposited Funds","Deposit","2018-02-28","12357","Miscellaneous - Retail:David Lo","71094","Company Checking Account",NA,1932,-21874.65
"1598","Undeposited Funds","Deposit","2018-02-28","57702","Godwin Lighting Depot:Store #202","71050","Company Checking Account",NA,7786.4,-29661.05
"1599","Undeposited Funds","Deposit","2018-02-28","57713","Godwin Lighting Depot:Store #303","71059","Company Checking Account",NA,1687.95,-31349
"1600","Undeposited Funds","Payment","2018-03-02","5749","Kern Lighting Warehouse:Store #34","71124","Accounts Receivable",8400,NA,-22949
"1601","Undeposited Funds","Payment","2018-03-02","5750","Kern Lighting Warehouse:Store #13","71123","Accounts Receivable",110,NA,-22839
"1602","Undeposited Funds","Payment","2018-03-15","741","Miscellaneous - Retail:Mr. Fred Kaseman","71056","Accounts Receivable",2221,NA,-20618
"1603","Undeposited Funds","Payment","2018-03-16","5790","Kern Lighting Warehouse:Store #34","71121","Accounts Receivable",6745,NA,-13873
"1604","Undeposited Funds","Payment","2018-03-16","142","Baker's Professional Lighting:Store #05","71110","Accounts Receivable",2391,NA,-11482
"1605","Undeposited Funds","Payment","2018-03-16","11030","Cole Home Builders:Phase 2 - Lot 5","71072","Accounts Receivable",2187.45,NA,-9294.55
"1606","Undeposited Funds","Deposit","2018-03-17","5749","Kern Lighting Warehouse:Store #34","71124","Company Checking Account",NA,8400,-17694.55
"1607","Undeposited Funds","Deposit","2018-03-17","5750","Kern Lighting Warehouse:Store #13","71123","Company Checking Account",NA,110,-17804.55
"1608","Undeposited Funds","Deposit","2018-03-17","741","Miscellaneous - Retail:Mr. Fred Kaseman","71056","Company Checking Account",NA,2221,-20025.55
"1609","Undeposited Funds","Payment","2018-03-30","157","Baker's Professional Lighting:Store #15","71052","Accounts Receivable",1885,NA,-18140.55
"1610","Undeposited Funds","Payment","2018-03-30","11111","Lavery Lighting & Design:Store #JL-08","71122","Accounts Receivable",600,NA,-17540.55
"1611","Undeposited Funds","Deposit","2018-03-31","5790","Kern Lighting Warehouse:Store #34","71121","Company Checking Account",NA,6745,-24285.55
"1612","Undeposited Funds","Deposit","2018-03-31","142","Baker's Professional Lighting:Store #05","71110","Company Checking Account",NA,2391,-26676.55
"1613","Undeposited Funds","Deposit","2018-03-31","11030","Cole Home Builders:Phase 2 - Lot 5","71072","Company Checking Account",NA,2187.45,-28864
"1614","Undeposited Funds","Deposit","2018-03-31","5740","Kern Lighting Warehouse:Store #01","71119","Company Checking Account",NA,6150,-35014
"1615","Undeposited Funds","Deposit","2018-03-31","157","Baker's Professional Lighting:Store #15","71052","Company Checking Account",NA,1885,-36899
"1616","Undeposited Funds","Deposit","2018-03-31","11111","Lavery Lighting & Design:Store #JL-08","71122","Company Checking Account",NA,600,-37499
"1617","Undeposited Funds","Payment","2018-04-10","489","Miscellaneous - Retail:Mr. Jay Jessen","71057","Accounts Receivable",1239,NA,-36260
"1618","Undeposited Funds","Payment","2018-04-13","169","Baker's Professional Lighting:Store #20","71048","Accounts Receivable",1872,NA,-34388
"1619","Undeposited Funds","Deposit","2018-04-15","489","Miscellaneous - Retail:Mr. Jay Jessen","71057","Company Checking Account",NA,1239,-35627
"1620","Undeposited Funds","Deposit","2018-04-15","169","Baker's Professional Lighting:Store #20","71048","Company Checking Account",NA,1872,-37499
"1621","Undeposited Funds","Payment","2018-04-16","11057","Cole Home Builders:Phase 1 - Lot 2","71088","Accounts Receivable",2187.45,NA,-35311.55
"1622","Undeposited Funds","Payment","2018-04-16","11049","Cole Home Builders:Phase 2 - Lot 5","71051","Accounts Receivable",4364,NA,-30947.55
"1623","Undeposited Funds","Payment","2018-04-25","8111","Thompson Lighting Stores:Store #15","71112","Accounts Receivable",3025,NA,-27922.55
"1624","Undeposited Funds","Payment","2018-04-25","265","Miscellaneous - Retail:Mrs. Anne Hemp","71058","Accounts Receivable",1563,NA,-26359.55
"1625","Undeposited Funds","Payment","2018-04-30","57730","Godwin Lighting Depot:Store #404","71060","Accounts Receivable",1687.95,NA,-24671.6
"1626","Undeposited Funds","Payment","2018-04-30","57713","Godwin Lighting Depot:Store #303","71065","Accounts Receivable",2578.95,NA,-22092.65
"1627","Undeposited Funds","Payment","2018-04-30","11128","Lavery Lighting & Design:Store #JL-06","71049","Accounts Receivable",4694.5,NA,-17398.15
"1628","Undeposited Funds","Payment","2018-04-30","5790","Dan A. North Builders:McCarthy Properties","71071","Accounts Receivable",8929,NA,-8469.15
"1629","Undeposited Funds","Deposit","2018-04-30","8111","Thompson Lighting Stores:Store #15","71112","Company Checking Account",NA,3025,-11494.15
"1630","Undeposited Funds","Deposit","2018-05-01","11057","Cole Home Builders:Phase 1 - Lot 2","71088","Company Checking Account",NA,2187.45,-13681.6
"1631","Undeposited Funds","Deposit","2018-05-01","11049","Cole Home Builders:Phase 2 - Lot 5","71051","Company Checking Account",NA,4364,-18045.6
"1632","Undeposited Funds","Deposit","2018-05-01","265","Miscellaneous - Retail:Mrs. Anne Hemp","71058","Company Checking Account",NA,1563,-19608.6
"1633","Undeposited Funds","Deposit","2018-05-01","5791","Kern Lighting Warehouse:Store #13","71120","Company Checking Account",NA,8190,-27798.6
"1634","Undeposited Funds","Deposit","2018-05-01","57730","Godwin Lighting Depot:Store #404","71060","Company Checking Account",NA,1687.95,-29486.55
"1635","Undeposited Funds","Deposit","2018-05-01","57713","Godwin Lighting Depot:Store #303","71065","Company Checking Account",NA,2578.95,-32065.5
"1636","Undeposited Funds","Deposit","2018-05-01","11128","Lavery Lighting & Design:Store #JL-06","71049","Company Checking Account",NA,4694.5,-36760
"1637","Undeposited Funds","Deposit","2018-05-01","5790","Dan A. North Builders:McCarthy Properties","71071","Company Checking Account",NA,8929,-45689
"1638","Undeposited Funds","Payment","2018-05-02","5824","Kern Lighting Warehouse:Store #45","71124","Accounts Receivable",8500,NA,-37189
"1639","Undeposited Funds","Payment","2018-05-16","1125","Miscellaneous - Retail:Carlos Nazar","71095","Accounts Receivable",2025,NA,-35164
"1640","Undeposited Funds","Deposit","2018-05-16","5824","Kern Lighting Warehouse:Store #45","71124","Company Checking Account",NA,8500,-43664
"1641","Undeposited Funds","Deposit","2018-05-16","1125","Miscellaneous - Retail:Carlos Nazar","71095","Company Checking Account",NA,2025,-45689
"1642","Undeposited Funds","Payment","2018-05-30","5810","Dan A. North Builders:Wagner Suites","71067","Accounts Receivable",7890,NA,-37799
"1643","Undeposited Funds","Payment","2018-05-31","57749","Godwin Lighting Depot:Store #202","71061","Accounts Receivable",1687.95,NA,-36111.05
"1644","Undeposited Funds","Payment","2018-05-31","57767","Godwin Lighting Depot:Store #404","71064","Accounts Receivable",2578.95,NA,-33532.1
"1645","Undeposited Funds","Payment","2018-05-31","57777","Godwin Lighting Depot:Store #909","71066","Accounts Receivable",2578.95,NA,-30953.15
"1646","Undeposited Funds","Deposit","2018-06-02","5810","Dan A. North Builders:Wagner Suites","71067","Company Checking Account",NA,7890,-38843.15
"1647","Undeposited Funds","Deposit","2018-06-02","57749","Godwin Lighting Depot:Store #202","71061","Company Checking Account",NA,1687.95,-40531.1
"1648","Undeposited Funds","Deposit","2018-06-02","57767","Godwin Lighting Depot:Store #404","71064","Company Checking Account",NA,2578.95,-43110.05
"1649","Undeposited Funds","Deposit","2018-06-02","57777","Godwin Lighting Depot:Store #909","71066","Company Checking Account",NA,2578.95,-45689
"1650","Undeposited Funds","Payment","2018-06-05","2546","Miscellaneous - Retail:Anne Loomis","71096","Accounts Receivable",1608,NA,-44081
"1651","Undeposited Funds","Payment","2018-06-08","5832","Kern Lighting Warehouse:Store #13","71126","Accounts Receivable",12600,NA,-31481
"1652","Undeposited Funds","Payment","2018-06-11","201","Baker's Professional Lighting:Store #10","71111","Accounts Receivable",2038,NA,-29443
"1653","Undeposited Funds","Payment","2018-06-15","11123","Cole Home Builders:Phase 1 - Lot 5","71087","Accounts Receivable",2187.45,NA,-27255.55
"1654","Undeposited Funds","Deposit","2018-06-16","2546","Miscellaneous - Retail:Anne Loomis","71096","Company Checking Account",NA,1608,-28863.55
"1655","Undeposited Funds","Deposit","2018-06-16","5832","Kern Lighting Warehouse:Store #13","71126","Company Checking Account",NA,12600,-41463.55
"1656","Undeposited Funds","Deposit","2018-06-16","201","Baker's Professional Lighting:Store #10","71111","Company Checking Account",NA,2038,-43501.55
"1657","Undeposited Funds","Deposit","2018-06-16","11123","Cole Home Builders:Phase 1 - Lot 5","71087","Company Checking Account",NA,2187.45,-45689
"1658","Undeposited Funds","Payment","2018-06-29","57790","Godwin Lighting Depot:Store #404","71062","Accounts Receivable",1687.95,NA,-44001.05
"1659","Undeposited Funds","Payment","2018-06-29","57801","Godwin Lighting Depot:Store #404","71063","Accounts Receivable",1687.95,NA,-42313.1
"1660","Undeposited Funds","Payment","2018-06-29","57799","Godwin Lighting Depot:Store #909","71068","Accounts Receivable",2578.95,NA,-39734.15
"1661","Undeposited Funds","Payment","2018-06-29","57811","Godwin Lighting Depot:Store #1020","71069","Accounts Receivable",2578.95,NA,-37155.2
"1662","Undeposited Funds","Deposit","2018-06-30","57790","Godwin Lighting Depot:Store #404","71062","Company Checking Account",NA,1687.95,-38843.15
"1663","Undeposited Funds","Deposit","2018-06-30","57801","Godwin Lighting Depot:Store #404","71063","Company Checking Account",NA,1687.95,-40531.1
"1664","Undeposited Funds","Deposit","2018-06-30","57799","Godwin Lighting Depot:Store #909","71068","Company Checking Account",NA,2578.95,-43110.05
"1665","Undeposited Funds","Deposit","2018-06-30","57811","Godwin Lighting Depot:Store #1020","71069","Company Checking Account",NA,2578.95,-45689
"1666","Undeposited Funds","Payment","2018-07-16","11173","Cole Home Builders:Phase 2 - Lot 5","71083","Accounts Receivable",1637.1,NA,-44051.9
"1667","Undeposited Funds","Payment","2018-07-16","11154","Cole Home Builders:Phase 1 - Lot 5","71084","Accounts Receivable",1637.1,NA,-42414.8
"1668","Undeposited Funds","Payment","2018-07-20","11167","Cole Home Builders:Phase 1 - Lot 4","71086","Accounts Receivable",2187.45,NA,-40227.35
"1669","Undeposited Funds","Payment","2018-07-24","35587","Miscellaneous - Retail:Sean Martin","71097","Accounts Receivable",1542,NA,-38685.35
"1670","Undeposited Funds","Payment","2018-07-27","7233","Thompson Lighting Stores:Store #20","71113","Accounts Receivable",3025,NA,-35660.35
"1671","Undeposited Funds","Payment","2018-07-29","5740","Kern Lighting Warehouse:Store #01","71119","Accounts Receivable",6150,NA,-29510.35
"1672","Undeposited Funds","Payment","2018-07-31","5850","Kern Lighting Warehouse:Store #34","71127","Accounts Receivable",8756,NA,-20754.35
"1673","Undeposited Funds","Payment","2018-07-31","57820","Godwin Lighting Depot:Store #303","71070","Accounts Receivable",2578.95,NA,-18175.4
"1674","Undeposited Funds","Deposit","2018-08-01","11173","Cole Home Builders:Phase 2 - Lot 5","71083","Company Checking Account",NA,1637.1,-19812.5
"1675","Undeposited Funds","Deposit","2018-08-01","11154","Cole Home Builders:Phase 1 - Lot 5","71084","Company Checking Account",NA,1637.1,-21449.6
"1676","Undeposited Funds","Deposit","2018-08-01","11167","Cole Home Builders:Phase 1 - Lot 4","71086","Company Checking Account",NA,2187.45,-23637.05
"1677","Undeposited Funds","Deposit","2018-08-01","35587","Miscellaneous - Retail:Sean Martin","71097","Company Checking Account",NA,1542,-25179.05
"1678","Undeposited Funds","Deposit","2018-08-01","7233","Thompson Lighting Stores:Store #20","71113","Company Checking Account",NA,3025,-28204.05
"1679","Undeposited Funds","Deposit","2018-08-01","5850","Kern Lighting Warehouse:Store #34","71127","Company Checking Account",NA,8756,-36960.05
"1680","Undeposited Funds","Deposit","2018-08-01","57820","Godwin Lighting Depot:Store #303","71070","Company Checking Account",NA,2578.95,-39539
"1681","Undeposited Funds","Payment","2018-08-07","5587","Miscellaneous - Retail:Jann Minor","71098","Accounts Receivable",2085,NA,-37454
"1682","Undeposited Funds","Payment","2018-08-15","7262","Thompson Lighting Stores:Store #50","71116","Accounts Receivable",3025,NA,-34429
"1683","Undeposited Funds","Payment","2018-08-15","11191","Cole Home Builders:Phase 1 - Lot 5","71080","Accounts Receivable",2009.25,NA,-32419.75
"1684","Undeposited Funds","Payment","2018-08-15","11190","Cole Home Builders:Phase 2 - Lot 5","71081","Accounts Receivable",1637.1,NA,-30782.65
"1685","Undeposited Funds","Payment","2018-08-15","11199","Cole Home Builders:Phase 1 - Lot 5","71082","Accounts Receivable",1637.1,NA,-29145.55
"1686","Undeposited Funds","Payment","2018-08-17","11184","Cole Home Builders:Phase 1 - Lot 5","71085","Accounts Receivable",2187.45,NA,-26958.1
"1687","Undeposited Funds","Payment","2018-08-17","5861","Kern Lighting Warehouse:Store #45","71128","Accounts Receivable",14175,NA,-12783.1
"1688","Undeposited Funds","Deposit","2018-08-18","5587","Miscellaneous - Retail:Jann Minor","71098","Company Checking Account",NA,2085,-14868.1
"1689","Undeposited Funds","Deposit","2018-08-18","7262","Thompson Lighting Stores:Store #50","71116","Company Checking Account",NA,3025,-17893.1
"1690","Undeposited Funds","Deposit","2018-08-18","11191","Cole Home Builders:Phase 1 - Lot 5","71080","Company Checking Account",NA,2009.25,-19902.35
"1691","Undeposited Funds","Deposit","2018-08-18","11190","Cole Home Builders:Phase 2 - Lot 5","71081","Company Checking Account",NA,1637.1,-21539.45
"1692","Undeposited Funds","Deposit","2018-08-18","11199","Cole Home Builders:Phase 1 - Lot 5","71082","Company Checking Account",NA,1637.1,-23176.55
"1693","Undeposited Funds","Deposit","2018-08-18","11184","Cole Home Builders:Phase 1 - Lot 5","71085","Company Checking Account",NA,2187.45,-25364
"1694","Undeposited Funds","Deposit","2018-08-18","5861","Kern Lighting Warehouse:Store #45","71128","Company Checking Account",NA,14175,-39539
"1695","Undeposited Funds","Payment","2018-09-11","6687","Miscellaneous - Retail:Jason Helper","71099","Accounts Receivable",1812,NA,-37727
"1696","Undeposited Funds","Payment","2018-09-14","11201","Cole Home Builders:Phase 1 - Lot 5","71089","Accounts Receivable",1637.1,NA,-36089.9
"1697","Undeposited Funds","Payment","2018-09-14","5890","Kern Lighting Warehouse:Store #01","71129","Accounts Receivable",18940,NA,-17149.9
"1698","Undeposited Funds","Deposit","2018-09-15","6687","Miscellaneous - Retail:Jason Helper","71099","Company Checking Account",NA,1812,-18961.9
"1699","Undeposited Funds","Deposit","2018-09-15","11201","Cole Home Builders:Phase 1 - Lot 5","71089","Company Checking Account",NA,1637.1,-20599
"1700","Undeposited Funds","Deposit","2018-09-15","5890","Kern Lighting Warehouse:Store #01","71129","Company Checking Account",NA,18940,-39539
"1701","Undeposited Funds","Payment","2018-09-17","11223","Cole Home Builders:Phase 1 - Lot 5","71078","Accounts Receivable",2009.25,NA,-37529.75
"1702","Undeposited Funds","Payment","2018-09-17","11213","Cole Home Builders:Phase 1 - Lot 5","71079","Accounts Receivable",2009.25,NA,-35520.5
"1703","Undeposited Funds","Payment","2018-09-25","71105","Miscellaneous - Retail:John Huhn","71100","Accounts Receivable",2239,NA,-33281.5
"1704","Undeposited Funds","Payment","2018-09-28","7253","Thompson Lighting Stores:Store #30","71114","Accounts Receivable",3025,NA,-30256.5
"1705","Undeposited Funds","Payment","2018-09-28","7279","Thompson Lighting Stores:Store #40","71115","Accounts Receivable",3025,NA,-27231.5
"1706","Undeposited Funds","Payment","2018-09-28","6111","Dan A. North Builders:Turner Suites","71109","Accounts Receivable",13300,NA,-13931.5
"1707","Undeposited Funds","Deposit","2018-09-30","11223","Cole Home Builders:Phase 1 - Lot 5","71078","Company Checking Account",NA,2009.25,-15940.75
"1708","Undeposited Funds","Deposit","2018-09-30","11213","Cole Home Builders:Phase 1 - Lot 5","71079","Company Checking Account",NA,2009.25,-17950
"1709","Undeposited Funds","Deposit","2018-09-30","71105","Miscellaneous - Retail:John Huhn","71100","Company Checking Account",NA,2239,-20189
"1710","Undeposited Funds","Deposit","2018-09-30","7253","Thompson Lighting Stores:Store #30","71114","Company Checking Account",NA,3025,-23214
"1711","Undeposited Funds","Deposit","2018-09-30","7279","Thompson Lighting Stores:Store #40","71115","Company Checking Account",NA,3025,-26239
"1712","Undeposited Funds","Deposit","2018-09-30","6111","Dan A. North Builders:Turner Suites","71109","Company Checking Account",NA,13300,-39539
"1713","Undeposited Funds","Payment","2018-10-09","99611","Miscellaneous - Retail:Doug Jacobsen","71101","Accounts Receivable",1719,NA,-37820
"1714","Undeposited Funds","Payment","2018-10-15","11219","Cole Home Builders:Phase 1 - Lot 5","71076","Accounts Receivable",2138.4,NA,-35681.6
"1715","Undeposited Funds","Payment","2018-10-15","11230","Cole Home Builders:Phase 1 - Lot 5","71077","Accounts Receivable",2009.25,NA,-33672.35
"1716","Undeposited Funds","Deposit","2018-10-16","99611","Miscellaneous - Retail:Doug Jacobsen","71101","Company Checking Account",NA,1719,-35391.35
"1717","Undeposited Funds","Deposit","2018-10-16","11219","Cole Home Builders:Phase 1 - Lot 5","71076","Company Checking Account",NA,2138.4,-37529.75
"1718","Undeposited Funds","Deposit","2018-10-16","11230","Cole Home Builders:Phase 1 - Lot 5","71077","Company Checking Account",NA,2009.25,-39539
"1719","Undeposited Funds","Payment","2018-10-19","11240","Cole Home Builders:Phase 2 - Lot 5","71090","Accounts Receivable",2009.25,NA,-37529.75
"1720","Undeposited Funds","Payment","2018-10-19","5910","Kern Lighting Warehouse:Store #45","71130","Accounts Receivable",8000,NA,-29529.75
"1721","Undeposited Funds","Payment","2018-10-25","115789","Miscellaneous - Retail:Peter Karpas","71102","Accounts Receivable",1714,NA,-27815.75
"1722","Undeposited Funds","Deposit","2018-10-30","11240","Cole Home Builders:Phase 2 - Lot 5","71090","Company Checking Account",NA,2009.25,-29825
"1723","Undeposited Funds","Deposit","2018-10-30","5910","Kern Lighting Warehouse:Store #45","71130","Company Checking Account",NA,8000,-37825
"1724","Undeposited Funds","Deposit","2018-10-30","115789","Miscellaneous - Retail:Peter Karpas","71102","Company Checking Account",NA,1714,-39539
"1725","Undeposited Funds","Payment","2018-11-05","101","Miscellaneous - Retail:Valesha Jones","71103","Accounts Receivable",2395,NA,-37144
"1726","Undeposited Funds","Payment","2018-11-16","11270","Cole Home Builders:Phase 1 - Lot 5","71073","Accounts Receivable",2138.4,NA,-35005.6
"1727","Undeposited Funds","Payment","2018-11-16","11257","Cole Home Builders:Phase 1 - Lot 5","71074","Accounts Receivable",2138.4,NA,-32867.2
"1728","Undeposited Funds","Payment","2018-11-16","11250","Cole Home Builders:Phase 1 - Lot 5","71075","Accounts Receivable",2138.4,NA,-30728.8
"1729","Undeposited Funds","Payment","2018-11-16","11280","Cole Home Builders:Phase 2 - Lot 5","71091","Accounts Receivable",2138.4,NA,-28590.4
"1730","Undeposited Funds","Payment","2018-11-16","5930","Kern Lighting Warehouse:Store #13","71131","Accounts Receivable",5569,NA,-23021.4
"1731","Undeposited Funds","Payment","2018-11-20","55449","Miscellaneous - Retail:Melanie Hall","71104","Accounts Receivable",1600,NA,-21421.4
"1732","Undeposited Funds","Payment","2018-11-29","1052","Stern Commercial Contractor's:Tittle Properties","71107","Accounts Receivable",17433,NA,-3988.4
"1733","Undeposited Funds","Payment","2018-11-30","5791","Kern Lighting Warehouse:Store #13","71120","Accounts Receivable",8190,NA,4201.6
"1734","Undeposited Funds","Payment","2018-11-30","1098","Stern Commercial Contractor's:Wilson Suites","71108","Accounts Receivable",14355,NA,18556.6
"1735","Undeposited Funds","Payment","2018-12-01","11311","Lavery Lighting & Design:Store #JL-04","71118","Accounts Receivable",11715,NA,30271.6
"1736","Undeposited Funds","Deposit","2018-12-01","101","Miscellaneous - Retail:Valesha Jones","71103","Company Checking Account",NA,2395,27876.6
"1737","Undeposited Funds","Deposit","2018-12-01","11270","Cole Home Builders:Phase 1 - Lot 5","71073","Company Checking Account",NA,2138.4,25738.2
"1738","Undeposited Funds","Deposit","2018-12-01","11257","Cole Home Builders:Phase 1 - Lot 5","71074","Company Checking Account",NA,2138.4,23599.8
"1739","Undeposited Funds","Deposit","2018-12-01","11250","Cole Home Builders:Phase 1 - Lot 5","71075","Company Checking Account",NA,2138.4,21461.4
"1740","Undeposited Funds","Deposit","2018-12-01","11280","Cole Home Builders:Phase 2 - Lot 5","71091","Company Checking Account",NA,2138.4,19323
"1741","Undeposited Funds","Deposit","2018-12-01","5930","Kern Lighting Warehouse:Store #13","71131","Company Checking Account",NA,5569,13754
"1742","Undeposited Funds","Deposit","2018-12-01","55449","Miscellaneous - Retail:Melanie Hall","71104","Company Checking Account",NA,1600,12154
"1743","Undeposited Funds","Deposit","2018-12-01","1052","Stern Commercial Contractor's:Tittle Properties","71107","Company Checking Account",NA,17433,-5279
"1744","Undeposited Funds","Payment","2018-12-10","66587","Miscellaneous - Retail:Lara Gussman","71105","Accounts Receivable",1679,NA,-3600
"1745","Undeposited Funds","Payment","2018-12-11","5977","Kern Lighting Warehouse:Store #01","71133","Accounts Receivable",9839,NA,6239
"1746","Undeposited Funds","Payment","2018-12-14","5950","Kern Lighting Warehouse:Store #34","71132","Accounts Receivable",10723.6,NA,16962.6
"1747","Undeposited Funds","Payment","2018-12-15","11301","Lavery Lighting & Design:Store #JL-01","71117","Accounts Receivable",5279,NA,22241.6
"1748","Undeposited Funds","Payment","2018-12-15","5999","Kern Lighting Warehouse:Store #13","71134","Accounts Receivable",9033.5,NA,31275.1
"1749","Undeposited Funds","Deposit","2018-12-15","66587","Miscellaneous - Retail:Lara Gussman","71105","Company Checking Account",NA,1679,29596.1
"1750","Undeposited Funds","Deposit","2018-12-15","5950","Kern Lighting Warehouse:Store #34","71132","Company Checking Account",NA,10723.6,18872.5
"1751","Undeposited Funds","Deposit","2018-12-15","5977","Kern Lighting Warehouse:Store #01","71133","Company Checking Account",NA,9839,9033.5
"1757","Computer & Office Equipment","Check","2018-06-22","5144","Electronics Manufacturer","Computer","Company Checking Account",2500,NA,19453
"1762","Accumulated Depreciation","General Journal","2018-01-31","DEPR03",NA,"Jan07 Depr Expense","Depreciation Expense",NA,76.92,-76.92
"1763","Accumulated Depreciation","General Journal","2018-02-28","DEPR03",NA,"Feb03 Depr Expense","Depreciation Expense",NA,76.92,-153.84
"1764","Accumulated Depreciation","General Journal","2018-03-31","DEPR4",NA,"Mar03 Depr Expense","Depreciation Expense",NA,76.92,-230.76
"1765","Accumulated Depreciation","General Journal","2018-04-30","DEPR5",NA,"Apr03 Depr Expense","Depreciation Expense",NA,76.92,-307.68
"1766","Accumulated Depreciation","General Journal","2018-05-31","DEPR6",NA,"May03 Depr Expense","Depreciation Expense",NA,76.92,-384.6
"1767","Accumulated Depreciation","General Journal","2018-06-30","DEPR7",NA,"June03 Depr Expense","Depreciation Expense",NA,76.92,-461.52
"1768","Accumulated Depreciation","General Journal","2018-07-31","DEPR8",NA,"July03 Depr Expense","Depreciation Expense",NA,76.92,-538.44
"1769","Accumulated Depreciation","General Journal","2018-08-31","DEPR9",NA,"Aug03 Depr Expense","Depreciation Expense",NA,76.92,-615.36
"1770","Accumulated Depreciation","General Journal","2018-09-30","DEPR10",NA,"Sept03 Depr Expense","Depreciation Expense",NA,76.92,-692.28
"1771","Accumulated Depreciation","General Journal","2018-10-31","DEPR11",NA,"Oct03 Depr Expense","Depreciation Expense",NA,76.92,-769.2
"1772","Accumulated Depreciation","General Journal","2018-11-30","DEPR12",NA,"Nov03 Depr Expense","Depreciation Expense",NA,76.92,-846.12
"1773","Accumulated Depreciation","General Journal","2018-12-31","DEPR13",NA,"Dec03 Depr Expense","Depreciation Expense",NA,76.92,-923.04
"1776","Accounts Payable","Bill","2018-01-02","76850-2","Peacock Bulb Manufacturing Company",NA,"-SPLIT-",NA,76.5,-76.5
"1777","Accounts Payable","Bill","2018-01-06","87865","Paulsen's Lighting",NA,"-SPLIT-",NA,2520,-2596.5
"1778","Accounts Payable","Bill","2018-01-24","U7890","Paulsen's Lighting",NA,"-SPLIT-",NA,12812.5,-15409
"1779","Accounts Payable","Bill","2018-01-26","b8796","Peacock Bulb Manufacturing Company",NA,"-SPLIT-",NA,9142.5,-24551.5
"1780","Accounts Payable","Bill","2018-01-30","98760AR","Hall Lighting & Accessories",NA,"-SPLIT-",NA,6747.5,-31299
"1781","Accounts Payable","Bill","2018-01-31","8907","Foster Lighting",NA,"-SPLIT-",NA,4470,-35769
"1782","Accounts Payable","Bill","2018-01-31","124-80056","Fisse Fast Package Delivery",NA,"Freight Costs",NA,134,-35903
"1783","Accounts Payable","Bill","2018-02-01","15657","Printing Shop","Product literature","Purchases  (Cost of Goods)",NA,255,-36158
"1784","Accounts Payable","Bill","2018-02-03","15687","Printing Shop","Promotional flyers","Promotional Expense",NA,156,-36314
"1785","Accounts Payable","Bill","2018-02-05","124-89056","Fisse Fast Package Delivery",NA,"Freight Costs",NA,197,-36511
"1786","Accounts Payable","Bill","2018-02-06","455778","Paulsen's Lighting",NA,"-SPLIT-",NA,2150,-38661
"1787","Accounts Payable","Bill","2018-02-06","78900","Foster Lighting",NA,"-SPLIT-",NA,8450,-47111
"1788","Accounts Payable","Bill","2018-02-15","P8890-01","Paulsen's Lighting","Cust #WD008","-SPLIT-",NA,1736,-48847
"1789","Accounts Payable","Bill Pmt -Check","2018-02-20","3063","Paulsen's Lighting",NA,"Company Checking Account",2520,NA,-46327
"1790","Accounts Payable","Bill Pmt -Check","2018-02-28","5052","Fisse Fast Package Delivery","ACCT# 256044025","Company Checking Account",134,NA,-46193
"1791","Accounts Payable","Bill Pmt -Check","2018-02-28","5057","Printing Shop","Inv#","Company Checking Account",255,NA,-45938
"1792","Accounts Payable","Bill Pmt -Check","2018-02-28","5058","Fisse Fast Package Delivery","ACCT# 256044025","Company Checking Account",197,NA,-45741
"1793","Accounts Payable","Bill Pmt -Check","2018-02-28","5055","Printing Shop","Inv#","Company Checking Account",156,NA,-45585
"1794","Accounts Payable","Bill Pmt -Check","2018-02-28","5238","Fisse Fast Package Delivery","ACCT# 256044025","Company Checking Account",164,NA,-45421
"1795","Accounts Payable","Bill","2018-03-01","7866-92","Foster Lighting","Cust ID#0987-01A","-SPLIT-",NA,705,-46126
"1796","Accounts Payable","Bill Pmt -Check","2018-03-05","3064","Foster Lighting",NA,"Company Checking Account",4470,NA,-41656
"1797","Accounts Payable","Bill Pmt -Check","2018-03-05","3065","Hall Lighting & Accessories",NA,"Company Checking Account",6747.5,NA,-34908.5
"1798","Accounts Payable","Bill Pmt -Check","2018-03-05","3066","Paulsen's Lighting",NA,"Company Checking Account",12812.5,NA,-22096
"1799","Accounts Payable","Bill Pmt -Check","2018-03-05","3067","Peacock Bulb Manufacturing Company",NA,"Company Checking Account",9142.5,NA,-12953.5
"1800","Accounts Payable","Bill","2018-03-05","124-85001","Fisse Fast Package Delivery",NA,"Freight Costs",NA,164,-13117.5
"1801","Accounts Payable","Bill","2018-03-09","R909878","Paulsen's Lighting",NA,"-SPLIT-",NA,20950,-34067.5
"1802","Accounts Payable","Bill Pmt -Check","2018-03-20","3068","Foster Lighting",NA,"Company Checking Account",8450,NA,-25617.5
"1803","Accounts Payable","Bill Pmt -Check","2018-03-20","3069","Paulsen's Lighting",NA,"Company Checking Account",3886,NA,-21731.5
"1804","Accounts Payable","Bill","2018-04-02","156098","Printing Shop","Marketing materials","Marketing Expense",NA,285,-22016.5
"1805","Accounts Payable","Bill Pmt -Check","2018-04-05","3070","Foster Lighting","Cust ID#0987-01A","Company Checking Account",705,NA,-21311.5
"1806","Accounts Payable","Bill Pmt -Check","2018-04-05","3071","Paulsen's Lighting",NA,"Company Checking Account",20950,NA,-361.5
"1807","Accounts Payable","Bill","2018-04-15","124-90002","Fisse Fast Package Delivery",NA,"Freight Costs",NA,164,-525.5
"1808","Accounts Payable","Bill","2018-04-16","0987","Foster Lighting",NA,"-SPLIT-",NA,5550,-6075.5
"1809","Accounts Payable","Bill","2018-04-16","8284","Hall Lighting & Accessories",NA,"-SPLIT-",NA,6747.5,-12823
"1810","Accounts Payable","Bill","2018-04-16","0987","Paulsen's Lighting",NA,"-SPLIT-",NA,7925,-20748
"1811","Accounts Payable","Bill Pmt -Check","2018-04-30","5102","Fisse Fast Package Delivery","ACCT# 256044025","Company Checking Account",164,NA,-20584
"1812","Accounts Payable","Bill Pmt -Check","2018-04-30","5103","Printing Shop","Inv#","Company Checking Account",285,NA,-20299
"1813","Accounts Payable","Bill","2018-04-30","765-06","Foster Lighting",NA,"-SPLIT-",NA,2840,-23139
"1814","Accounts Payable","Bill","2018-04-30","155098","Printing Shop","Business cards","Supplies",NA,160,-23299
"1815","Accounts Payable","Bill","2018-05-05","124-87002","Fisse Fast Package Delivery",NA,"Freight Costs",NA,164,-23463
"1816","Accounts Payable","Bill Pmt -Check","2018-05-20","3072","Foster Lighting",NA,"Company Checking Account",5550,NA,-17913
"1817","Accounts Payable","Bill Pmt -Check","2018-05-20","3073","Hall Lighting & Accessories",NA,"Company Checking Account",6747.5,NA,-11165.5
"1818","Accounts Payable","Bill Pmt -Check","2018-05-20","3074","Paulsen's Lighting",NA,"Company Checking Account",7925,NA,-3240.5
"1819","Accounts Payable","Bill Pmt -Check","2018-05-31","5129","Fisse Fast Package Delivery","ACCT# 256044025","Company Checking Account",164,NA,-3076.5
"1820","Accounts Payable","Bill Pmt -Check","2018-05-31","5130","Printing Shop","Inv#","Company Checking Account",160,NA,-2916.5
"1821","Accounts Payable","Bill","2018-05-31","45087","Printing Shop","Packaging materials with logo","Packaging Materials",NA,1000,-3916.5
"1822","Accounts Payable","Bill Pmt -Check","2018-06-05","3075","Foster Lighting",NA,"Company Checking Account",2840,NA,-1076.5
"1823","Accounts Payable","Bill","2018-06-05","124-87010","Fisse Fast Package Delivery",NA,"Freight Costs",NA,148,-1224.5
"1824","Accounts Payable","Bill","2018-06-07","90897","Foster Lighting",NA,"-SPLIT-",NA,3150,-4374.5
"1825","Accounts Payable","Bill","2018-06-07","45674","Paulsen's Lighting",NA,"-SPLIT-",NA,3625,-7999.5
"1826","Accounts Payable","Bill Pmt -Check","2018-06-29","5155","Fisse Fast Package Delivery","ACCT# 256044025","Company Checking Account",148,NA,-7851.5
"1827","Accounts Payable","Bill Pmt -Check","2018-06-29","5156","Printing Shop","Inv#","Company Checking Account",1000,NA,-6851.5
"1828","Accounts Payable","Bill","2018-07-01","159087","Printing Shop","Fall catalog","Promotional Expense",NA,675,-7526.5
"1829","Accounts Payable","Bill","2018-07-01","Commission Jan - Jun","Michael Kretchmar","Commission on sales of $79,815.90 (see report) x 5%. January - June 2007. Based on a cash basis.","Sales Commission (outside reps)",NA,3990.8,-11517.3
"1830","Accounts Payable","Bill Pmt -Check","2018-07-05","3076","Foster Lighting",NA,"Company Checking Account",3150,NA,-8367.3
"1831","Accounts Payable","Bill Pmt -Check","2018-07-05","3077","Paulsen's Lighting",NA,"Company Checking Account",3625,NA,-4742.3
"1832","Accounts Payable","Bill","2018-07-05","124-89012","Fisse Fast Package Delivery",NA,"Freight Costs",NA,152,-4894.3
"1833","Accounts Payable","Bill Pmt -Check","2018-07-31","5185","Fisse Fast Package Delivery","ACCT# 256044025","Company Checking Account",152,NA,-4742.3
"1834","Accounts Payable","Bill Pmt -Check","2018-07-31","5189","Printing Shop","Inv#","Company Checking Account",675,NA,-4067.3
"1835","Accounts Payable","Bill","2018-08-01","34566","Foster Lighting",NA,"-SPLIT-",NA,845,-4912.3
"1836","Accounts Payable","Bill","2018-08-01","159008","Printing Shop","Printing costs for second half of fall promotional materials","Promotional Expense",NA,835,-5747.3
"1837","Accounts Payable","Bill","2018-08-15","124-89199","Fisse Fast Package Delivery",NA,"Freight Costs",NA,148,-5895.3
"1838","Accounts Payable","Bill","2018-08-15","160987","Printing Shop","Packaging tape with company name and logo","Packaging Materials",NA,325,-6220.3
"1839","Accounts Payable","Bill Pmt -Check","2018-08-20","3078","Foster Lighting",NA,"Company Checking Account",845,NA,-5375.3
"1840","Accounts Payable","Bill Pmt -Check","2018-08-31","5217","Fisse Fast Package Delivery","ACCT# 256044025","Company Checking Account",148,NA,-5227.3
"1841","Accounts Payable","Bill Pmt -Check","2018-08-31","5218","Printing Shop","Inv#","Company Checking Account",835,NA,-4392.3
"1842","Accounts Payable","Bill","2018-09-06","6785","Hall Lighting & Accessories",NA,"-SPLIT-",NA,8800,-13192.3
"1843","Accounts Payable","Bill","2018-09-10","9087","Foster Lighting",NA,"Inventory Asset",NA,6000,-19192.3
"1844","Accounts Payable","Bill","2018-09-10","H8765","Paulsen's Lighting",NA,"-SPLIT-",NA,9225,-28417.3
"1845","Accounts Payable","Bill Pmt -Check","2018-09-28","5239","Printing Shop","Inv#","Company Checking Account",325,NA,-28092.3
"1846","Accounts Payable","Bill","2018-09-30","124-90610","Fisse Fast Package Delivery",NA,"Freight Costs",NA,181,-28273.3
"1847","Accounts Payable","Bill","2018-10-01","15908","Printing Shop","Packaging materials with logo","Packaging Materials",NA,427.5,-28700.8
"1848","Accounts Payable","Bill","2018-10-05","9807-02","Peacock Bulb Manufacturing Company","Cust ID#WD98760","-SPLIT-",NA,175,-28875.8
"1849","Accounts Payable","Bill Pmt -Check","2018-10-05","3079","Foster Lighting",NA,"Company Checking Account",6000,NA,-22875.8
"1850","Accounts Payable","Bill Pmt -Check","2018-10-05","3080","Hall Lighting & Accessories",NA,"Company Checking Account",8800,NA,-14075.8
"1851","Accounts Payable","Bill Pmt -Check","2018-10-05","3081","Paulsen's Lighting",NA,"Company Checking Account",9225,NA,-4850.8
"1852","Accounts Payable","Bill","2018-10-30","124-90712","Fisse Fast Package Delivery",NA,"Freight Costs",NA,196,-5046.8
"1853","Accounts Payable","Bill Pmt -Check","2018-10-31","5265","Fisse Fast Package Delivery","ACCT# 256044025","Company Checking Account",181,NA,-4865.8
"1854","Accounts Payable","Bill Pmt -Check","2018-10-31","5266","Printing Shop","Inv#","Company Checking Account",427.5,NA,-4438.3
"1855","Accounts Payable","Bill","2018-11-01","160321","Printing Shop","Marketing materials","Marketing Expense",NA,197,-4635.3
"1856","Accounts Payable","Bill Pmt -Check","2018-11-05","3082","Peacock Bulb Manufacturing Company","Cust ID#WD98760","Company Checking Account",175,NA,-4460.3
"1857","Accounts Payable","Bill","2018-11-15",NA,"Peacock Bulb Manufacturing Company",NA,"-SPLIT-",NA,2450,-6910.3
"1858","Accounts Payable","Bill Pmt -Check","2018-11-30","5290","Fisse Fast Package Delivery","ACCT# 256044025","Company Checking Account",196,NA,-6714.3
"1859","Accounts Payable","Bill Pmt -Check","2018-11-30","5291","Printing Shop","Inv#","Company Checking Account",197,NA,-6517.3
"1860","Accounts Payable","Bill","2018-12-06","FL0987","Foster Lighting",NA,"-SPLIT-",NA,2170,-8687.3
"1861","Accounts Payable","Bill","2018-12-11","TB-0987","Peacock Bulb Manufacturing Company",NA,"-SPLIT-",NA,800,-9487.3
"1862","Accounts Payable","Bill","2018-12-15","P0989","Paulsen's Lighting",NA,"Purchases  (Cost of Goods)",NA,5400,-14887.3
"1863","Accounts Payable","Bill","2018-12-15","124-90874","Fisse Fast Package Delivery",NA,"Freight Costs",NA,162,-15049.3
"1864","Accounts Payable","Bill","2018-12-15","15789","Printing Shop","Letterhead and cards","Supplies",NA,340,-15389.3
"1865","Accounts Payable","Bill","2018-12-15",NA,"Paulsen's Lighting",NA,"-SPLIT-",NA,1810,-17199.3
"1866","Accounts Payable","Bill Pmt -Check","2018-12-31","5313","Fisse Fast Package Delivery","ACCT# 256044025","Company Checking Account",162,NA,-17037.3
"1867","Accounts Payable","Bill Pmt -Check","2018-12-31","5314","Printing Shop","Inv#","Company Checking Account",340,NA,-16697.3
"1870","QuickBooks Credit Card","Credit Card Charge","2018-01-07","1269875","Randy's Floral","Gift for client","Promotional Expense",NA,355,-355
"1871","QuickBooks Credit Card","Credit Card Charge","2018-01-25","1578932","Larsen Gas Station","gas","Gas",NA,22.56,-377.56
"1872","QuickBooks Credit Card","Credit Card Charge","2018-01-28","1256831","Business Supply Center","ink cartridges","Supplies",NA,18.15,-395.71
"1873","QuickBooks Credit Card","Check","2018-01-29","5020","Credit Card","ACCT# 3786401297855001","Company Checking Account",95.71,NA,-300
"1874","QuickBooks Credit Card","Credit Card Charge","2018-02-12","CC","Jenny's Cafe","lunch with Jonathan","Meals and Entertainment",NA,32.09,-332.09
"1875","QuickBooks Credit Card","Credit Card Charge","2018-02-18","1256935","Vin's Restaurant","Lunch with Crimson","Meals and Entertainment",NA,56,-388.09
"1876","QuickBooks Credit Card","Check","2018-02-28","5054","Credit Card","ACCT# 3786401297855001","Company Checking Account",56,NA,-332.09
"1877","QuickBooks Credit Card","Credit Card Charge","2018-02-28","cc","Jenny's Cafe","lunch","Meals and Entertainment",NA,35.97,-368.06
"1878","QuickBooks Credit Card","Credit Card Charge","2018-03-12",NA,"Norton Discount Warehouse",NA,"Supplies",NA,631.23,-999.29
"1879","QuickBooks Credit Card","Credit Card Charge","2018-03-28","125385","Local Restaurant","Staff lunch with Society Corp","Meals and Entertainment",NA,51,-1050.29
"1880","QuickBooks Credit Card","Check","2018-03-30","5078","Credit Card","ACCT# 3786401297855001","Company Checking Account",682.23,NA,-368.06
"1881","QuickBooks Credit Card","Credit Card Charge","2018-04-12",NA,"Electronics & Computer Store","computer supplies","Supplies",NA,65.2,-433.26
"1882","QuickBooks Credit Card","Credit Card Charge","2018-04-15","cc","Online Accounting","Quarterly checkup","Accounting Fees",NA,255,-688.26
"1883","QuickBooks Credit Card","Credit Card Charge","2018-04-17","1256931",NA,NA,"Supplies",NA,23.6,-711.86
"1884","QuickBooks Credit Card","Credit Card Charge","2018-04-26",NA,"Local Market","kitchen supplies","Supplies",NA,54.95,-766.81
"1885","QuickBooks Credit Card","Credit Card Charge","2018-04-28","cc","Jenny's Cafe","lunch","Meals and Entertainment",NA,35.97,-802.78
"1886","QuickBooks Credit Card","Check","2018-04-30","5105","Credit Card","ACCT# 3786401297855001","Company Checking Account",143.75,NA,-659.03
"1887","QuickBooks Credit Card","Credit Card Charge","2018-05-12","8752361","Randy's Floral","flowers for employee","Supplies",NA,65,-724.03
"1888","QuickBooks Credit Card","Credit Card Charge","2018-05-20","cc","Jenny's Cafe","lunch brough in for everyone","Meals and Entertainment",NA,80.09,-804.12
"1889","QuickBooks Credit Card","Check","2018-05-31","5132","Credit Card","ACCT# 3786401297855001","Company Checking Account",65,NA,-739.12
"1890","QuickBooks Credit Card","Credit Card Charge","2018-06-23",NA,"Electronics & Computer Store","computer supplies","Supplies",NA,23.6,-762.72
"1891","QuickBooks Credit Card","Check","2018-06-29","5159","Credit Card","ACCT# 3786401297855001","Company Checking Account",23.6,NA,-739.12
"1892","QuickBooks Credit Card","Credit Card Charge","2018-07-04",NA,"Electronics & Computer Store","computer supplies","Supplies",NA,98.21,-837.33
"1893","QuickBooks Credit Card","Credit Card Charge","2018-07-12",NA,"Ken Chen Coffee","coffee for office","Supplies",NA,23.9,-861.23
"1894","QuickBooks Credit Card","Credit Card Charge","2018-07-15","cc","Online Accounting","Quarterly checkup","Accounting Fees",NA,255,-1116.23
"1895","QuickBooks Credit Card","Check","2018-07-31","5186","Credit Card","ACCT# 3786401297855001","Company Checking Account",122.11,NA,-994.12
"1896","QuickBooks Credit Card","Credit Card Charge","2018-08-06",NA,"Ken Chen Coffee","coffee for office","Supplies",NA,23.9,-1018.02
"1897","QuickBooks Credit Card","Credit Card Charge","2018-08-10",NA,"Electronics & Computer Store","computer supplies","Supplies",NA,42.13,-1060.15
"1898","QuickBooks Credit Card","Check","2018-08-31","5216","Credit Card","ACCT# 3786401297855001","Company Checking Account",66.03,NA,-994.12
"1899","QuickBooks Credit Card","Credit Card Charge","2018-09-10",NA,"Local Market","kitchen supplies","Supplies",NA,78.41,-1072.53
"1900","QuickBooks Credit Card","Credit Card Charge","2018-09-10","7/15/03","Local Market","kitchen supplies","Supplies",NA,54.98,-1127.51
"1901","QuickBooks Credit Card","Credit Card Charge","2018-09-12","12369523","Local Market","kitchen supplies","Supplies",NA,65.21,-1192.72
"1902","QuickBooks Credit Card","Credit Card Charge","2018-09-12",NA,"Electronics & Computer Store","computer supplies","Supplies",NA,23.21,-1215.93
"1903","QuickBooks Credit Card","Check","2018-09-28","5242","Credit Card","ACCT# 3786401297855001","Company Checking Account",156.6,NA,-1059.33
"1904","QuickBooks Credit Card","Credit Card Charge","2018-10-05","1236952","Office Supply Store","supplies","Supplies",NA,97.23,-1156.56
"1905","QuickBooks Credit Card","Credit Card Charge","2018-10-10",NA,"Electronics & Computer Store","computer supplies","Supplies",NA,75.12,-1231.68
"1906","QuickBooks Credit Card","Credit Card Charge","2018-10-15","cc","Online Accounting","Quarterly checkup","Accounting Fees",NA,255,-1486.68
"1907","QuickBooks Credit Card","Check","2018-10-31","5268","Credit Card","ACCT# 3786401297855001","Company Checking Account",172.35,NA,-1314.33
"1908","QuickBooks Credit Card","Credit Card Charge","2018-11-04",NA,"Electronics & Computer Store","computer supplies","Supplies",NA,39.58,-1353.91
"1909","QuickBooks Credit Card","Credit Card Charge","2018-11-24",NA,"Ken Chen Coffee","coffee for office","Supplies",NA,23.9,-1377.81
"1910","QuickBooks Credit Card","Credit Card Charge","2018-11-24",NA,"Randy's Floral","holiday decorations","Supplies",NA,78,-1455.81
"1911","QuickBooks Credit Card","Credit Card Charge","2018-11-26","2356289","Cecil's Lockworks","new keys","Supplies",NA,26,-1481.81
"1912","QuickBooks Credit Card","Check","2018-11-30","5294","Credit Card","ACCT# 3786401297855001","Company Checking Account",232.69,NA,-1249.12
"1913","QuickBooks Credit Card","Credit Card Charge","2018-12-19","125963321","Local Restaurant","Company Holiday Party","Meals and Entertainment",NA,263,-1512.12
"1914","QuickBooks Credit Card","Credit Card Charge","2018-12-27",NA,"Electronics & Computer Store","computer supplies","Supplies",NA,125.41,-1637.53
"1915","QuickBooks Credit Card","Check","2018-12-31","5316","Credit Card","ACCT# 3786401297855001","Company Checking Account",388.41,NA,-1249.12
"1918","Customer Deposits","Invoice","2018-12-15","71137","Dan A. North Builders:Custom Order - Suite 100A","50% down payment","Accounts Receivable",3500,NA,3500
"1921","Line of Credit","General Journal","2018-01-31","Interest",NA,NA,"Interest Expense",NA,100.13,-23509.36
"1922","Line of Credit","Transfer","2018-02-09",NA,NA,"Funds Transfer","Company Checking Account",10000,NA,-13509.36
"1923","Line of Credit","General Journal","2018-02-28","Interest",NA,NA,"Interest Expense",NA,80.47,-13589.83
"1924","Line of Credit","Transfer","2018-03-05",NA,NA,"Funds Transfer","Company Checking Account",NA,50000,-63589.83
"1925","Line of Credit","General Journal","2018-03-30","Interest",NA,NA,"Interest Expense",NA,81.56,-63671.39
"1926","Line of Credit","General Journal","2018-04-30","Interest",NA,NA,"Interest Expense",NA,82.98,-63754.37
"1927","Line of Credit","Transfer","2018-05-15",NA,NA,"Funds Transfer","Company Checking Account",NA,25000,-88754.37
"1928","Line of Credit","General Journal","2018-05-31","Interest",NA,NA,"Interest Expense",NA,125.89,-88880.26
"1929","Line of Credit","Transfer","2018-06-25",NA,NA,"Funds Transfer","Company Checking Account",NA,25000,-113880.26
"1930","Line of Credit","General Journal","2018-06-29","Interest",NA,NA,"Interest Expense",NA,156.65,-114036.91
"1931","Line of Credit","Transfer","2018-07-20",NA,NA,"Funds Transfer","Company Checking Account",10000,NA,-104036.91
"1932","Line of Credit","General Journal","2018-07-31","Interest",NA,NA,"Interest Expense",NA,113.25,-104150.16
"1933","Line of Credit","Transfer","2018-08-01",NA,NA,"Funds Transfer","Company Checking Account",NA,5000,-109150.16
"1934","Line of Credit","General Journal","2018-08-31","Interest",NA,NA,"Interest Expense",NA,95.65,-109245.81
"1935","Line of Credit","General Journal","2018-09-28","Interest",NA,NA,"Interest Expense",NA,97.25,-109343.06
"1936","Line of Credit","General Journal","2018-10-31","Interest",NA,NA,"Interest Expense",NA,99.56,-109442.62
"1937","Line of Credit","Transfer","2018-11-16",NA,NA,"Funds Transfer","Company Checking Account",5000,NA,-104442.62
"1938","Line of Credit","General Journal","2018-11-30","Interest",NA,NA,"Interest Expense",NA,54.21,-104496.83
"1939","Line of Credit","General Journal","2018-12-29","Interest",NA,NA,"Interest Expense",NA,60.27,-104557.1
"1940","Line of Credit","General Journal","2018-12-31","Interest",NA,NA,"Interest Expense",NA,60.98,-104618.08
"1946","Payroll Liabilities","Paycheck","2018-01-15","3003","Bolinski, Rafal",NA,"Company Checking Account",NA,115,-115
"1947","Payroll Liabilities","Paycheck","2018-01-15","3003","Bolinski, Rafal",NA,"Company Checking Account",NA,27.69,-142.69
"1948","Payroll Liabilities","Paycheck","2018-01-15","3003","Bolinski, Rafal",NA,"Company Checking Account",NA,27.69,-170.38
"1949","Payroll Liabilities","Paycheck","2018-01-15","3003","Bolinski, Rafal",NA,"Company Checking Account",NA,6.53,-176.91
"1950","Payroll Liabilities","Paycheck","2018-01-15","3003","Bolinski, Rafal",NA,"Company Checking Account",NA,6.53,-183.44
"1951","Payroll Liabilities","Paycheck","2018-01-15","3003","Bolinski, Rafal",NA,"Company Checking Account",NA,35.78,-219.22
"1952","Payroll Liabilities","Paycheck","2018-01-15","3003","Bolinski, Rafal",NA,"Company Checking Account",0,NA,-219.22
"1953","Payroll Liabilities","Paycheck","2018-01-15","3003","Bolinski, Rafal",NA,"Company Checking Account",0,NA,-219.22
"1954","Payroll Liabilities","Paycheck","2018-01-15","3003","Bolinski, Rafal",NA,"Company Checking Account",0,NA,-219.22
"1955","Payroll Liabilities","Paycheck","2018-01-15","3003","Bolinski, Rafal",NA,"Company Checking Account",0,NA,-219.22
"1956","Payroll Liabilities","Paycheck","2018-01-15","3004","Deen, Jeannette",NA,"Company Checking Account",NA,105,-324.22
"1957","Payroll Liabilities","Paycheck","2018-01-15","3004","Deen, Jeannette",NA,"Company Checking Account",NA,21.07,-345.29
"1958","Payroll Liabilities","Paycheck","2018-01-15","3004","Deen, Jeannette",NA,"Company Checking Account",NA,21.07,-366.36
"1959","Payroll Liabilities","Paycheck","2018-01-15","3004","Deen, Jeannette",NA,"Company Checking Account",NA,4.97,-371.33
"1960","Payroll Liabilities","Paycheck","2018-01-15","3004","Deen, Jeannette",NA,"Company Checking Account",NA,4.97,-376.3
"1961","Payroll Liabilities","Paycheck","2018-01-15","3004","Deen, Jeannette",NA,"Company Checking Account",NA,27.23,-403.53
"1962","Payroll Liabilities","Paycheck","2018-01-15","3001","King, Vicki",NA,"Company Checking Account",NA,115.5,-519.03
"1963","Payroll Liabilities","Paycheck","2018-01-15","3001","King, Vicki",NA,"Company Checking Account",NA,21.7,-540.73
"1964","Payroll Liabilities","Paycheck","2018-01-15","3001","King, Vicki",NA,"Company Checking Account",NA,21.7,-562.43
"1965","Payroll Liabilities","Paycheck","2018-01-15","3001","King, Vicki",NA,"Company Checking Account",NA,5.08,-567.51
"1966","Payroll Liabilities","Paycheck","2018-01-15","3001","King, Vicki",NA,"Company Checking Account",NA,5.08,-572.59
"1967","Payroll Liabilities","Paycheck","2018-01-15","3001","King, Vicki",NA,"Company Checking Account",NA,28,-600.59
"1968","Payroll Liabilities","Paycheck","2018-02-01",NA,"Wood, Deborah",NA,"Payroll Clearing (owner's time)",0,NA,-600.59
"1969","Payroll Liabilities","Paycheck","2018-02-01","3005","Bolinski, Rafal",NA,"Company Checking Account",NA,115,-715.59
"1970","Payroll Liabilities","Paycheck","2018-02-01","3005","Bolinski, Rafal",NA,"Company Checking Account",0,NA,-715.59
"1971","Payroll Liabilities","Paycheck","2018-02-01","3005","Bolinski, Rafal",NA,"Company Checking Account",NA,27.69,-743.28
"1972","Payroll Liabilities","Paycheck","2018-02-01","3005","Bolinski, Rafal",NA,"Company Checking Account",0,NA,-743.28
"1973","Payroll Liabilities","Paycheck","2018-02-01","3005","Bolinski, Rafal",NA,"Company Checking Account",NA,6.53,-749.81
"1974","Payroll Liabilities","Paycheck","2018-02-01","3005","Bolinski, Rafal",NA,"Company Checking Account",0,NA,-749.81
"1975","Payroll Liabilities","Paycheck","2018-02-01","3005","Bolinski, Rafal",NA,"Company Checking Account",0,NA,-749.81
"1976","Payroll Liabilities","Paycheck","2018-02-01","3005","Bolinski, Rafal",NA,"Company Checking Account",0,NA,-749.81
"1977","Payroll Liabilities","Paycheck","2018-02-01","3005","Bolinski, Rafal",NA,"Company Checking Account",0,NA,-749.81
"1978","Payroll Liabilities","Paycheck","2018-02-01","3005","Bolinski, Rafal",NA,"Company Checking Account",0,NA,-749.81
"1979","Payroll Liabilities","Paycheck","2018-02-01","3006","Deen, Jeannette",NA,"Company Checking Account",NA,105,-854.81
"1980","Payroll Liabilities","Paycheck","2018-02-01","3006","Deen, Jeannette",NA,"Company Checking Account",NA,21.07,-875.88
"1981","Payroll Liabilities","Paycheck","2018-02-01","3006","Deen, Jeannette",NA,"Company Checking Account",NA,21.07,-896.95
"1982","Payroll Liabilities","Paycheck","2018-02-01","3006","Deen, Jeannette",NA,"Company Checking Account",NA,4.97,-901.92
"1983","Payroll Liabilities","Paycheck","2018-02-01","3006","Deen, Jeannette",NA,"Company Checking Account",NA,4.97,-906.89
"1984","Payroll Liabilities","Paycheck","2018-02-01","3006","Deen, Jeannette",NA,"Company Checking Account",NA,27.23,-934.12
"1985","Payroll Liabilities","Paycheck","2018-02-01","3004","King, Vicki",NA,"Company Checking Account",NA,115.5,-1049.62
"1986","Payroll Liabilities","Paycheck","2018-02-01","3004","King, Vicki",NA,"Company Checking Account",NA,21.7,-1071.32
"1987","Payroll Liabilities","Paycheck","2018-02-01","3004","King, Vicki",NA,"Company Checking Account",NA,21.7,-1093.02
"1988","Payroll Liabilities","Paycheck","2018-02-01","3004","King, Vicki",NA,"Company Checking Account",NA,5.08,-1098.1
"1989","Payroll Liabilities","Paycheck","2018-02-01","3004","King, Vicki",NA,"Company Checking Account",NA,5.08,-1103.18
"1990","Payroll Liabilities","Paycheck","2018-02-01","3004","King, Vicki",NA,"Company Checking Account",NA,28,-1131.18
"1991","Payroll Liabilities","Paycheck","2018-02-15","3006","King, Vicki",NA,"Company Checking Account",NA,115.5,-1246.68
"1992","Payroll Liabilities","Paycheck","2018-02-15","3006","King, Vicki",NA,"Company Checking Account",NA,21.7,-1268.38
"1993","Payroll Liabilities","Paycheck","2018-02-15","3006","King, Vicki",NA,"Company Checking Account",NA,21.7,-1290.08
"1994","Payroll Liabilities","Paycheck","2018-02-15","3006","King, Vicki",NA,"Company Checking Account",NA,5.08,-1295.16
"1995","Payroll Liabilities","Paycheck","2018-02-15","3006","King, Vicki",NA,"Company Checking Account",NA,5.08,-1300.24
"1996","Payroll Liabilities","Paycheck","2018-02-15","3006","King, Vicki",NA,"Company Checking Account",NA,28,-1328.24
"1997","Payroll Liabilities","Paycheck","2018-02-15","3007","Bolinski, Rafal",NA,"Company Checking Account",NA,115,-1443.24
"1998","Payroll Liabilities","Paycheck","2018-02-15","3007","Bolinski, Rafal",NA,"Company Checking Account",NA,27.69,-1470.93
"1999","Payroll Liabilities","Paycheck","2018-02-15","3007","Bolinski, Rafal",NA,"Company Checking Account",NA,27.69,-1498.62
"2000","Payroll Liabilities","Paycheck","2018-02-15","3007","Bolinski, Rafal",NA,"Company Checking Account",NA,6.53,-1505.15
"2001","Payroll Liabilities","Paycheck","2018-02-15","3007","Bolinski, Rafal",NA,"Company Checking Account",NA,6.53,-1511.68
"2002","Payroll Liabilities","Paycheck","2018-02-15","3007","Bolinski, Rafal",NA,"Company Checking Account",NA,35.79,-1547.47
"2003","Payroll Liabilities","Paycheck","2018-02-15","3007","Bolinski, Rafal",NA,"Company Checking Account",0,NA,-1547.47
"2004","Payroll Liabilities","Paycheck","2018-02-15","3007","Bolinski, Rafal",NA,"Company Checking Account",0,NA,-1547.47
"2005","Payroll Liabilities","Paycheck","2018-02-15","3007","Bolinski, Rafal",NA,"Company Checking Account",0,NA,-1547.47
"2006","Payroll Liabilities","Paycheck","2018-02-15","3007","Bolinski, Rafal",NA,"Company Checking Account",0,NA,-1547.47
"2007","Payroll Liabilities","Paycheck","2018-02-15","3008","Deen, Jeannette",NA,"Company Checking Account",NA,105,-1652.47
"2008","Payroll Liabilities","Paycheck","2018-02-15","3008","Deen, Jeannette",NA,"Company Checking Account",NA,105,-1757.47
"2009","Payroll Liabilities","Paycheck","2018-02-15","3008","Deen, Jeannette",NA,"Company Checking Account",NA,21.07,-1778.54
"2010","Payroll Liabilities","Paycheck","2018-02-15","3008","Deen, Jeannette",NA,"Company Checking Account",NA,21.07,-1799.61
"2011","Payroll Liabilities","Paycheck","2018-02-15","3008","Deen, Jeannette",NA,"Company Checking Account",NA,4.97,-1804.58
"2012","Payroll Liabilities","Paycheck","2018-02-15","3008","Deen, Jeannette",NA,"Company Checking Account",NA,27.23,-1831.81
"2013","Payroll Liabilities","Liability Check","2018-02-15","5347","Local Bank","55-5555555","Company Checking Account",91.01,NA,-1740.8
"2014","Payroll Liabilities","Liability Check","2018-02-15","5347","Local Bank","55-5555555","Company Checking Account",335.5,NA,-1405.3
"2015","Payroll Liabilities","Liability Check","2018-02-15","5347","Local Bank","55-5555555","Company Checking Account",16.58,NA,-1388.72
"2016","Payroll Liabilities","Liability Check","2018-02-15","5347","Local Bank","55-5555555","Company Checking Account",16.58,NA,-1372.14
"2017","Payroll Liabilities","Liability Check","2018-02-15","5347","Local Bank","55-5555555","Company Checking Account",70.46,NA,-1301.68
"2018","Payroll Liabilities","Liability Check","2018-02-15","5347","Local Bank","55-5555555","Company Checking Account",70.46,NA,-1231.22
"2019","Payroll Liabilities","Paycheck","2018-03-01",NA,"Wood, Deborah",NA,"Payroll Clearing (owner's time)",0,NA,-1231.22
"2020","Payroll Liabilities","Paycheck","2018-03-01","3009","Bolinski, Rafal",NA,"Company Checking Account",NA,115,-1346.22
"2021","Payroll Liabilities","Paycheck","2018-03-01","3009","Bolinski, Rafal",NA,"Company Checking Account",NA,27.69,-1373.91
"2022","Payroll Liabilities","Paycheck","2018-03-01","3009","Bolinski, Rafal",NA,"Company Checking Account",NA,27.69,-1401.6
"2023","Payroll Liabilities","Paycheck","2018-03-01","3009","Bolinski, Rafal",NA,"Company Checking Account",NA,6.53,-1408.13
"2024","Payroll Liabilities","Paycheck","2018-03-01","3009","Bolinski, Rafal",NA,"Company Checking Account",NA,6.53,-1414.66
"2025","Payroll Liabilities","Paycheck","2018-03-01","3009","Bolinski, Rafal",NA,"Company Checking Account",NA,35.79,-1450.45
"2026","Payroll Liabilities","Paycheck","2018-03-01","3009","Bolinski, Rafal",NA,"Company Checking Account",0,NA,-1450.45
"2027","Payroll Liabilities","Paycheck","2018-03-01","3009","Bolinski, Rafal",NA,"Company Checking Account",0,NA,-1450.45
"2028","Payroll Liabilities","Paycheck","2018-03-01","3009","Bolinski, Rafal",NA,"Company Checking Account",0,NA,-1450.45
"2029","Payroll Liabilities","Paycheck","2018-03-01","3009","Bolinski, Rafal",NA,"Company Checking Account",0,NA,-1450.45
"2030","Payroll Liabilities","Paycheck","2018-03-01","3010","Deen, Jeannette",NA,"Company Checking Account",NA,105,-1555.45
"2031","Payroll Liabilities","Paycheck","2018-03-01","3010","Deen, Jeannette",NA,"Company Checking Account",NA,21.07,-1576.52
"2032","Payroll Liabilities","Paycheck","2018-03-01","3010","Deen, Jeannette",NA,"Company Checking Account",NA,21.07,-1597.59
"2033","Payroll Liabilities","Paycheck","2018-03-01","3010","Deen, Jeannette",NA,"Company Checking Account",NA,4.97,-1602.56
"2034","Payroll Liabilities","Paycheck","2018-03-01","3010","Deen, Jeannette",NA,"Company Checking Account",NA,4.97,-1607.53
"2035","Payroll Liabilities","Paycheck","2018-03-01","3010","Deen, Jeannette",NA,"Company Checking Account",NA,27.23,-1634.76
"2036","Payroll Liabilities","Paycheck","2018-03-01","3008","King, Vicki",NA,"Company Checking Account",NA,115.5,-1750.26
"2037","Payroll Liabilities","Paycheck","2018-03-01","3008","King, Vicki",NA,"Company Checking Account",NA,21.7,-1771.96
"2038","Payroll Liabilities","Paycheck","2018-03-01","3008","King, Vicki",NA,"Company Checking Account",NA,21.7,-1793.66
"2039","Payroll Liabilities","Paycheck","2018-03-01","3008","King, Vicki",NA,"Company Checking Account",NA,5.08,-1798.74
"2040","Payroll Liabilities","Paycheck","2018-03-01","3008","King, Vicki",NA,"Company Checking Account",NA,5.08,-1803.82
"2041","Payroll Liabilities","Paycheck","2018-03-01","3008","King, Vicki",NA,"Company Checking Account",NA,28,-1831.82
"2042","Payroll Liabilities","Paycheck","2018-03-15","3010","King, Vicki",NA,"Company Checking Account",NA,115.5,-1947.32
"2043","Payroll Liabilities","Paycheck","2018-03-15","3010","King, Vicki",NA,"Company Checking Account",NA,21.7,-1969.02
"2044","Payroll Liabilities","Paycheck","2018-03-15","3010","King, Vicki",NA,"Company Checking Account",NA,21.7,-1990.72
"2045","Payroll Liabilities","Paycheck","2018-03-15","3010","King, Vicki",NA,"Company Checking Account",NA,5.08,-1995.8
"2046","Payroll Liabilities","Paycheck","2018-03-15","3010","King, Vicki",NA,"Company Checking Account",NA,5.08,-2000.88
"2047","Payroll Liabilities","Paycheck","2018-03-15","3010","King, Vicki",NA,"Company Checking Account",NA,28,-2028.88
"2048","Payroll Liabilities","Paycheck","2018-03-15","3011","Bolinski, Rafal",NA,"Company Checking Account",NA,115,-2143.88
"2049","Payroll Liabilities","Paycheck","2018-03-15","3011","Bolinski, Rafal",NA,"Company Checking Account",NA,27.69,-2171.57
"2050","Payroll Liabilities","Paycheck","2018-03-15","3011","Bolinski, Rafal",NA,"Company Checking Account",NA,27.69,-2199.26
"2051","Payroll Liabilities","Paycheck","2018-03-15","3011","Bolinski, Rafal",NA,"Company Checking Account",NA,6.53,-2205.79
"2052","Payroll Liabilities","Paycheck","2018-03-15","3011","Bolinski, Rafal",NA,"Company Checking Account",NA,6.53,-2212.32
"2053","Payroll Liabilities","Paycheck","2018-03-15","3011","Bolinski, Rafal",NA,"Company Checking Account",NA,35.79,-2248.11
"2054","Payroll Liabilities","Paycheck","2018-03-15","3011","Bolinski, Rafal",NA,"Company Checking Account",0,NA,-2248.11
"2055","Payroll Liabilities","Paycheck","2018-03-15","3011","Bolinski, Rafal",NA,"Company Checking Account",0,NA,-2248.11
"2056","Payroll Liabilities","Paycheck","2018-03-15","3011","Bolinski, Rafal",NA,"Company Checking Account",0,NA,-2248.11
"2057","Payroll Liabilities","Paycheck","2018-03-15","3011","Bolinski, Rafal",NA,"Company Checking Account",0,NA,-2248.11
"2058","Payroll Liabilities","Paycheck","2018-03-15","3012","Deen, Jeannette",NA,"Company Checking Account",NA,105,-2353.11
"2059","Payroll Liabilities","Paycheck","2018-03-15","3012","Deen, Jeannette",NA,"Company Checking Account",NA,21.07,-2374.18
"2060","Payroll Liabilities","Paycheck","2018-03-15","3012","Deen, Jeannette",NA,"Company Checking Account",NA,21.07,-2395.25
"2061","Payroll Liabilities","Paycheck","2018-03-15","3012","Deen, Jeannette",NA,"Company Checking Account",NA,4.97,-2400.22
"2062","Payroll Liabilities","Paycheck","2018-03-15","3012","Deen, Jeannette",NA,"Company Checking Account",NA,4.97,-2405.19
"2063","Payroll Liabilities","Paycheck","2018-03-15","3012","Deen, Jeannette",NA,"Company Checking Account",NA,27.23,-2432.42
"2064","Payroll Liabilities","Liability Check","2018-03-15","5348","Local Bank","55-5555555","Company Checking Account",146.25,NA,-2286.17
"2065","Payroll Liabilities","Liability Check","2018-03-15","5348","Local Bank","55-5555555","Company Checking Account",671,NA,-1615.17
"2066","Payroll Liabilities","Liability Check","2018-03-15","5348","Local Bank","55-5555555","Company Checking Account",42.73,NA,-1572.44
"2067","Payroll Liabilities","Liability Check","2018-03-15","5348","Local Bank","55-5555555","Company Checking Account",33.16,NA,-1539.28
"2068","Payroll Liabilities","Liability Check","2018-03-15","5348","Local Bank","55-5555555","Company Checking Account",197.16,NA,-1342.12
"2069","Payroll Liabilities","Liability Check","2018-03-15","5348","Local Bank","55-5555555","Company Checking Account",140.92,NA,-1201.2
"2070","Payroll Liabilities","Paycheck","2018-04-02",NA,"Wood, Deborah",NA,"Payroll Clearing (owner's time)",0,NA,-1201.2
"2071","Payroll Liabilities","Paycheck","2018-04-02","3013","Bolinski, Rafal",NA,"Company Checking Account",NA,115,-1316.2
"2072","Payroll Liabilities","Paycheck","2018-04-02","3013","Bolinski, Rafal",NA,"Company Checking Account",NA,27.69,-1343.89
"2073","Payroll Liabilities","Paycheck","2018-04-02","3013","Bolinski, Rafal",NA,"Company Checking Account",NA,27.69,-1371.58
"2074","Payroll Liabilities","Paycheck","2018-04-02","3013","Bolinski, Rafal",NA,"Company Checking Account",NA,6.53,-1378.11
"2075","Payroll Liabilities","Paycheck","2018-04-02","3013","Bolinski, Rafal",NA,"Company Checking Account",NA,6.53,-1384.64
"2076","Payroll Liabilities","Paycheck","2018-04-02","3013","Bolinski, Rafal",NA,"Company Checking Account",NA,35.79,-1420.43
"2077","Payroll Liabilities","Paycheck","2018-04-02","3013","Bolinski, Rafal",NA,"Company Checking Account",0,NA,-1420.43
"2078","Payroll Liabilities","Paycheck","2018-04-02","3013","Bolinski, Rafal",NA,"Company Checking Account",0,NA,-1420.43
"2079","Payroll Liabilities","Paycheck","2018-04-02","3013","Bolinski, Rafal",NA,"Company Checking Account",0,NA,-1420.43
"2080","Payroll Liabilities","Paycheck","2018-04-02","3013","Bolinski, Rafal",NA,"Company Checking Account",0,NA,-1420.43
"2081","Payroll Liabilities","Paycheck","2018-04-02","3014","Deen, Jeannette",NA,"Company Checking Account",NA,105,-1525.43
"2082","Payroll Liabilities","Paycheck","2018-04-02","3014","Deen, Jeannette",NA,"Company Checking Account",NA,21.07,-1546.5
"2083","Payroll Liabilities","Paycheck","2018-04-02","3014","Deen, Jeannette",NA,"Company Checking Account",NA,21.07,-1567.57
"2084","Payroll Liabilities","Paycheck","2018-04-02","3014","Deen, Jeannette",NA,"Company Checking Account",NA,4.97,-1572.54
"2085","Payroll Liabilities","Paycheck","2018-04-02","3014","Deen, Jeannette",NA,"Company Checking Account",NA,4.97,-1577.51
"2086","Payroll Liabilities","Paycheck","2018-04-02","3014","Deen, Jeannette",NA,"Company Checking Account",NA,27.23,-1604.74
"2087","Payroll Liabilities","Paycheck","2018-04-02","3012","King, Vicki",NA,"Company Checking Account",NA,115.5,-1720.24
"2088","Payroll Liabilities","Paycheck","2018-04-02","3012","King, Vicki",NA,"Company Checking Account",NA,21.7,-1741.94
"2089","Payroll Liabilities","Paycheck","2018-04-02","3012","King, Vicki",NA,"Company Checking Account",NA,21.7,-1763.64
"2090","Payroll Liabilities","Paycheck","2018-04-02","3012","King, Vicki",NA,"Company Checking Account",NA,5.08,-1768.72
"2091","Payroll Liabilities","Paycheck","2018-04-02","3012","King, Vicki",NA,"Company Checking Account",NA,5.08,-1773.8
"2092","Payroll Liabilities","Paycheck","2018-04-02","3012","King, Vicki",NA,"Company Checking Account",NA,28,-1801.8
"2093","Payroll Liabilities","Paycheck","2018-04-15","3015","Bolinski, Rafal",NA,"Company Checking Account",NA,115,-1916.8
"2094","Payroll Liabilities","Paycheck","2018-04-15","3015","Bolinski, Rafal",NA,"Company Checking Account",NA,27.69,-1944.49
"2095","Payroll Liabilities","Paycheck","2018-04-15","3015","Bolinski, Rafal",NA,"Company Checking Account",NA,27.69,-1972.18
"2096","Payroll Liabilities","Paycheck","2018-04-15","3015","Bolinski, Rafal",NA,"Company Checking Account",NA,6.53,-1978.71
"2097","Payroll Liabilities","Paycheck","2018-04-15","3015","Bolinski, Rafal",NA,"Company Checking Account",NA,6.53,-1985.24
"2098","Payroll Liabilities","Paycheck","2018-04-15","3015","Bolinski, Rafal",NA,"Company Checking Account",NA,35.79,-2021.03
"2099","Payroll Liabilities","Paycheck","2018-04-15","3015","Bolinski, Rafal",NA,"Company Checking Account",0,NA,-2021.03
"2100","Payroll Liabilities","Paycheck","2018-04-15","3015","Bolinski, Rafal",NA,"Company Checking Account",0,NA,-2021.03
"2101","Payroll Liabilities","Paycheck","2018-04-15","3015","Bolinski, Rafal",NA,"Company Checking Account",0,NA,-2021.03
"2102","Payroll Liabilities","Paycheck","2018-04-15","3015","Bolinski, Rafal",NA,"Company Checking Account",0,NA,-2021.03
"2103","Payroll Liabilities","Paycheck","2018-04-15","3016","Deen, Jeannette",NA,"Company Checking Account",NA,105,-2126.03
"2104","Payroll Liabilities","Paycheck","2018-04-15","3016","Deen, Jeannette",NA,"Company Checking Account",NA,21.07,-2147.1
"2105","Payroll Liabilities","Paycheck","2018-04-15","3016","Deen, Jeannette",NA,"Company Checking Account",NA,21.07,-2168.17
"2106","Payroll Liabilities","Paycheck","2018-04-15","3016","Deen, Jeannette",NA,"Company Checking Account",NA,4.97,-2173.14
"2107","Payroll Liabilities","Paycheck","2018-04-15","3016","Deen, Jeannette",NA,"Company Checking Account",NA,4.97,-2178.11
"2108","Payroll Liabilities","Paycheck","2018-04-15","3016","Deen, Jeannette",NA,"Company Checking Account",NA,27.23,-2205.34
"2109","Payroll Liabilities","Liability Check","2018-04-15","5349","Local Bank","55-5555555","Company Checking Account",182.04,NA,-2023.3
"2110","Payroll Liabilities","Liability Check","2018-04-15","5349","Local Bank","55-5555555","Company Checking Account",671,NA,-1352.3
"2111","Payroll Liabilities","Liability Check","2018-04-15","5349","Local Bank","55-5555555","Company Checking Account",33.16,NA,-1319.14
"2112","Payroll Liabilities","Liability Check","2018-04-15","5349","Local Bank","55-5555555","Company Checking Account",33.16,NA,-1285.98
"2113","Payroll Liabilities","Liability Check","2018-04-15","5349","Local Bank","55-5555555","Company Checking Account",140.92,NA,-1145.06
"2114","Payroll Liabilities","Liability Check","2018-04-15","5349","Local Bank","55-5555555","Company Checking Account",140.92,NA,-1004.14
"2115","Payroll Liabilities","Paycheck","2018-04-16","3014","King, Vicki",NA,"Company Checking Account",NA,69.29,-1073.43
"2116","Payroll Liabilities","Paycheck","2018-04-16","3014","King, Vicki",NA,"Company Checking Account",NA,13,-1086.43
"2117","Payroll Liabilities","Paycheck","2018-04-16","3014","King, Vicki",NA,"Company Checking Account",NA,13,-1099.43
"2118","Payroll Liabilities","Paycheck","2018-04-16","3014","King, Vicki",NA,"Company Checking Account",NA,3.07,-1102.5
"2119","Payroll Liabilities","Paycheck","2018-04-16","3014","King, Vicki",NA,"Company Checking Account",NA,3.07,-1105.57
"2120","Payroll Liabilities","Paycheck","2018-04-16","3014","King, Vicki",NA,"Company Checking Account",NA,16.8,-1122.37
"2121","Payroll Liabilities","Paycheck","2018-05-01",NA,"Wood, Deborah",NA,"Payroll Clearing (owner's time)",0,NA,-1122.37
"2122","Payroll Liabilities","Paycheck","2018-05-01","3017","Bolinski, Rafal",NA,"Company Checking Account",NA,115,-1237.37
"2123","Payroll Liabilities","Paycheck","2018-05-01","3017","Bolinski, Rafal",NA,"Company Checking Account",NA,27.69,-1265.06
"2124","Payroll Liabilities","Paycheck","2018-05-01","3017","Bolinski, Rafal",NA,"Company Checking Account",NA,27.69,-1292.75
"2125","Payroll Liabilities","Paycheck","2018-05-01","3017","Bolinski, Rafal",NA,"Company Checking Account",NA,6.53,-1299.28
"2126","Payroll Liabilities","Paycheck","2018-05-01","3017","Bolinski, Rafal",NA,"Company Checking Account",NA,6.53,-1305.81
"2127","Payroll Liabilities","Paycheck","2018-05-01","3017","Bolinski, Rafal",NA,"Company Checking Account",NA,7.78,-1313.59
"2128","Payroll Liabilities","Paycheck","2018-05-01","3017","Bolinski, Rafal",NA,"Company Checking Account",0,NA,-1313.59
"2129","Payroll Liabilities","Paycheck","2018-05-01","3017","Bolinski, Rafal",NA,"Company Checking Account",0,NA,-1313.59
"2130","Payroll Liabilities","Paycheck","2018-05-01","3017","Bolinski, Rafal",NA,"Company Checking Account",0,NA,-1313.59
"2131","Payroll Liabilities","Paycheck","2018-05-01","3017","Bolinski, Rafal",NA,"Company Checking Account",0,NA,-1313.59
"2132","Payroll Liabilities","Paycheck","2018-05-01","3018","Deen, Jeannette",NA,"Company Checking Account",NA,105,-1418.59
"2133","Payroll Liabilities","Paycheck","2018-05-01","3018","Deen, Jeannette",NA,"Company Checking Account",NA,21.07,-1439.66
"2134","Payroll Liabilities","Paycheck","2018-05-01","3018","Deen, Jeannette",NA,"Company Checking Account",NA,21.07,-1460.73
"2135","Payroll Liabilities","Paycheck","2018-05-01","3018","Deen, Jeannette",NA,"Company Checking Account",NA,4.97,-1465.7
"2136","Payroll Liabilities","Paycheck","2018-05-01","3018","Deen, Jeannette",NA,"Company Checking Account",NA,4.97,-1470.67
"2137","Payroll Liabilities","Paycheck","2018-05-01","3018","Deen, Jeannette",NA,"Company Checking Account",NA,27.23,-1497.9
"2138","Payroll Liabilities","Paycheck","2018-05-01","3016","King, Vicki",NA,"Company Checking Account",NA,69.29,-1567.19
"2139","Payroll Liabilities","Paycheck","2018-05-01","3016","King, Vicki",NA,"Company Checking Account",NA,13,-1580.19
"2140","Payroll Liabilities","Paycheck","2018-05-01","3016","King, Vicki",NA,"Company Checking Account",NA,13,-1593.19
"2141","Payroll Liabilities","Paycheck","2018-05-01","3016","King, Vicki",NA,"Company Checking Account",NA,3.07,-1596.26
"2142","Payroll Liabilities","Paycheck","2018-05-01","3016","King, Vicki",NA,"Company Checking Account",NA,3.07,-1599.33
"2143","Payroll Liabilities","Paycheck","2018-05-01","3016","King, Vicki",NA,"Company Checking Account",NA,16.8,-1616.13
"2144","Payroll Liabilities","Liability Check","2018-05-13","5350","Local Bank","55-5555555","Company Checking Account",170.84,NA,-1445.29
"2145","Payroll Liabilities","Liability Check","2018-05-13","5350","Local Bank","55-5555555","Company Checking Account",624.79,NA,-820.5
"2146","Payroll Liabilities","Liability Check","2018-05-13","5350","Local Bank","55-5555555","Company Checking Account",31.15,NA,-789.35
"2147","Payroll Liabilities","Liability Check","2018-05-13","5350","Local Bank","55-5555555","Company Checking Account",31.15,NA,-758.2
"2148","Payroll Liabilities","Liability Check","2018-05-13","5350","Local Bank","55-5555555","Company Checking Account",132.22,NA,-625.98
"2149","Payroll Liabilities","Liability Check","2018-05-13","5350","Local Bank","55-5555555","Company Checking Account",132.22,NA,-493.76
"2150","Payroll Liabilities","Liability Check","2018-05-13","5351","Local Bank","55-5555555","Company Checking Account",131.73,NA,-362.03
"2151","Payroll Liabilities","Liability Check","2018-05-13","5351","Local Bank","55-5555555","Company Checking Account",578.58,NA,216.55
"2152","Payroll Liabilities","Liability Check","2018-05-13","5351","Local Bank","55-5555555","Company Checking Account",29.14,NA,245.69
"2153","Payroll Liabilities","Liability Check","2018-05-13","5351","Local Bank","55-5555555","Company Checking Account",29.14,NA,274.83
"2154","Payroll Liabilities","Liability Check","2018-05-13","5351","Local Bank","55-5555555","Company Checking Account",123.52,NA,398.35
"2155","Payroll Liabilities","Liability Check","2018-05-13","5351","Local Bank","55-5555555","Company Checking Account",123.52,NA,521.87
"2156","Payroll Liabilities","Paycheck","2018-05-15","3019","Bolinski, Rafal",NA,"Company Checking Account",NA,115,406.87
"2157","Payroll Liabilities","Paycheck","2018-05-15","3019","Bolinski, Rafal",NA,"Company Checking Account",NA,27.69,379.18
"2158","Payroll Liabilities","Paycheck","2018-05-15","3019","Bolinski, Rafal",NA,"Company Checking Account",NA,27.69,351.49
"2159","Payroll Liabilities","Paycheck","2018-05-15","3019","Bolinski, Rafal",NA,"Company Checking Account",NA,6.53,344.96
"2160","Payroll Liabilities","Paycheck","2018-05-15","3019","Bolinski, Rafal",NA,"Company Checking Account",NA,6.53,338.43
"2161","Payroll Liabilities","Paycheck","2018-05-15","3019","Bolinski, Rafal",NA,"Company Checking Account",NA,35.79,302.64
"2162","Payroll Liabilities","Paycheck","2018-05-15","3019","Bolinski, Rafal",NA,"Company Checking Account",0,NA,302.64
"2163","Payroll Liabilities","Paycheck","2018-05-15","3019","Bolinski, Rafal",NA,"Company Checking Account",0,NA,302.64
"2164","Payroll Liabilities","Paycheck","2018-05-15","3019","Bolinski, Rafal",NA,"Company Checking Account",0,NA,302.64
"2165","Payroll Liabilities","Paycheck","2018-05-15","3019","Bolinski, Rafal",NA,"Company Checking Account",0,NA,302.64
"2166","Payroll Liabilities","Paycheck","2018-05-15","3020","Deen, Jeannette",NA,"Company Checking Account",NA,105,197.64
"2167","Payroll Liabilities","Paycheck","2018-05-15","3020","Deen, Jeannette",NA,"Company Checking Account",NA,21.07,176.57
"2168","Payroll Liabilities","Paycheck","2018-05-15","3020","Deen, Jeannette",NA,"Company Checking Account",NA,21.07,155.5
"2169","Payroll Liabilities","Paycheck","2018-05-15","3020","Deen, Jeannette",NA,"Company Checking Account",NA,4.97,150.53
"2170","Payroll Liabilities","Paycheck","2018-05-15","3020","Deen, Jeannette",NA,"Company Checking Account",NA,4.97,145.56
"2171","Payroll Liabilities","Paycheck","2018-05-15","3020","Deen, Jeannette",NA,"Company Checking Account",NA,27.33,118.23
"2172","Payroll Liabilities","Paycheck","2018-05-15","3018","King, Vicki",NA,"Company Checking Account",NA,69.29,48.94
"2173","Payroll Liabilities","Paycheck","2018-05-15","3018","King, Vicki",NA,"Company Checking Account",NA,13,35.94
"2174","Payroll Liabilities","Paycheck","2018-05-15","3018","King, Vicki",NA,"Company Checking Account",NA,13,22.94
"2175","Payroll Liabilities","Paycheck","2018-05-15","3018","King, Vicki",NA,"Company Checking Account",NA,3.07,19.87
"2176","Payroll Liabilities","Paycheck","2018-05-15","3018","King, Vicki",NA,"Company Checking Account",NA,3.07,16.8
"2179","Payroll Liabilities","Paycheck","2018-06-01","3020","King, Vicki",NA,"Company Checking Account",NA,69.29,-69.29
"2180","Payroll Liabilities","Paycheck","2018-06-01","3020","King, Vicki",NA,"Company Checking Account",NA,13,-82.29
"2181","Payroll Liabilities","Paycheck","2018-06-01","3020","King, Vicki",NA,"Company Checking Account",NA,13,-95.29
"2182","Payroll Liabilities","Paycheck","2018-06-01","3020","King, Vicki",NA,"Company Checking Account",NA,3.07,-98.36
"2183","Payroll Liabilities","Paycheck","2018-06-01","3020","King, Vicki",NA,"Company Checking Account",NA,3.07,-101.43
"2184","Payroll Liabilities","Paycheck","2018-06-01","3020","King, Vicki",NA,"Company Checking Account",NA,16.8,-118.23
"2185","Payroll Liabilities","Paycheck","2018-06-01","3021","Bolinski, Rafal",NA,"Company Checking Account",NA,115,-233.23
"2186","Payroll Liabilities","Paycheck","2018-06-01","3021","Bolinski, Rafal",NA,"Company Checking Account",NA,27.69,-260.92
"2187","Payroll Liabilities","Paycheck","2018-06-01","3021","Bolinski, Rafal",NA,"Company Checking Account",NA,27.69,-288.61
"2188","Payroll Liabilities","Paycheck","2018-06-01","3021","Bolinski, Rafal",NA,"Company Checking Account",NA,6.53,-295.14
"2189","Payroll Liabilities","Paycheck","2018-06-01","3021","Bolinski, Rafal",NA,"Company Checking Account",NA,6.53,-301.67
"2190","Payroll Liabilities","Paycheck","2018-06-01","3021","Bolinski, Rafal",NA,"Company Checking Account",NA,35.79,-337.46
"2191","Payroll Liabilities","Paycheck","2018-06-01","3021","Bolinski, Rafal",NA,"Company Checking Account",0,NA,-337.46
"2192","Payroll Liabilities","Paycheck","2018-06-01","3021","Bolinski, Rafal",NA,"Company Checking Account",0,NA,-337.46
"2193","Payroll Liabilities","Paycheck","2018-06-01","3021","Bolinski, Rafal",NA,"Company Checking Account",0,NA,-337.46
"2194","Payroll Liabilities","Paycheck","2018-06-01","3021","Bolinski, Rafal",NA,"Company Checking Account",0,NA,-337.46
"2195","Payroll Liabilities","Paycheck","2018-06-01","3022","Deen, Jeannette",NA,"Company Checking Account",NA,105,-442.46
"2196","Payroll Liabilities","Paycheck","2018-06-01","3022","Deen, Jeannette",NA,"Company Checking Account",NA,21.07,-463.53
"2197","Payroll Liabilities","Paycheck","2018-06-01","3022","Deen, Jeannette",NA,"Company Checking Account",NA,21.07,-484.6
"2198","Payroll Liabilities","Paycheck","2018-06-01","3022","Deen, Jeannette",NA,"Company Checking Account",NA,4.97,-489.57
"2199","Payroll Liabilities","Paycheck","2018-06-01","3022","Deen, Jeannette",NA,"Company Checking Account",NA,4.97,-494.54
"2200","Payroll Liabilities","Paycheck","2018-06-01","3022","Deen, Jeannette",NA,"Company Checking Account",NA,27.23,-521.77
"2201","Payroll Liabilities","Paycheck","2018-06-15","3023","Bolinski, Rafal",NA,"Company Checking Account",NA,115,-636.77
"2202","Payroll Liabilities","Paycheck","2018-06-15","3023","Bolinski, Rafal",NA,"Company Checking Account",NA,27.69,-664.46
"2203","Payroll Liabilities","Paycheck","2018-06-15","3023","Bolinski, Rafal",NA,"Company Checking Account",NA,27.69,-692.15
"2204","Payroll Liabilities","Paycheck","2018-06-15","3023","Bolinski, Rafal",NA,"Company Checking Account",NA,6.53,-698.68
"2205","Payroll Liabilities","Paycheck","2018-06-15","3023","Bolinski, Rafal",NA,"Company Checking Account",NA,6.53,-705.21
"2206","Payroll Liabilities","Paycheck","2018-06-15","3023","Bolinski, Rafal",NA,"Company Checking Account",NA,35.79,-741
"2207","Payroll Liabilities","Paycheck","2018-06-15","3023","Bolinski, Rafal",NA,"Company Checking Account",0,NA,-741
"2208","Payroll Liabilities","Paycheck","2018-06-15","3023","Bolinski, Rafal",NA,"Company Checking Account",0,NA,-741
"2209","Payroll Liabilities","Paycheck","2018-06-15","3023","Bolinski, Rafal",NA,"Company Checking Account",0,NA,-741
"2210","Payroll Liabilities","Paycheck","2018-06-15","3023","Bolinski, Rafal",NA,"Company Checking Account",0,NA,-741
"2211","Payroll Liabilities","Paycheck","2018-06-15","3024","Deen, Jeannette",NA,"Company Checking Account",NA,105,-846
"2212","Payroll Liabilities","Paycheck","2018-06-15","3024","Deen, Jeannette",NA,"Company Checking Account",NA,21.07,-867.07
"2213","Payroll Liabilities","Paycheck","2018-06-15","3024","Deen, Jeannette",NA,"Company Checking Account",NA,21.07,-888.14
"2214","Payroll Liabilities","Paycheck","2018-06-15","3024","Deen, Jeannette",NA,"Company Checking Account",NA,4.97,-893.11
"2215","Payroll Liabilities","Paycheck","2018-06-15","3024","Deen, Jeannette",NA,"Company Checking Account",NA,4.97,-898.08
"2216","Payroll Liabilities","Paycheck","2018-06-15","3024","Deen, Jeannette",NA,"Company Checking Account",NA,27.23,-925.31
"2217","Payroll Liabilities","Paycheck","2018-06-15","3022","King, Vicki",NA,"Company Checking Account",NA,69.29,-994.6
"2218","Payroll Liabilities","Paycheck","2018-06-15","3022","King, Vicki",NA,"Company Checking Account",NA,13,-1007.6
"2219","Payroll Liabilities","Paycheck","2018-06-15","3022","King, Vicki",NA,"Company Checking Account",NA,13,-1020.6
"2220","Payroll Liabilities","Paycheck","2018-06-15","3022","King, Vicki",NA,"Company Checking Account",NA,3.07,-1023.67
"2221","Payroll Liabilities","Paycheck","2018-06-15","3022","King, Vicki",NA,"Company Checking Account",NA,3.07,-1026.74
"2222","Payroll Liabilities","Paycheck","2018-06-15","3022","King, Vicki",NA,"Company Checking Account",NA,16.8,-1043.54
"2223","Payroll Liabilities","Paycheck","2018-07-01","3025","Bolinski, Rafal",NA,"Company Checking Account",NA,115,-1158.54
"2224","Payroll Liabilities","Paycheck","2018-07-01","3025","Bolinski, Rafal",NA,"Company Checking Account",NA,115,-1273.54
"2225","Payroll Liabilities","Paycheck","2018-07-01","3025","Bolinski, Rafal",NA,"Company Checking Account",NA,27.69,-1301.23
"2226","Payroll Liabilities","Paycheck","2018-07-01","3025","Bolinski, Rafal",NA,"Company Checking Account",NA,27.69,-1328.92
"2227","Payroll Liabilities","Paycheck","2018-07-01","3025","Bolinski, Rafal",NA,"Company Checking Account",NA,6.53,-1335.45
"2228","Payroll Liabilities","Paycheck","2018-07-01","3025","Bolinski, Rafal",NA,"Company Checking Account",NA,6.53,-1341.98
"2229","Payroll Liabilities","Paycheck","2018-07-01","3025","Bolinski, Rafal",NA,"Company Checking Account",0,NA,-1341.98
"2230","Payroll Liabilities","Paycheck","2018-07-01","3025","Bolinski, Rafal",NA,"Company Checking Account",0,NA,-1341.98
"2231","Payroll Liabilities","Paycheck","2018-07-01","3025","Bolinski, Rafal",NA,"Company Checking Account",0,NA,-1341.98
"2232","Payroll Liabilities","Paycheck","2018-07-01","3025","Bolinski, Rafal",NA,"Company Checking Account",0,NA,-1341.98
"2233","Payroll Liabilities","Paycheck","2018-07-01","3026","Deen, Jeannette",NA,"Company Checking Account",NA,105,-1446.98
"2234","Payroll Liabilities","Paycheck","2018-07-01","3026","Deen, Jeannette",NA,"Company Checking Account",NA,21.07,-1468.05
"2235","Payroll Liabilities","Paycheck","2018-07-01","3026","Deen, Jeannette",NA,"Company Checking Account",NA,21.07,-1489.12
"2236","Payroll Liabilities","Paycheck","2018-07-01","3026","Deen, Jeannette",NA,"Company Checking Account",NA,4.97,-1494.09
"2237","Payroll Liabilities","Paycheck","2018-07-01","3026","Deen, Jeannette",NA,"Company Checking Account",NA,4.97,-1499.06
"2238","Payroll Liabilities","Paycheck","2018-07-01","3026","Deen, Jeannette",NA,"Company Checking Account",NA,27.23,-1526.29
"2239","Payroll Liabilities","Paycheck","2018-07-02",NA,"Wood, Deborah",NA,"Payroll Clearing (owner's time)",0,NA,-1526.29
"2240","Payroll Liabilities","Paycheck","2018-07-02","3024","King, Vicki",NA,"Company Checking Account",NA,69.29,-1595.58
"2241","Payroll Liabilities","Paycheck","2018-07-02","3024","King, Vicki",NA,"Company Checking Account",NA,13,-1608.58
"2242","Payroll Liabilities","Paycheck","2018-07-02","3024","King, Vicki",NA,"Company Checking Account",NA,13,-1621.58
"2243","Payroll Liabilities","Paycheck","2018-07-02","3024","King, Vicki",NA,"Company Checking Account",NA,3.07,-1624.65
"2244","Payroll Liabilities","Paycheck","2018-07-02","3024","King, Vicki",NA,"Company Checking Account",NA,3.07,-1627.72
"2245","Payroll Liabilities","Paycheck","2018-07-02","3024","King, Vicki",NA,"Company Checking Account",NA,16.8,-1644.52
"2246","Payroll Liabilities","Paycheck","2018-07-15","3027","Bolinski, Rafal",NA,"Company Checking Account",NA,115,-1759.52
"2247","Payroll Liabilities","Paycheck","2018-07-15","3027","Bolinski, Rafal",NA,"Company Checking Account",NA,27.69,-1787.21
"2248","Payroll Liabilities","Paycheck","2018-07-15","3027","Bolinski, Rafal",NA,"Company Checking Account",NA,27.69,-1814.9
"2249","Payroll Liabilities","Paycheck","2018-07-15","3027","Bolinski, Rafal",NA,"Company Checking Account",NA,6.53,-1821.43
"2250","Payroll Liabilities","Paycheck","2018-07-15","3027","Bolinski, Rafal",NA,"Company Checking Account",NA,6.53,-1827.96
"2251","Payroll Liabilities","Paycheck","2018-07-15","3027","Bolinski, Rafal",NA,"Company Checking Account",NA,35.79,-1863.75
"2252","Payroll Liabilities","Paycheck","2018-07-15","3027","Bolinski, Rafal",NA,"Company Checking Account",0,NA,-1863.75
"2253","Payroll Liabilities","Paycheck","2018-07-15","3027","Bolinski, Rafal",NA,"Company Checking Account",0,NA,-1863.75
"2254","Payroll Liabilities","Paycheck","2018-07-15","3027","Bolinski, Rafal",NA,"Company Checking Account",0,NA,-1863.75
"2255","Payroll Liabilities","Paycheck","2018-07-15","3027","Bolinski, Rafal",NA,"Company Checking Account",0,NA,-1863.75
"2256","Payroll Liabilities","Paycheck","2018-07-15","3028","Deen, Jeannette",NA,"Company Checking Account",NA,105,-1968.75
"2257","Payroll Liabilities","Paycheck","2018-07-15","3028","Deen, Jeannette",NA,"Company Checking Account",NA,21.07,-1989.82
"2258","Payroll Liabilities","Paycheck","2018-07-15","3028","Deen, Jeannette",NA,"Company Checking Account",NA,21.07,-2010.89
"2259","Payroll Liabilities","Paycheck","2018-07-15","3028","Deen, Jeannette",NA,"Company Checking Account",NA,4.97,-2015.86
"2260","Payroll Liabilities","Paycheck","2018-07-15","3028","Deen, Jeannette",NA,"Company Checking Account",NA,4.97,-2020.83
"2261","Payroll Liabilities","Paycheck","2018-07-15","3028","Deen, Jeannette",NA,"Company Checking Account",NA,27.23,-2048.06
"2262","Payroll Liabilities","Liability Check","2018-07-15","5352","Local Bank","55-5555555","Company Checking Account",159.64,NA,-1888.42
"2263","Payroll Liabilities","Liability Check","2018-07-15","5352","Local Bank","55-5555555","Company Checking Account",578.58,NA,-1309.84
"2264","Payroll Liabilities","Liability Check","2018-07-15","5352","Local Bank","55-5555555","Company Checking Account",29.14,NA,-1280.7
"2265","Payroll Liabilities","Liability Check","2018-07-15","5352","Local Bank","55-5555555","Company Checking Account",29.14,NA,-1251.56
"2266","Payroll Liabilities","Liability Check","2018-07-15","5352","Local Bank","55-5555555","Company Checking Account",123.52,NA,-1128.04
"2267","Payroll Liabilities","Liability Check","2018-07-15","5352","Local Bank","55-5555555","Company Checking Account",123.52,NA,-1004.52
"2268","Payroll Liabilities","Paycheck","2018-07-17","3026","King, Vicki",NA,"Company Checking Account",NA,69.29,-1073.81
"2269","Payroll Liabilities","Paycheck","2018-07-17","3026","King, Vicki",NA,"Company Checking Account",NA,13,-1086.81
"2270","Payroll Liabilities","Paycheck","2018-07-17","3026","King, Vicki",NA,"Company Checking Account",NA,13,-1099.81
"2271","Payroll Liabilities","Paycheck","2018-07-17","3026","King, Vicki",NA,"Company Checking Account",NA,3.07,-1102.88
"2272","Payroll Liabilities","Paycheck","2018-07-17","3026","King, Vicki",NA,"Company Checking Account",NA,3.07,-1105.95
"2273","Payroll Liabilities","Paycheck","2018-07-17","3026","King, Vicki",NA,"Company Checking Account",NA,16.8,-1122.75
"2274","Payroll Liabilities","Paycheck","2018-08-01",NA,"Wood, Deborah",NA,"Payroll Clearing (owner's time)",0,NA,-1122.75
"2275","Payroll Liabilities","Paycheck","2018-08-01","3029","Bolinski, Rafal",NA,"Company Checking Account",NA,115,-1237.75
"2276","Payroll Liabilities","Paycheck","2018-08-01","3029","Bolinski, Rafal",NA,"Company Checking Account",NA,27.69,-1265.44
"2277","Payroll Liabilities","Paycheck","2018-08-01","3029","Bolinski, Rafal",NA,"Company Checking Account",NA,27.69,-1293.13
"2278","Payroll Liabilities","Paycheck","2018-08-01","3029","Bolinski, Rafal",NA,"Company Checking Account",NA,6.53,-1299.66
"2279","Payroll Liabilities","Paycheck","2018-08-01","3029","Bolinski, Rafal",NA,"Company Checking Account",NA,6.53,-1306.19
"2280","Payroll Liabilities","Paycheck","2018-08-01","3029","Bolinski, Rafal",NA,"Company Checking Account",NA,35.79,-1341.98
"2281","Payroll Liabilities","Paycheck","2018-08-01","3029","Bolinski, Rafal",NA,"Company Checking Account",0,NA,-1341.98
"2282","Payroll Liabilities","Paycheck","2018-08-01","3029","Bolinski, Rafal",NA,"Company Checking Account",0,NA,-1341.98
"2283","Payroll Liabilities","Paycheck","2018-08-01","3029","Bolinski, Rafal",NA,"Company Checking Account",0,NA,-1341.98
"2284","Payroll Liabilities","Paycheck","2018-08-01","3029","Bolinski, Rafal",NA,"Company Checking Account",0,NA,-1341.98
"2285","Payroll Liabilities","Paycheck","2018-08-01","3030","Deen, Jeannette",NA,"Company Checking Account",NA,105,-1446.98
"2286","Payroll Liabilities","Paycheck","2018-08-01","3030","Deen, Jeannette",NA,"Company Checking Account",NA,21.07,-1468.05
"2287","Payroll Liabilities","Paycheck","2018-08-01","3030","Deen, Jeannette",NA,"Company Checking Account",NA,21.07,-1489.12
"2288","Payroll Liabilities","Paycheck","2018-08-01","3030","Deen, Jeannette",NA,"Company Checking Account",NA,4.97,-1494.09
"2289","Payroll Liabilities","Paycheck","2018-08-01","3030","Deen, Jeannette",NA,"Company Checking Account",NA,4.97,-1499.06
"2290","Payroll Liabilities","Paycheck","2018-08-01","3030","Deen, Jeannette",NA,"Company Checking Account",NA,27.23,-1526.29
"2291","Payroll Liabilities","Paycheck","2018-08-03","3028","King, Vicki",NA,"Company Checking Account",NA,69.29,-1595.58
"2292","Payroll Liabilities","Paycheck","2018-08-03","3028","King, Vicki",NA,"Company Checking Account",NA,13,-1608.58
"2293","Payroll Liabilities","Paycheck","2018-08-03","3028","King, Vicki",NA,"Company Checking Account",NA,13,-1621.58
"2294","Payroll Liabilities","Paycheck","2018-08-03","3028","King, Vicki",NA,"Company Checking Account",NA,3.07,-1624.65
"2295","Payroll Liabilities","Paycheck","2018-08-03","3028","King, Vicki",NA,"Company Checking Account",NA,3.07,-1627.72
"2296","Payroll Liabilities","Paycheck","2018-08-03","3028","King, Vicki",NA,"Company Checking Account",NA,16.8,-1644.52
"2297","Payroll Liabilities","Paycheck","2018-08-15","3031","Bolinski, Rafal",NA,"Company Checking Account",NA,115,-1759.52
"2298","Payroll Liabilities","Paycheck","2018-08-15","3031","Bolinski, Rafal",NA,"Company Checking Account",NA,27.69,-1787.21
"2299","Payroll Liabilities","Paycheck","2018-08-15","3031","Bolinski, Rafal",NA,"Company Checking Account",NA,27.69,-1814.9
"2300","Payroll Liabilities","Paycheck","2018-08-15","3031","Bolinski, Rafal",NA,"Company Checking Account",NA,6.53,-1821.43
"2301","Payroll Liabilities","Paycheck","2018-08-15","3031","Bolinski, Rafal",NA,"Company Checking Account",NA,6.53,-1827.96
"2302","Payroll Liabilities","Paycheck","2018-08-15","3031","Bolinski, Rafal",NA,"Company Checking Account",NA,35.79,-1863.75
"2303","Payroll Liabilities","Paycheck","2018-08-15","3031","Bolinski, Rafal",NA,"Company Checking Account",0,NA,-1863.75
"2304","Payroll Liabilities","Paycheck","2018-08-15","3031","Bolinski, Rafal",NA,"Company Checking Account",0,NA,-1863.75
"2305","Payroll Liabilities","Paycheck","2018-08-15","3031","Bolinski, Rafal",NA,"Company Checking Account",0,NA,-1863.75
"2306","Payroll Liabilities","Paycheck","2018-08-15","3031","Bolinski, Rafal",NA,"Company Checking Account",0,NA,-1863.75
"2307","Payroll Liabilities","Paycheck","2018-08-15","3032","Deen, Jeannette",NA,"Company Checking Account",NA,105,-1968.75
"2308","Payroll Liabilities","Paycheck","2018-08-15","3032","Deen, Jeannette",NA,"Company Checking Account",0,NA,-1968.75
"2309","Payroll Liabilities","Paycheck","2018-08-15","3032","Deen, Jeannette",NA,"Company Checking Account",NA,21.07,-1989.82
"2310","Payroll Liabilities","Paycheck","2018-08-15","3032","Deen, Jeannette",NA,"Company Checking Account",0,NA,-1989.82
"2311","Payroll Liabilities","Paycheck","2018-08-15","3032","Deen, Jeannette",NA,"Company Checking Account",NA,4,-1993.82
"2312","Payroll Liabilities","Paycheck","2018-08-15","3032","Deen, Jeannette",NA,"Company Checking Account",0,NA,-1993.82
"2313","Payroll Liabilities","Liability Check","2018-08-15","5353","Local Bank","55-5555555","Company Checking Account",130.38,NA,-1863.44
"2314","Payroll Liabilities","Liability Check","2018-08-15","5353","Local Bank","55-5555555","Company Checking Account",578.58,NA,-1284.86
"2315","Payroll Liabilities","Liability Check","2018-08-15","5353","Local Bank","55-5555555","Company Checking Account",50.3,NA,-1234.56
"2316","Payroll Liabilities","Liability Check","2018-08-15","5353","Local Bank","55-5555555","Company Checking Account",29.14,NA,-1205.42
"2317","Payroll Liabilities","Liability Check","2018-08-15","5353","Local Bank","55-5555555","Company Checking Account",210.83,NA,-994.59
"2318","Payroll Liabilities","Liability Check","2018-08-15","5353","Local Bank","55-5555555","Company Checking Account",123.52,NA,-871.07
"2319","Payroll Liabilities","Paycheck","2018-08-17","3030","King, Vicki",NA,"Company Checking Account",NA,69.29,-940.36
"2320","Payroll Liabilities","Paycheck","2018-08-17","3030","King, Vicki",NA,"Company Checking Account",NA,13,-953.36
"2321","Payroll Liabilities","Paycheck","2018-08-17","3030","King, Vicki",NA,"Company Checking Account",NA,13,-966.36
"2322","Payroll Liabilities","Paycheck","2018-08-17","3030","King, Vicki",NA,"Company Checking Account",NA,3.07,-969.43
"2323","Payroll Liabilities","Paycheck","2018-08-17","3030","King, Vicki",NA,"Company Checking Account",NA,3.07,-972.5
"2324","Payroll Liabilities","Paycheck","2018-08-17","3030","King, Vicki",NA,"Company Checking Account",NA,16.8,-989.3
"2325","Payroll Liabilities","Paycheck","2018-09-01","3033","Bolinski, Rafal",NA,"Company Checking Account",NA,115,-1104.3
"2326","Payroll Liabilities","Paycheck","2018-09-01","3033","Bolinski, Rafal",NA,"Company Checking Account",NA,27.69,-1131.99
"2327","Payroll Liabilities","Paycheck","2018-09-01","3033","Bolinski, Rafal",NA,"Company Checking Account",NA,27.69,-1159.68
"2328","Payroll Liabilities","Paycheck","2018-09-01","3033","Bolinski, Rafal",NA,"Company Checking Account",NA,6.53,-1166.21
"2329","Payroll Liabilities","Paycheck","2018-09-01","3033","Bolinski, Rafal",NA,"Company Checking Account",NA,6.53,-1172.74
"2330","Payroll Liabilities","Paycheck","2018-09-01","3033","Bolinski, Rafal",NA,"Company Checking Account",NA,35.79,-1208.53
"2331","Payroll Liabilities","Paycheck","2018-09-01","3033","Bolinski, Rafal",NA,"Company Checking Account",0,NA,-1208.53
"2332","Payroll Liabilities","Paycheck","2018-09-01","3033","Bolinski, Rafal",NA,"Company Checking Account",0,NA,-1208.53
"2333","Payroll Liabilities","Paycheck","2018-09-01","3033","Bolinski, Rafal",NA,"Company Checking Account",0,NA,-1208.53
"2334","Payroll Liabilities","Paycheck","2018-09-01","3033","Bolinski, Rafal",NA,"Company Checking Account",0,NA,-1208.53
"2335","Payroll Liabilities","Paycheck","2018-09-01","3034","Deen, Jeannette",NA,"Company Checking Account",NA,105,-1313.53
"2336","Payroll Liabilities","Paycheck","2018-09-01","3034","Deen, Jeannette",NA,"Company Checking Account",NA,21.07,-1334.6
"2337","Payroll Liabilities","Paycheck","2018-09-01","3034","Deen, Jeannette",NA,"Company Checking Account",NA,21.07,-1355.67
"2338","Payroll Liabilities","Paycheck","2018-09-01","3034","Deen, Jeannette",NA,"Company Checking Account",NA,4.97,-1360.64
"2339","Payroll Liabilities","Paycheck","2018-09-01","3034","Deen, Jeannette",NA,"Company Checking Account",NA,4.97,-1365.61
"2340","Payroll Liabilities","Paycheck","2018-09-01","3034","Deen, Jeannette",NA,"Company Checking Account",NA,27.23,-1392.84
"2341","Payroll Liabilities","Paycheck","2018-09-03",NA,"Wood, Deborah",NA,"Payroll Clearing (owner's time)",0,NA,-1392.84
"2342","Payroll Liabilities","Paycheck","2018-09-03","3032","King, Vicki",NA,"Company Checking Account",NA,69.29,-1462.13
"2343","Payroll Liabilities","Paycheck","2018-09-03","3032","King, Vicki",NA,"Company Checking Account",NA,13,-1475.13
"2344","Payroll Liabilities","Paycheck","2018-09-03","3032","King, Vicki",NA,"Company Checking Account",NA,13,-1488.13
"2345","Payroll Liabilities","Paycheck","2018-09-03","3032","King, Vicki",NA,"Company Checking Account",NA,3.07,-1491.2
"2346","Payroll Liabilities","Paycheck","2018-09-03","3032","King, Vicki",NA,"Company Checking Account",NA,3.07,-1494.27
"2347","Payroll Liabilities","Paycheck","2018-09-03","3032","King, Vicki",NA,"Company Checking Account",NA,16.8,-1511.07
"2348","Payroll Liabilities","Paycheck","2018-09-15","3035","Bolinski, Rafal",NA,"Company Checking Account",NA,115,-1626.07
"2349","Payroll Liabilities","Paycheck","2018-09-15","3035","Bolinski, Rafal",NA,"Company Checking Account",NA,27.69,-1653.76
"2350","Payroll Liabilities","Paycheck","2018-09-15","3035","Bolinski, Rafal",NA,"Company Checking Account",NA,27.69,-1681.45
"2351","Payroll Liabilities","Paycheck","2018-09-15","3035","Bolinski, Rafal",NA,"Company Checking Account",NA,6.53,-1687.98
"2352","Payroll Liabilities","Paycheck","2018-09-15","3035","Bolinski, Rafal",NA,"Company Checking Account",NA,6.53,-1694.51
"2353","Payroll Liabilities","Paycheck","2018-09-15","3035","Bolinski, Rafal",NA,"Company Checking Account",NA,35.79,-1730.3
"2354","Payroll Liabilities","Paycheck","2018-09-15","3035","Bolinski, Rafal",NA,"Company Checking Account",0,NA,-1730.3
"2355","Payroll Liabilities","Paycheck","2018-09-15","3035","Bolinski, Rafal",NA,"Company Checking Account",0,NA,-1730.3
"2356","Payroll Liabilities","Paycheck","2018-09-15","3035","Bolinski, Rafal",NA,"Company Checking Account",0,NA,-1730.3
"2357","Payroll Liabilities","Paycheck","2018-09-15","3035","Bolinski, Rafal",NA,"Company Checking Account",0,NA,-1730.3
"2358","Payroll Liabilities","Paycheck","2018-09-15","3036","Deen, Jeannette",NA,"Company Checking Account",NA,105,-1835.3
"2359","Payroll Liabilities","Paycheck","2018-09-15","3036","Deen, Jeannette",NA,"Company Checking Account",NA,21.07,-1856.37
"2360","Payroll Liabilities","Paycheck","2018-09-15","3036","Deen, Jeannette",NA,"Company Checking Account",NA,21.07,-1877.44
"2361","Payroll Liabilities","Paycheck","2018-09-15","3036","Deen, Jeannette",NA,"Company Checking Account",NA,4.97,-1882.41
"2362","Payroll Liabilities","Paycheck","2018-09-15","3036","Deen, Jeannette",NA,"Company Checking Account",NA,4.97,-1887.38
"2363","Payroll Liabilities","Paycheck","2018-09-15","3036","Deen, Jeannette",NA,"Company Checking Account",NA,27.33,-1914.71
"2364","Payroll Liabilities","Liability Check","2018-09-15","5355","Local Bank","55-5555555","Company Checking Account",132.41,NA,-1782.3
"2365","Payroll Liabilities","Liability Check","2018-09-15","5355","Local Bank","55-5555555","Company Checking Account",578.58,NA,-1203.72
"2366","Payroll Liabilities","Liability Check","2018-09-15","5355","Local Bank","55-5555555","Company Checking Account",24.17,NA,-1179.55
"2367","Payroll Liabilities","Liability Check","2018-09-15","5355","Local Bank","55-5555555","Company Checking Account",28.17,NA,-1151.38
"2368","Payroll Liabilities","Liability Check","2018-09-15","5355","Local Bank","55-5555555","Company Checking Account",102.45,NA,-1048.93
"2369","Payroll Liabilities","Liability Check","2018-09-15","5355","Local Bank","55-5555555","Company Checking Account",123.52,NA,-925.41
"2370","Payroll Liabilities","Paycheck","2018-09-17","3034","King, Vicki",NA,"Company Checking Account",NA,69.29,-994.7
"2371","Payroll Liabilities","Paycheck","2018-09-17","3034","King, Vicki",NA,"Company Checking Account",NA,13,-1007.7
"2372","Payroll Liabilities","Paycheck","2018-09-17","3034","King, Vicki",NA,"Company Checking Account",NA,13,-1020.7
"2373","Payroll Liabilities","Paycheck","2018-09-17","3034","King, Vicki",NA,"Company Checking Account",NA,3.07,-1023.77
"2374","Payroll Liabilities","Paycheck","2018-09-17","3034","King, Vicki",NA,"Company Checking Account",NA,3.07,-1026.84
"2375","Payroll Liabilities","Paycheck","2018-09-17","3034","King, Vicki",NA,"Company Checking Account",NA,16.8,-1043.64
"2376","Payroll Liabilities","Paycheck","2018-10-01",NA,"Wood, Deborah",NA,"Payroll Clearing (owner's time)",0,NA,-1043.64
"2377","Payroll Liabilities","Paycheck","2018-10-01","3037","Bolinski, Rafal",NA,"Company Checking Account",NA,115,-1158.64
"2378","Payroll Liabilities","Paycheck","2018-10-01","3037","Bolinski, Rafal",NA,"Company Checking Account",NA,27.69,-1186.33
"2379","Payroll Liabilities","Paycheck","2018-10-01","3037","Bolinski, Rafal",NA,"Company Checking Account",NA,27.69,-1214.02
"2380","Payroll Liabilities","Paycheck","2018-10-01","3037","Bolinski, Rafal",NA,"Company Checking Account",NA,6.53,-1220.55
"2381","Payroll Liabilities","Paycheck","2018-10-01","3037","Bolinski, Rafal",NA,"Company Checking Account",NA,6.53,-1227.08
"2382","Payroll Liabilities","Paycheck","2018-10-01","3037","Bolinski, Rafal",NA,"Company Checking Account",NA,35.79,-1262.87
"2383","Payroll Liabilities","Paycheck","2018-10-01","3037","Bolinski, Rafal",NA,"Company Checking Account",0,NA,-1262.87
"2384","Payroll Liabilities","Paycheck","2018-10-01","3037","Bolinski, Rafal",NA,"Company Checking Account",0,NA,-1262.87
"2385","Payroll Liabilities","Paycheck","2018-10-01","3037","Bolinski, Rafal",NA,"Company Checking Account",0,NA,-1262.87
"2386","Payroll Liabilities","Paycheck","2018-10-01","3037","Bolinski, Rafal",NA,"Company Checking Account",0,NA,-1262.87
"2387","Payroll Liabilities","Paycheck","2018-10-01","3038","Deen, Jeannette",NA,"Company Checking Account",NA,105,-1367.87
"2388","Payroll Liabilities","Paycheck","2018-10-01","3038","Deen, Jeannette",NA,"Company Checking Account",NA,21.07,-1388.94
"2389","Payroll Liabilities","Paycheck","2018-10-01","3038","Deen, Jeannette",NA,"Company Checking Account",NA,21.07,-1410.01
"2390","Payroll Liabilities","Paycheck","2018-10-01","3038","Deen, Jeannette",NA,"Company Checking Account",NA,4.97,-1414.98
"2391","Payroll Liabilities","Paycheck","2018-10-01","3038","Deen, Jeannette",NA,"Company Checking Account",NA,4.97,-1419.95
"2392","Payroll Liabilities","Paycheck","2018-10-01","3038","Deen, Jeannette",NA,"Company Checking Account",NA,27.23,-1447.18
"2393","Payroll Liabilities","Paycheck","2018-10-03","3036","King, Vicki",NA,"Company Checking Account",NA,69.29,-1516.47
"2394","Payroll Liabilities","Paycheck","2018-10-03","3036","King, Vicki",NA,"Company Checking Account",NA,13,-1529.47
"2395","Payroll Liabilities","Paycheck","2018-10-03","3036","King, Vicki",NA,"Company Checking Account",NA,13,-1542.47
"2396","Payroll Liabilities","Paycheck","2018-10-03","3036","King, Vicki",NA,"Company Checking Account",NA,3.07,-1545.54
"2397","Payroll Liabilities","Paycheck","2018-10-03","3036","King, Vicki",NA,"Company Checking Account",NA,3.07,-1548.61
"2398","Payroll Liabilities","Paycheck","2018-10-03","3036","King, Vicki",NA,"Company Checking Account",NA,16.8,-1565.41
"2399","Payroll Liabilities","Paycheck","2018-10-15","3039","Bolinski, Rafal",NA,"Company Checking Account",NA,115,-1680.41
"2400","Payroll Liabilities","Paycheck","2018-10-15","3039","Bolinski, Rafal",NA,"Company Checking Account",NA,27.69,-1708.1
"2401","Payroll Liabilities","Paycheck","2018-10-15","3039","Bolinski, Rafal",NA,"Company Checking Account",NA,27.69,-1735.79
"2402","Payroll Liabilities","Paycheck","2018-10-15","3039","Bolinski, Rafal",NA,"Company Checking Account",NA,6.53,-1742.32
"2403","Payroll Liabilities","Paycheck","2018-10-15","3039","Bolinski, Rafal",NA,"Company Checking Account",NA,6.53,-1748.85
"2404","Payroll Liabilities","Paycheck","2018-10-15","3039","Bolinski, Rafal",NA,"Company Checking Account",NA,35.79,-1784.64
"2405","Payroll Liabilities","Paycheck","2018-10-15","3039","Bolinski, Rafal",NA,"Company Checking Account",0,NA,-1784.64
"2406","Payroll Liabilities","Paycheck","2018-10-15","3039","Bolinski, Rafal",NA,"Company Checking Account",0,NA,-1784.64
"2407","Payroll Liabilities","Paycheck","2018-10-15","3039","Bolinski, Rafal",NA,"Company Checking Account",0,NA,-1784.64
"2408","Payroll Liabilities","Paycheck","2018-10-15","3039","Bolinski, Rafal",NA,"Company Checking Account",0,NA,-1784.64
"2409","Payroll Liabilities","Paycheck","2018-10-15","3040","Deen, Jeannette",NA,"Company Checking Account",NA,105,-1889.64
"2410","Payroll Liabilities","Paycheck","2018-10-15","3040","Deen, Jeannette",NA,"Company Checking Account",NA,21.07,-1910.71
"2411","Payroll Liabilities","Paycheck","2018-10-15","3040","Deen, Jeannette",NA,"Company Checking Account",NA,21.07,-1931.78
"2412","Payroll Liabilities","Paycheck","2018-10-15","3040","Deen, Jeannette",NA,"Company Checking Account",NA,4.97,-1936.75
"2413","Payroll Liabilities","Paycheck","2018-10-15","3040","Deen, Jeannette",NA,"Company Checking Account",NA,4.97,-1941.72
"2414","Payroll Liabilities","Paycheck","2018-10-15","3040","Deen, Jeannette",NA,"Company Checking Account",NA,27.23,-1968.95
"2415","Payroll Liabilities","Liability Check","2018-10-15","5354","Local Bank","55-5555555","Company Checking Account",159.74,NA,-1809.21
"2416","Payroll Liabilities","Liability Check","2018-10-15","5354","Local Bank","55-5555555","Company Checking Account",578.58,NA,-1230.63
"2417","Payroll Liabilities","Liability Check","2018-10-15","5354","Local Bank","55-5555555","Company Checking Account",29.14,NA,-1201.49
"2418","Payroll Liabilities","Liability Check","2018-10-15","5354","Local Bank","55-5555555","Company Checking Account",29.14,NA,-1172.35
"2419","Payroll Liabilities","Liability Check","2018-10-15","5354","Local Bank","55-5555555","Company Checking Account",123.52,NA,-1048.83
"2420","Payroll Liabilities","Liability Check","2018-10-15","5354","Local Bank","55-5555555","Company Checking Account",123.52,NA,-925.31
"2421","Payroll Liabilities","Paycheck","2018-10-17","3038","King, Vicki",NA,"Company Checking Account",NA,69.29,-994.6
"2422","Payroll Liabilities","Paycheck","2018-10-17","3038","King, Vicki",NA,"Company Checking Account",NA,13,-1007.6
"2423","Payroll Liabilities","Paycheck","2018-10-17","3038","King, Vicki",NA,"Company Checking Account",NA,13,-1020.6
"2424","Payroll Liabilities","Paycheck","2018-10-17","3038","King, Vicki",NA,"Company Checking Account",NA,3.07,-1023.67
"2425","Payroll Liabilities","Paycheck","2018-10-17","3038","King, Vicki",NA,"Company Checking Account",NA,3.07,-1026.74
"2426","Payroll Liabilities","Paycheck","2018-10-17","3038","King, Vicki",NA,"Company Checking Account",NA,16.8,-1043.54
"2427","Payroll Liabilities","Paycheck","2018-11-01",NA,"Wood, Deborah",NA,"Payroll Clearing (owner's time)",0,NA,-1043.54
"2428","Payroll Liabilities","Paycheck","2018-11-01","3041","Bolinski, Rafal",NA,"Company Checking Account",NA,115,-1158.54
"2429","Payroll Liabilities","Paycheck","2018-11-01","3041","Bolinski, Rafal",NA,"Company Checking Account",NA,27.69,-1186.23
"2430","Payroll Liabilities","Paycheck","2018-11-01","3041","Bolinski, Rafal",NA,"Company Checking Account",NA,27.69,-1213.92
"2431","Payroll Liabilities","Paycheck","2018-11-01","3041","Bolinski, Rafal",NA,"Company Checking Account",NA,6.53,-1220.45
"2432","Payroll Liabilities","Paycheck","2018-11-01","3041","Bolinski, Rafal",NA,"Company Checking Account",NA,6.53,-1226.98
"2433","Payroll Liabilities","Paycheck","2018-11-01","3041","Bolinski, Rafal",NA,"Company Checking Account",NA,35.79,-1262.77
"2434","Payroll Liabilities","Paycheck","2018-11-01","3041","Bolinski, Rafal",NA,"Company Checking Account",0,NA,-1262.77
"2435","Payroll Liabilities","Paycheck","2018-11-01","3041","Bolinski, Rafal",NA,"Company Checking Account",0,NA,-1262.77
"2436","Payroll Liabilities","Paycheck","2018-11-01","3041","Bolinski, Rafal",NA,"Company Checking Account",0,NA,-1262.77
"2437","Payroll Liabilities","Paycheck","2018-11-01","3041","Bolinski, Rafal",NA,"Company Checking Account",0,NA,-1262.77
"2438","Payroll Liabilities","Paycheck","2018-11-01","3042","Deen, Jeannette",NA,"Company Checking Account",NA,105,-1367.77
"2439","Payroll Liabilities","Paycheck","2018-11-01","3042","Deen, Jeannette",NA,"Company Checking Account",NA,21.07,-1388.84
"2440","Payroll Liabilities","Paycheck","2018-11-01","3042","Deen, Jeannette",NA,"Company Checking Account",NA,21.07,-1409.91
"2441","Payroll Liabilities","Paycheck","2018-11-01","3042","Deen, Jeannette",NA,"Company Checking Account",NA,4.97,-1414.88
"2442","Payroll Liabilities","Paycheck","2018-11-01","3042","Deen, Jeannette",NA,"Company Checking Account",NA,4.97,-1419.85
"2443","Payroll Liabilities","Paycheck","2018-11-01","3042","Deen, Jeannette",NA,"Company Checking Account",NA,27.23,-1447.08
"2444","Payroll Liabilities","Paycheck","2018-11-02","3040","King, Vicki",NA,"Company Checking Account",NA,69.29,-1516.37
"2445","Payroll Liabilities","Paycheck","2018-11-02","3040","King, Vicki",NA,"Company Checking Account",NA,13,-1529.37
"2446","Payroll Liabilities","Paycheck","2018-11-02","3040","King, Vicki",NA,"Company Checking Account",NA,13,-1542.37
"2447","Payroll Liabilities","Paycheck","2018-11-02","3040","King, Vicki",NA,"Company Checking Account",NA,3.07,-1545.44
"2448","Payroll Liabilities","Paycheck","2018-11-02","3040","King, Vicki",NA,"Company Checking Account",NA,3.07,-1548.51
"2449","Payroll Liabilities","Paycheck","2018-11-02","3040","King, Vicki",NA,"Company Checking Account",NA,16.8,-1565.31
"2450","Payroll Liabilities","Paycheck","2018-11-15","3043","Bolinski, Rafal",NA,"Company Checking Account",NA,115,-1680.31
"2451","Payroll Liabilities","Paycheck","2018-11-15","3043","Bolinski, Rafal",NA,"Company Checking Account",NA,27.69,-1708
"2452","Payroll Liabilities","Paycheck","2018-11-15","3043","Bolinski, Rafal",NA,"Company Checking Account",NA,27.69,-1735.69
"2453","Payroll Liabilities","Paycheck","2018-11-15","3043","Bolinski, Rafal",NA,"Company Checking Account",NA,6.53,-1742.22
"2454","Payroll Liabilities","Paycheck","2018-11-15","3043","Bolinski, Rafal",NA,"Company Checking Account",NA,6.53,-1748.75
"2455","Payroll Liabilities","Paycheck","2018-11-15","3043","Bolinski, Rafal",NA,"Company Checking Account",NA,35.79,-1784.54
"2456","Payroll Liabilities","Paycheck","2018-11-15","3043","Bolinski, Rafal",NA,"Company Checking Account",0,NA,-1784.54
"2457","Payroll Liabilities","Paycheck","2018-11-15","3043","Bolinski, Rafal",NA,"Company Checking Account",0,NA,-1784.54
"2458","Payroll Liabilities","Paycheck","2018-11-15","3043","Bolinski, Rafal",NA,"Company Checking Account",0,NA,-1784.54
"2459","Payroll Liabilities","Paycheck","2018-11-15","3043","Bolinski, Rafal",NA,"Company Checking Account",0,NA,-1784.54
"2460","Payroll Liabilities","Paycheck","2018-11-15","3044","Deen, Jeannette",NA,"Company Checking Account",NA,105,-1889.54
"2461","Payroll Liabilities","Paycheck","2018-11-15","3044","Deen, Jeannette",NA,"Company Checking Account",NA,21.07,-1910.61
"2462","Payroll Liabilities","Paycheck","2018-11-15","3044","Deen, Jeannette",NA,"Company Checking Account",NA,21.07,-1931.68
"2463","Payroll Liabilities","Paycheck","2018-11-15","3044","Deen, Jeannette",NA,"Company Checking Account",NA,4.97,-1936.65
"2464","Payroll Liabilities","Paycheck","2018-11-15","3044","Deen, Jeannette",NA,"Company Checking Account",NA,4.97,-1941.62
"2465","Payroll Liabilities","Paycheck","2018-11-15","3044","Deen, Jeannette",NA,"Company Checking Account",NA,27.23,-1968.85
"2466","Payroll Liabilities","Liability Check","2018-11-15","5356","Local Bank","55-5555555","Company Checking Account",159.64,NA,-1809.21
"2467","Payroll Liabilities","Liability Check","2018-11-15","5356","Local Bank","55-5555555","Company Checking Account",578.58,NA,-1230.63
"2468","Payroll Liabilities","Liability Check","2018-11-15","5356","Local Bank","55-5555555","Company Checking Account",29.14,NA,-1201.49
"2469","Payroll Liabilities","Liability Check","2018-11-15","5356","Local Bank","55-5555555","Company Checking Account",29.14,NA,-1172.35
"2470","Payroll Liabilities","Liability Check","2018-11-15","5356","Local Bank","55-5555555","Company Checking Account",123.52,NA,-1048.83
"2471","Payroll Liabilities","Liability Check","2018-11-15","5356","Local Bank","55-5555555","Company Checking Account",123.52,NA,-925.31
"2472","Payroll Liabilities","Paycheck","2018-11-16","3042","King, Vicki",NA,"Company Checking Account",NA,69.29,-994.6
"2473","Payroll Liabilities","Paycheck","2018-11-16","3042","King, Vicki",NA,"Company Checking Account",NA,13,-1007.6
"2474","Payroll Liabilities","Paycheck","2018-11-16","3042","King, Vicki",NA,"Company Checking Account",NA,13,-1020.6
"2475","Payroll Liabilities","Paycheck","2018-11-16","3042","King, Vicki",NA,"Company Checking Account",NA,3.07,-1023.67
"2476","Payroll Liabilities","Paycheck","2018-11-16","3042","King, Vicki",NA,"Company Checking Account",NA,3.07,-1026.74
"2477","Payroll Liabilities","Paycheck","2018-11-16","3042","King, Vicki",NA,"Company Checking Account",NA,16.8,-1043.54
"2478","Payroll Liabilities","Paycheck","2018-12-01","3045","Bolinski, Rafal",NA,"Company Checking Account",NA,115,-1158.54
"2479","Payroll Liabilities","Paycheck","2018-12-01","3045","Bolinski, Rafal",NA,"Company Checking Account",NA,27.69,-1186.23
"2480","Payroll Liabilities","Paycheck","2018-12-01","3045","Bolinski, Rafal",NA,"Company Checking Account",NA,27.69,-1213.92
"2481","Payroll Liabilities","Paycheck","2018-12-01","3045","Bolinski, Rafal",NA,"Company Checking Account",NA,6.53,-1220.45
"2482","Payroll Liabilities","Paycheck","2018-12-01","3045","Bolinski, Rafal",NA,"Company Checking Account",NA,6.53,-1226.98
"2483","Payroll Liabilities","Paycheck","2018-12-01","3045","Bolinski, Rafal",NA,"Company Checking Account",NA,35.79,-1262.77
"2484","Payroll Liabilities","Paycheck","2018-12-01","3045","Bolinski, Rafal",NA,"Company Checking Account",0,NA,-1262.77
"2485","Payroll Liabilities","Paycheck","2018-12-01","3045","Bolinski, Rafal",NA,"Company Checking Account",0,NA,-1262.77
"2486","Payroll Liabilities","Paycheck","2018-12-01","3045","Bolinski, Rafal",NA,"Company Checking Account",0,NA,-1262.77
"2487","Payroll Liabilities","Paycheck","2018-12-01","3045","Bolinski, Rafal",NA,"Company Checking Account",0,NA,-1262.77
"2488","Payroll Liabilities","Paycheck","2018-12-01","3046","Deen, Jeannette",NA,"Company Checking Account",NA,105,-1367.77
"2489","Payroll Liabilities","Paycheck","2018-12-01","3046","Deen, Jeannette",NA,"Company Checking Account",NA,21.07,-1388.84
"2490","Payroll Liabilities","Paycheck","2018-12-01","3046","Deen, Jeannette",NA,"Company Checking Account",NA,21.07,-1409.91
"2491","Payroll Liabilities","Paycheck","2018-12-01","3046","Deen, Jeannette",NA,"Company Checking Account",NA,4.97,-1414.88
"2492","Payroll Liabilities","Paycheck","2018-12-01","3046","Deen, Jeannette",NA,"Company Checking Account",NA,4.97,-1419.85
"2493","Payroll Liabilities","Paycheck","2018-12-01","3046","Deen, Jeannette",NA,"Company Checking Account",NA,27.23,-1447.08
"2494","Payroll Liabilities","Paycheck","2018-12-03",NA,"Wood, Deborah",NA,"Payroll Clearing (owner's time)",0,NA,-1447.08
"2495","Payroll Liabilities","Paycheck","2018-12-03","3044","King, Vicki",NA,"Company Checking Account",NA,69.29,-1516.37
"2496","Payroll Liabilities","Paycheck","2018-12-03","3044","King, Vicki",NA,"Company Checking Account",NA,13,-1529.37
"2497","Payroll Liabilities","Paycheck","2018-12-03","3044","King, Vicki",NA,"Company Checking Account",NA,13,-1542.37
"2498","Payroll Liabilities","Paycheck","2018-12-03","3044","King, Vicki",NA,"Company Checking Account",NA,3.07,-1545.44
"2499","Payroll Liabilities","Paycheck","2018-12-03","3044","King, Vicki",NA,"Company Checking Account",NA,3.07,-1548.51
"2500","Payroll Liabilities","Paycheck","2018-12-03","3044","King, Vicki",NA,"Company Checking Account",NA,16.8,-1565.31
"2501","Payroll Liabilities","Paycheck","2018-12-15","3047","Bolinski, Rafal",NA,"Company Checking Account",NA,115,-1680.31
"2502","Payroll Liabilities","Paycheck","2018-12-15","3047","Bolinski, Rafal",NA,"Company Checking Account",NA,27.69,-1708
"2503","Payroll Liabilities","Paycheck","2018-12-15","3047","Bolinski, Rafal",NA,"Company Checking Account",NA,27.69,-1735.69
"2504","Payroll Liabilities","Paycheck","2018-12-15","3047","Bolinski, Rafal",NA,"Company Checking Account",NA,6.53,-1742.22
"2505","Payroll Liabilities","Paycheck","2018-12-15","3047","Bolinski, Rafal",NA,"Company Checking Account",NA,6.53,-1748.75
"2506","Payroll Liabilities","Paycheck","2018-12-15","3047","Bolinski, Rafal",NA,"Company Checking Account",NA,35.79,-1784.54
"2507","Payroll Liabilities","Paycheck","2018-12-15","3047","Bolinski, Rafal",NA,"Company Checking Account",0,NA,-1784.54
"2508","Payroll Liabilities","Paycheck","2018-12-15","3047","Bolinski, Rafal",NA,"Company Checking Account",0,NA,-1784.54
"2509","Payroll Liabilities","Paycheck","2018-12-15","3047","Bolinski, Rafal",NA,"Company Checking Account",0,NA,-1784.54
"2510","Payroll Liabilities","Paycheck","2018-12-15","3047","Bolinski, Rafal",NA,"Company Checking Account",0,NA,-1784.54
"2511","Payroll Liabilities","Paycheck","2018-12-15","3048","Deen, Jeannette",NA,"Company Checking Account",NA,105,-1889.54
"2512","Payroll Liabilities","Paycheck","2018-12-15","3048","Deen, Jeannette",NA,"Company Checking Account",NA,21.07,-1910.61
"2513","Payroll Liabilities","Paycheck","2018-12-15","3048","Deen, Jeannette",NA,"Company Checking Account",NA,21.07,-1931.68
"2514","Payroll Liabilities","Paycheck","2018-12-15","3048","Deen, Jeannette",NA,"Company Checking Account",NA,4.97,-1936.65
"2515","Payroll Liabilities","Paycheck","2018-12-15","3048","Deen, Jeannette",NA,"Company Checking Account",NA,4.97,-1941.62
"2516","Payroll Liabilities","Paycheck","2018-12-15","3048","Deen, Jeannette",NA,"Company Checking Account",NA,27.23,-1968.85
"2517","Payroll Liabilities","Liability Check","2018-12-15","5357","Local Bank","55-5555555","Company Checking Account",79.82,NA,-1889.03
"2518","Payroll Liabilities","Liability Check","2018-12-15","5357","Local Bank","55-5555555","Company Checking Account",289.29,NA,-1599.74
"2519","Payroll Liabilities","Liability Check","2018-12-15","5357","Local Bank","55-5555555","Company Checking Account",14.57,NA,-1585.17
"2520","Payroll Liabilities","Liability Check","2018-12-15","5357","Local Bank","55-5555555","Company Checking Account",14.57,NA,-1570.6
"2521","Payroll Liabilities","Liability Check","2018-12-15","5357","Local Bank","55-5555555","Company Checking Account",61.76,NA,-1508.84
"2522","Payroll Liabilities","Liability Check","2018-12-15","5357","Local Bank","55-5555555","Company Checking Account",61.76,NA,-1447.08
"2523","Payroll Liabilities","Liability Check","2018-12-15",NA,"Local Bank","55-5555555","Company Checking Account",289.29,NA,-1157.79
"2524","Payroll Liabilities","Liability Check","2018-12-15",NA,"Local Bank","55-5555555","Company Checking Account",61.76,NA,-1096.03
"2525","Payroll Liabilities","Liability Check","2018-12-15",NA,"Local Bank","55-5555555","Company Checking Account",61.76,NA,-1034.27
"2526","Payroll Liabilities","Liability Check","2018-12-15",NA,"Local Bank","55-5555555","Company Checking Account",14.57,NA,-1019.7
"2527","Payroll Liabilities","Liability Check","2018-12-15",NA,"Local Bank","55-5555555","Company Checking Account",14.57,NA,-1005.13
"2528","Payroll Liabilities","Paycheck","2018-12-15","5361","Graham, Jonathan",NA,"Company Checking Account",NA,2.5,-1007.63
"2529","Payroll Liabilities","Paycheck","2018-12-15","5361","Graham, Jonathan",NA,"Company Checking Account",NA,266,-1273.63
"2530","Payroll Liabilities","Paycheck","2018-12-15","5361","Graham, Jonathan",NA,"Company Checking Account",NA,155,-1428.63
"2531","Payroll Liabilities","Paycheck","2018-12-15","5361","Graham, Jonathan",NA,"Company Checking Account",NA,155,-1583.63
"2532","Payroll Liabilities","Paycheck","2018-12-15","5361","Graham, Jonathan",NA,"Company Checking Account",NA,36.25,-1619.88
"2533","Payroll Liabilities","Paycheck","2018-12-15","5361","Graham, Jonathan",NA,"Company Checking Account",NA,36.25,-1656.13
"2534","Payroll Liabilities","Paycheck","2018-12-15","5361","Graham, Jonathan",NA,"Company Checking Account",NA,20,-1676.13
"2535","Payroll Liabilities","Paycheck","2018-12-15","5361","Graham, Jonathan",NA,"Company Checking Account",NA,126.98,-1803.11
"2536","Payroll Liabilities","Paycheck","2018-12-15","5361","Graham, Jonathan",NA,"Company Checking Account",NA,20,-1823.11
"2537","Payroll Liabilities","Paycheck","2018-12-15","5361","Graham, Jonathan",NA,"Company Checking Account",NA,87.5,-1910.61
"2538","Payroll Liabilities","Paycheck","2018-12-15","5362","King, Vicki",NA,"Company Checking Account",NA,0.48,-1911.09
"2539","Payroll Liabilities","Paycheck","2018-12-15","5362","King, Vicki",NA,"Company Checking Account",NA,27,-1938.09
"2540","Payroll Liabilities","Paycheck","2018-12-15","5362","King, Vicki",NA,"Company Checking Account",NA,40.14,-1978.23
"2541","Payroll Liabilities","Paycheck","2018-12-15","5362","King, Vicki",NA,"Company Checking Account",NA,40.14,-2018.37
"2542","Payroll Liabilities","Paycheck","2018-12-15","5362","King, Vicki",NA,"Company Checking Account",NA,8.85,-2027.22
"2543","Payroll Liabilities","Paycheck","2018-12-15","5362","King, Vicki",NA,"Company Checking Account",NA,8.85,-2036.07
"2544","Payroll Liabilities","Paycheck","2018-12-15","5362","King, Vicki",NA,"Company Checking Account",0,NA,-2036.07
"2545","Payroll Liabilities","Paycheck","2018-12-15","5362","King, Vicki",NA,"Company Checking Account",0,NA,-2036.07
"2546","Payroll Liabilities","Paycheck","2018-12-15","5362","King, Vicki",NA,"Company Checking Account",NA,3.84,-2039.91
"2547","Payroll Liabilities","Paycheck","2018-12-15","5362","King, Vicki",NA,"Company Checking Account",NA,16.8,-2056.71
"2548","Payroll Liabilities","Paycheck","2018-12-15","5363","Wood, Deborah",NA,"Company Checking Account",0,NA,-2056.71
"2549","Payroll Liabilities","Paycheck","2018-12-15","5364","Bolinski, Rafal",NA,"Company Checking Account",0,NA,-2056.71
"2550","Payroll Liabilities","Paycheck","2018-12-15","5364","Bolinski, Rafal",NA,"Company Checking Account",NA,5,-2061.71
"2551","Payroll Liabilities","Paycheck","2018-12-15","5364","Bolinski, Rafal",NA,"Company Checking Account",0,NA,-2061.71
"2552","Payroll Liabilities","Paycheck","2018-12-15","5364","Bolinski, Rafal",NA,"Company Checking Account",NA,73.83,-2135.54
"2553","Payroll Liabilities","Paycheck","2018-12-15","5364","Bolinski, Rafal",NA,"Company Checking Account",0,NA,-2135.54
"2554","Payroll Liabilities","Paycheck","2018-12-15","5364","Bolinski, Rafal",NA,"Company Checking Account",NA,14.78,-2150.32
"2555","Payroll Liabilities","Paycheck","2018-12-15","5364","Bolinski, Rafal",NA,"Company Checking Account",0,NA,-2150.32
"2556","Payroll Liabilities","Paycheck","2018-12-15","5364","Bolinski, Rafal",NA,"Company Checking Account",NA,5.16,-2155.48
"2557","Payroll Liabilities","Paycheck","2018-12-15","5364","Bolinski, Rafal",NA,"Company Checking Account",0,NA,-2155.48
"2558","Payroll Liabilities","Paycheck","2018-12-15","5364","Bolinski, Rafal",NA,"Company Checking Account",NA,490,-2645.48
"2559","Payroll Liabilities","Paycheck","2018-12-15","5365","Deen, Jeannette",NA,"Company Checking Account",NA,36,-2681.48
"2560","Payroll Liabilities","Paycheck","2018-12-15","5365","Deen, Jeannette",NA,"Company Checking Account",0,NA,-2681.48
"2561","Payroll Liabilities","Paycheck","2018-12-15","5365","Deen, Jeannette",NA,"Company Checking Account",NA,59.98,-2741.46
"2562","Payroll Liabilities","Paycheck","2018-12-15","5365","Deen, Jeannette",NA,"Company Checking Account",0,NA,-2741.46
"2563","Payroll Liabilities","Paycheck","2018-12-15","5365","Deen, Jeannette",NA,"Company Checking Account",NA,14.03,-2755.49
"2564","Payroll Liabilities","Paycheck","2018-12-15","5365","Deen, Jeannette",NA,"Company Checking Account",0,NA,-2755.49
"2565","Payroll Liabilities","Paycheck","2018-12-17","3046","King, Vicki",NA,"Company Checking Account",NA,69.29,-2824.78
"2566","Payroll Liabilities","Paycheck","2018-12-17","3046","King, Vicki",NA,"Company Checking Account",NA,13,-2837.78
"2567","Payroll Liabilities","Paycheck","2018-12-17","3046","King, Vicki",NA,"Company Checking Account",NA,13,-2850.78
"2568","Payroll Liabilities","Paycheck","2018-12-17","3046","King, Vicki",NA,"Company Checking Account",NA,3.07,-2853.85
"2569","Payroll Liabilities","Paycheck","2018-12-17","3046","King, Vicki",NA,"Company Checking Account",NA,3.07,-2856.92
"2570","Payroll Liabilities","Paycheck","2018-12-17","3046","King, Vicki",NA,"Company Checking Account",NA,16.8,-2873.72
"2573","Payroll Liabilities","Paycheck","2018-01-15","3001","King, Vicki",NA,"Company Checking Account",NA,50,-50
"2574","Payroll Liabilities","Paycheck","2018-02-01","3004","King, Vicki",NA,"Company Checking Account",NA,100,-150
"2575","Payroll Liabilities","Liability Check","2018-02-15","5036","Sec125 Administrator","Acct#  870547","Company Checking Account",50,NA,-100
"2576","Payroll Liabilities","Paycheck","2018-03-01","3008","King, Vicki",NA,"Company Checking Account",NA,100,-200
"2577","Payroll Liabilities","Liability Check","2018-03-15","5065","Sec125 Administrator","Acct#  870547","Company Checking Account",100,NA,-100
"2578","Payroll Liabilities","Paycheck","2018-04-02","3012","King, Vicki",NA,"Company Checking Account",NA,100,-200
"2579","Payroll Liabilities","Liability Check","2018-04-16","5086","Sec125 Administrator","Acct#  870547","Company Checking Account",100,NA,-100
"2580","Payroll Liabilities","Paycheck","2018-05-01","3016","King, Vicki",NA,"Company Checking Account",NA,100,-200
"2581","Payroll Liabilities","Liability Check","2018-05-15","5114","Sec125 Administrator","Acct#  870547","Company Checking Account",100,NA,-100
"2582","Payroll Liabilities","Paycheck","2018-05-15","3018","King, Vicki",NA,"Company Checking Account",NA,100,-200
"2583","Payroll Liabilities","Liability Check","2018-06-15","5143","Sec125 Administrator","Acct#  870547","Company Checking Account",100,NA,-100
"2584","Payroll Liabilities","Paycheck","2018-06-15","3022","King, Vicki",NA,"Company Checking Account",NA,100,-200
"2585","Payroll Liabilities","Paycheck","2018-07-02","3024","King, Vicki",NA,"Company Checking Account",NA,100,-300
"2586","Payroll Liabilities","Liability Check","2018-07-16","5167","Sec125 Administrator","Acct#  870547","Company Checking Account",100,NA,-200
"2587","Payroll Liabilities","Paycheck","2018-07-17","3026","King, Vicki",NA,"Company Checking Account",NA,100,-300
"2588","Payroll Liabilities","Paycheck","2018-08-03","3028","King, Vicki",NA,"Company Checking Account",NA,100,-400
"2589","Payroll Liabilities","Liability Check","2018-08-15","5199","Sec125 Administrator","Acct#  870547","Company Checking Account",100,NA,-300
"2590","Payroll Liabilities","Paycheck","2018-09-03","3032","King, Vicki",NA,"Company Checking Account",NA,100,-400
"2591","Payroll Liabilities","Liability Check","2018-09-17","5228","Sec125 Administrator","Acct#  870547","Company Checking Account",100,NA,-300
"2592","Payroll Liabilities","Paycheck","2018-09-17","3034","King, Vicki",NA,"Company Checking Account",NA,100,-400
"2593","Payroll Liabilities","Liability Check","2018-10-15","5251","Sec125 Administrator","Acct#  870547","Company Checking Account",100,NA,-300
"2594","Payroll Liabilities","Liability Check","2018-11-15","5277","Sec125 Administrator","Acct#  870547","Company Checking Account",100,NA,-200
"2595","Payroll Liabilities","Liability Check","2018-12-15",NA,"Sec125 Administrator","Acct#  870547","Company Checking Account",100,NA,-100
"2596","Payroll Liabilities","Paycheck","2018-12-15","5361","Graham, Jonathan",NA,"Company Checking Account",NA,50,-150
"2597","Payroll Liabilities","Paycheck","2018-12-15","5362","King, Vicki",NA,"Company Checking Account",NA,100,-250
"2598","Payroll Liabilities","Liability Check","2018-12-15",NA,"Sec125 Administrator","Acct#  870547","Company Checking Account",150,NA,-100
"2599","Payroll Liabilities","Paycheck","2018-12-15","5364","Bolinski, Rafal",NA,"Company Checking Account",NA,50,-150
"2600","Payroll Liabilities","Liability Check","2018-12-15",NA,"Sec125 Administrator","Acct#  870547","Company Checking Account",50,NA,-100
"2601","Payroll Liabilities","Paycheck","2018-12-15","5365","Deen, Jeannette",NA,"Company Checking Account",NA,50,-150
"2602","Payroll Liabilities","Liability Check","2018-12-17","5303","Sec125 Administrator","Acct#  870547","Company Checking Account",100,NA,-50
"2611","Deborah Wood Equity","Paycheck","2018-02-01",NA,"Wood, Deborah",NA,"Payroll Clearing (owner's time)",200,NA,200
"2612","Deborah Wood Equity","Paycheck","2018-02-01",NA,"Wood, Deborah",NA,"Payroll Clearing (owner's time)",100,NA,300
"2613","Deborah Wood Equity","Paycheck","2018-02-01",NA,"Wood, Deborah",NA,"Payroll Clearing (owner's time)",0,NA,300
"2614","Deborah Wood Equity","Paycheck","2018-02-01",NA,"Wood, Deborah",NA,"Payroll Clearing (owner's time)",700,NA,1000
"2615","Deborah Wood Equity","Paycheck","2018-02-01",NA,"Wood, Deborah",NA,"Payroll Clearing (owner's time)",1700,NA,2700
"2616","Deborah Wood Equity","Paycheck","2018-02-01",NA,"Wood, Deborah",NA,"Payroll Clearing (owner's time)",0,NA,2700
"2617","Deborah Wood Equity","Paycheck","2018-02-01",NA,"Wood, Deborah",NA,"Payroll Clearing (owner's time)",0,NA,2700
"2618","Deborah Wood Equity","Paycheck","2018-02-01",NA,"Wood, Deborah",NA,"Payroll Clearing (owner's time)",1000,NA,3700
"2619","Deborah Wood Equity","Paycheck","2018-02-01",NA,"Wood, Deborah",NA,"Payroll Clearing (owner's time)",600,NA,4300
"2620","Deborah Wood Equity","Paycheck","2018-02-01",NA,"Wood, Deborah",NA,"Payroll Clearing (owner's time)",0,NA,4300
"2621","Deborah Wood Equity","Paycheck","2018-02-01",NA,"Wood, Deborah",NA,"Payroll Clearing (owner's time)",0,NA,4300
"2622","Deborah Wood Equity","Paycheck","2018-02-01",NA,"Wood, Deborah",NA,"Payroll Clearing (owner's time)",0,NA,4300
"2623","Deborah Wood Equity","Paycheck","2018-02-01",NA,"Wood, Deborah",NA,"Payroll Clearing (owner's time)",0,NA,4300
"2624","Deborah Wood Equity","Paycheck","2018-02-01",NA,"Wood, Deborah",NA,"Payroll Clearing (owner's time)",0,NA,4300
"2625","Deborah Wood Equity","Paycheck","2018-02-01",NA,"Wood, Deborah",NA,"Payroll Clearing (owner's time)",400,NA,4700
"2626","Deborah Wood Equity","Paycheck","2018-02-01",NA,"Wood, Deborah",NA,"Payroll Clearing (owner's time)",350,NA,5050
"2627","Deborah Wood Equity","Paycheck","2018-02-01",NA,"Wood, Deborah",NA,"Payroll Clearing (owner's time)",0,NA,5050
"2628","Deborah Wood Equity","Paycheck","2018-02-01",NA,"Wood, Deborah",NA,"Payroll Clearing (owner's time)",0,NA,5050
"2629","Deborah Wood Equity","Paycheck","2018-02-01",NA,"Wood, Deborah",NA,"Payroll Clearing (owner's time)",0,NA,5050
"2630","Deborah Wood Equity","Paycheck","2018-02-01",NA,"Wood, Deborah",NA,"Payroll Clearing (owner's time)",0,NA,5050
"2631","Deborah Wood Equity","Paycheck","2018-02-01",NA,"Wood, Deborah",NA,"Payroll Clearing (owner's time)",200,NA,5250
"2632","Deborah Wood Equity","Paycheck","2018-02-01",NA,"Wood, Deborah",NA,"Payroll Clearing (owner's time)",50,NA,5300
"2634","Deborah Wood Equity","Paycheck","2018-03-01",NA,"Wood, Deborah",NA,"Payroll Clearing (owner's time)",1250,NA,1250
"2635","Deborah Wood Equity","Paycheck","2018-03-01",NA,"Wood, Deborah",NA,"Payroll Clearing (owner's time)",700,NA,1950
"2636","Deborah Wood Equity","Paycheck","2018-03-01",NA,"Wood, Deborah",NA,"Payroll Clearing (owner's time)",250,NA,2200
"2637","Deborah Wood Equity","Paycheck","2018-03-01",NA,"Wood, Deborah",NA,"Payroll Clearing (owner's time)",700,NA,2900
"2638","Deborah Wood Equity","Paycheck","2018-03-01",NA,"Wood, Deborah",NA,"Payroll Clearing (owner's time)",800,NA,3700
"2639","Deborah Wood Equity","Paycheck","2018-03-01",NA,"Wood, Deborah",NA,"Payroll Clearing (owner's time)",1250,NA,4950
"2640","Deborah Wood Equity","Paycheck","2018-03-01",NA,"Wood, Deborah",NA,"Payroll Clearing (owner's time)",200,NA,5150
"2641","Deborah Wood Equity","Paycheck","2018-03-01",NA,"Wood, Deborah",NA,"Payroll Clearing (owner's time)",200,NA,5350
"2642","Deborah Wood Equity","Paycheck","2018-03-01",NA,"Wood, Deborah",NA,"Payroll Clearing (owner's time)",500,NA,5850
"2643","Deborah Wood Equity","Paycheck","2018-03-01",NA,"Wood, Deborah",NA,"Payroll Clearing (owner's time)",200,NA,6050
"2644","Deborah Wood Equity","Paycheck","2018-03-01",NA,"Wood, Deborah",NA,"Payroll Clearing (owner's time)",450,NA,6500
"2645","Deborah Wood Equity","Paycheck","2018-03-01",NA,"Wood, Deborah",NA,"Payroll Clearing (owner's time)",200,NA,6700
"2646","Deborah Wood Equity","Paycheck","2018-03-01",NA,"Wood, Deborah",NA,"Payroll Clearing (owner's time)",250,NA,6950
"2647","Deborah Wood Equity","Paycheck","2018-03-01",NA,"Wood, Deborah",NA,"Payroll Clearing (owner's time)",350,NA,7300
"2648","Deborah Wood Equity","Paycheck","2018-03-01",NA,"Wood, Deborah",NA,"Payroll Clearing (owner's time)",300,NA,7600
"2649","Deborah Wood Equity","Paycheck","2018-03-01",NA,"Wood, Deborah",NA,"Payroll Clearing (owner's time)",1000,NA,8600
"2650","Deborah Wood Equity","Paycheck","2018-03-01",NA,"Wood, Deborah",NA,"Payroll Clearing (owner's time)",700,NA,9300
"2651","Deborah Wood Equity","Paycheck","2018-03-01",NA,"Wood, Deborah",NA,"Payroll Clearing (owner's time)",500,NA,9800
"2652","Deborah Wood Equity","Paycheck","2018-03-01",NA,"Wood, Deborah",NA,"Payroll Clearing (owner's time)",200,NA,10000
"2653","Deborah Wood Equity","Paycheck","2018-03-01",NA,"Wood, Deborah",NA,"Payroll Clearing (owner's time)",500,NA,10500
"2654","Deborah Wood Equity","Paycheck","2018-03-01",NA,"Wood, Deborah",NA,"Payroll Clearing (owner's time)",500,NA,11000
"2657","Deborah Wood Equity","Paycheck","2018-04-02",NA,"Wood, Deborah",NA,"Payroll Clearing (owner's time)",1500,NA,1500
"2658","Deborah Wood Equity","Paycheck","2018-04-02",NA,"Wood, Deborah",NA,"Payroll Clearing (owner's time)",1400,NA,2900
"2659","Deborah Wood Equity","Paycheck","2018-04-02",NA,"Wood, Deborah",NA,"Payroll Clearing (owner's time)",1000,NA,3900
"2660","Deborah Wood Equity","Paycheck","2018-04-02",NA,"Wood, Deborah",NA,"Payroll Clearing (owner's time)",1000,NA,4900
"2661","Deborah Wood Equity","Paycheck","2018-04-02",NA,"Wood, Deborah",NA,"Payroll Clearing (owner's time)",0,NA,4900
"2662","Deborah Wood Equity","Paycheck","2018-04-02",NA,"Wood, Deborah",NA,"Payroll Clearing (owner's time)",0,NA,4900
"2663","Deborah Wood Equity","Paycheck","2018-04-02",NA,"Wood, Deborah",NA,"Payroll Clearing (owner's time)",0,NA,4900
"2664","Deborah Wood Equity","Paycheck","2018-04-02",NA,"Wood, Deborah",NA,"Payroll Clearing (owner's time)",500,NA,5400
"2665","Deborah Wood Equity","Paycheck","2018-04-02",NA,"Wood, Deborah",NA,"Payroll Clearing (owner's time)",0,NA,5400
"2666","Deborah Wood Equity","Paycheck","2018-04-02",NA,"Wood, Deborah",NA,"Payroll Clearing (owner's time)",0,NA,5400
"2667","Deborah Wood Equity","Paycheck","2018-04-02",NA,"Wood, Deborah",NA,"Payroll Clearing (owner's time)",700,NA,6100
"2668","Deborah Wood Equity","Paycheck","2018-04-02",NA,"Wood, Deborah",NA,"Payroll Clearing (owner's time)",100,NA,6200
"2669","Deborah Wood Equity","Paycheck","2018-04-02",NA,"Wood, Deborah",NA,"Payroll Clearing (owner's time)",700,NA,6900
"2670","Deborah Wood Equity","Paycheck","2018-04-02",NA,"Wood, Deborah",NA,"Payroll Clearing (owner's time)",600,NA,7500
"2671","Deborah Wood Equity","Paycheck","2018-04-02",NA,"Wood, Deborah",NA,"Payroll Clearing (owner's time)",500,NA,8000
"2672","Deborah Wood Equity","Paycheck","2018-04-02",NA,"Wood, Deborah",NA,"Payroll Clearing (owner's time)",300,NA,8300
"2673","Deborah Wood Equity","Paycheck","2018-04-02",NA,"Wood, Deborah",NA,"Payroll Clearing (owner's time)",200,NA,8500
"2674","Deborah Wood Equity","Paycheck","2018-04-02",NA,"Wood, Deborah",NA,"Payroll Clearing (owner's time)",500,NA,9000
"2676","Deborah Wood Equity","Paycheck","2018-05-01",NA,"Wood, Deborah",NA,"Payroll Clearing (owner's time)",800,NA,800
"2677","Deborah Wood Equity","Paycheck","2018-05-01",NA,"Wood, Deborah",NA,"Payroll Clearing (owner's time)",900,NA,1700
"2678","Deborah Wood Equity","Paycheck","2018-05-01",NA,"Wood, Deborah",NA,"Payroll Clearing (owner's time)",500,NA,2200
"2679","Deborah Wood Equity","Paycheck","2018-05-01",NA,"Wood, Deborah",NA,"Payroll Clearing (owner's time)",200,NA,2400
"2680","Deborah Wood Equity","Paycheck","2018-05-01",NA,"Wood, Deborah",NA,"Payroll Clearing (owner's time)",100,NA,2500
"2681","Deborah Wood Equity","Paycheck","2018-05-01",NA,"Wood, Deborah",NA,"Payroll Clearing (owner's time)",600,NA,3100
"2682","Deborah Wood Equity","Paycheck","2018-05-01",NA,"Wood, Deborah",NA,"Payroll Clearing (owner's time)",500,NA,3600
"2683","Deborah Wood Equity","Paycheck","2018-05-01",NA,"Wood, Deborah",NA,"Payroll Clearing (owner's time)",1200,NA,4800
"2684","Deborah Wood Equity","Paycheck","2018-05-01",NA,"Wood, Deborah",NA,"Payroll Clearing (owner's time)",600,NA,5400
"2685","Deborah Wood Equity","Paycheck","2018-05-01",NA,"Wood, Deborah",NA,"Payroll Clearing (owner's time)",800,NA,6200
"2686","Deborah Wood Equity","Paycheck","2018-05-01",NA,"Wood, Deborah",NA,"Payroll Clearing (owner's time)",200,NA,6400
"2687","Deborah Wood Equity","Paycheck","2018-05-01",NA,"Wood, Deborah",NA,"Payroll Clearing (owner's time)",600,NA,7000
"2688","Deborah Wood Equity","Paycheck","2018-05-01",NA,"Wood, Deborah",NA,"Payroll Clearing (owner's time)",200,NA,7200
"2689","Deborah Wood Equity","Paycheck","2018-05-01",NA,"Wood, Deborah",NA,"Payroll Clearing (owner's time)",400,NA,7600
"2690","Deborah Wood Equity","Paycheck","2018-05-01",NA,"Wood, Deborah",NA,"Payroll Clearing (owner's time)",100,NA,7700
"2691","Deborah Wood Equity","Paycheck","2018-05-01",NA,"Wood, Deborah",NA,"Payroll Clearing (owner's time)",1100,NA,8800
"2692","Deborah Wood Equity","Paycheck","2018-05-01",NA,"Wood, Deborah",NA,"Payroll Clearing (owner's time)",200,NA,9000
"2693","Deborah Wood Equity","Paycheck","2018-05-01",NA,"Wood, Deborah",NA,"Payroll Clearing (owner's time)",600,NA,9600
"2694","Deborah Wood Equity","Paycheck","2018-05-01",NA,"Wood, Deborah",NA,"Payroll Clearing (owner's time)",300,NA,9900
"2695","Deborah Wood Equity","Paycheck","2018-05-01",NA,"Wood, Deborah",NA,"Payroll Clearing (owner's time)",100,NA,10000
"2697","Deborah Wood Equity","Paycheck","2018-06-01",NA,"Wood, Deborah",NA,"Payroll Clearing (owner's time)",500,NA,500
"2698","Deborah Wood Equity","Paycheck","2018-06-01",NA,"Wood, Deborah",NA,"Payroll Clearing (owner's time)",2550,NA,3050
"2699","Deborah Wood Equity","Paycheck","2018-06-01",NA,"Wood, Deborah",NA,"Payroll Clearing (owner's time)",950,NA,4000
"2700","Deborah Wood Equity","Paycheck","2018-06-01",NA,"Wood, Deborah",NA,"Payroll Clearing (owner's time)",200,NA,4200
"2701","Deborah Wood Equity","Paycheck","2018-06-01",NA,"Wood, Deborah",NA,"Payroll Clearing (owner's time)",400,NA,4600
"2702","Deborah Wood Equity","Paycheck","2018-06-01",NA,"Wood, Deborah",NA,"Payroll Clearing (owner's time)",700,NA,5300
"2703","Deborah Wood Equity","Paycheck","2018-06-01",NA,"Wood, Deborah",NA,"Payroll Clearing (owner's time)",600,NA,5900
"2704","Deborah Wood Equity","Paycheck","2018-06-01",NA,"Wood, Deborah",NA,"Payroll Clearing (owner's time)",300,NA,6200
"2705","Deborah Wood Equity","Paycheck","2018-06-01",NA,"Wood, Deborah",NA,"Payroll Clearing (owner's time)",100,NA,6300
"2706","Deborah Wood Equity","Paycheck","2018-06-01",NA,"Wood, Deborah",NA,"Payroll Clearing (owner's time)",700,NA,7000
"2707","Deborah Wood Equity","Paycheck","2018-06-01",NA,"Wood, Deborah",NA,"Payroll Clearing (owner's time)",700,NA,7700
"2708","Deborah Wood Equity","Paycheck","2018-06-01",NA,"Wood, Deborah",NA,"Payroll Clearing (owner's time)",600,NA,8300
"2709","Deborah Wood Equity","Paycheck","2018-06-01",NA,"Wood, Deborah",NA,"Payroll Clearing (owner's time)",400,NA,8700
"2710","Deborah Wood Equity","Paycheck","2018-06-01",NA,"Wood, Deborah",NA,"Payroll Clearing (owner's time)",100,NA,8800
"2711","Deborah Wood Equity","Paycheck","2018-06-01",NA,"Wood, Deborah",NA,"Payroll Clearing (owner's time)",400,NA,9200
"2712","Deborah Wood Equity","Paycheck","2018-06-01",NA,"Wood, Deborah",NA,"Payroll Clearing (owner's time)",350,NA,9550
"2713","Deborah Wood Equity","Paycheck","2018-06-01",NA,"Wood, Deborah",NA,"Payroll Clearing (owner's time)",350,NA,9900
"2714","Deborah Wood Equity","Paycheck","2018-06-01",NA,"Wood, Deborah",NA,"Payroll Clearing (owner's time)",200,NA,10100
"2715","Deborah Wood Equity","Paycheck","2018-06-01",NA,"Wood, Deborah",NA,"Payroll Clearing (owner's time)",300,NA,10400
"2716","Deborah Wood Equity","Paycheck","2018-06-01",NA,"Wood, Deborah",NA,"Payroll Clearing (owner's time)",700,NA,11100
"2717","Deborah Wood Equity","Paycheck","2018-06-01",NA,"Wood, Deborah",NA,"Payroll Clearing (owner's time)",200,NA,11300
"2718","Deborah Wood Equity","Paycheck","2018-06-01",NA,"Wood, Deborah",NA,"Payroll Clearing (owner's time)",100,NA,11400
"2719","Deborah Wood Equity","Paycheck","2018-06-01",NA,"Wood, Deborah",NA,"Payroll Clearing (owner's time)",200,NA,11600
"2721","Deborah Wood Equity","Paycheck","2018-07-02",NA,"Wood, Deborah",NA,"Payroll Clearing (owner's time)",100,NA,100
"2722","Deborah Wood Equity","Paycheck","2018-07-02",NA,"Wood, Deborah",NA,"Payroll Clearing (owner's time)",1950,NA,2050
"2723","Deborah Wood Equity","Paycheck","2018-07-02",NA,"Wood, Deborah",NA,"Payroll Clearing (owner's time)",400,NA,2450
"2724","Deborah Wood Equity","Paycheck","2018-07-02",NA,"Wood, Deborah",NA,"Payroll Clearing (owner's time)",100,NA,2550
"2725","Deborah Wood Equity","Paycheck","2018-07-02",NA,"Wood, Deborah",NA,"Payroll Clearing (owner's time)",200,NA,2750
"2726","Deborah Wood Equity","Paycheck","2018-07-02",NA,"Wood, Deborah",NA,"Payroll Clearing (owner's time)",1700,NA,4450
"2727","Deborah Wood Equity","Paycheck","2018-07-02",NA,"Wood, Deborah",NA,"Payroll Clearing (owner's time)",500,NA,4950
"2728","Deborah Wood Equity","Paycheck","2018-07-02",NA,"Wood, Deborah",NA,"Payroll Clearing (owner's time)",400,NA,5350
"2729","Deborah Wood Equity","Paycheck","2018-07-02",NA,"Wood, Deborah",NA,"Payroll Clearing (owner's time)",700,NA,6050
"2730","Deborah Wood Equity","Paycheck","2018-07-02",NA,"Wood, Deborah",NA,"Payroll Clearing (owner's time)",100,NA,6150
"2731","Deborah Wood Equity","Paycheck","2018-07-02",NA,"Wood, Deborah",NA,"Payroll Clearing (owner's time)",400,NA,6550
"2732","Deborah Wood Equity","Paycheck","2018-07-02",NA,"Wood, Deborah",NA,"Payroll Clearing (owner's time)",600,NA,7150
"2733","Deborah Wood Equity","Paycheck","2018-07-02",NA,"Wood, Deborah",NA,"Payroll Clearing (owner's time)",300,NA,7450
"2734","Deborah Wood Equity","Paycheck","2018-07-02",NA,"Wood, Deborah",NA,"Payroll Clearing (owner's time)",800,NA,8250
"2735","Deborah Wood Equity","Paycheck","2018-07-02",NA,"Wood, Deborah",NA,"Payroll Clearing (owner's time)",400,NA,8650
"2736","Deborah Wood Equity","Paycheck","2018-07-02",NA,"Wood, Deborah",NA,"Payroll Clearing (owner's time)",600,NA,9250
"2737","Deborah Wood Equity","Paycheck","2018-07-02",NA,"Wood, Deborah",NA,"Payroll Clearing (owner's time)",500,NA,9750
"2738","Deborah Wood Equity","Paycheck","2018-07-02",NA,"Wood, Deborah",NA,"Payroll Clearing (owner's time)",500,NA,10250
"2739","Deborah Wood Equity","Paycheck","2018-07-02",NA,"Wood, Deborah",NA,"Payroll Clearing (owner's time)",500,NA,10750
"2740","Deborah Wood Equity","Paycheck","2018-07-02",NA,"Wood, Deborah",NA,"Payroll Clearing (owner's time)",200,NA,10950
"2741","Deborah Wood Equity","Paycheck","2018-07-02",NA,"Wood, Deborah",NA,"Payroll Clearing (owner's time)",200,NA,11150
"2743","Deborah Wood Equity","Paycheck","2018-08-01",NA,"Wood, Deborah",NA,"Payroll Clearing (owner's time)",2050,NA,2050
"2744","Deborah Wood Equity","Paycheck","2018-08-01",NA,"Wood, Deborah",NA,"Payroll Clearing (owner's time)",0,NA,2050
"2745","Deborah Wood Equity","Paycheck","2018-08-01",NA,"Wood, Deborah",NA,"Payroll Clearing (owner's time)",1150,NA,3200
"2746","Deborah Wood Equity","Paycheck","2018-08-01",NA,"Wood, Deborah",NA,"Payroll Clearing (owner's time)",550,NA,3750
"2747","Deborah Wood Equity","Paycheck","2018-08-01",NA,"Wood, Deborah",NA,"Payroll Clearing (owner's time)",0,NA,3750
"2748","Deborah Wood Equity","Paycheck","2018-08-01",NA,"Wood, Deborah",NA,"Payroll Clearing (owner's time)",550,NA,4300
"2749","Deborah Wood Equity","Paycheck","2018-08-01",NA,"Wood, Deborah",NA,"Payroll Clearing (owner's time)",300,NA,4600
"2750","Deborah Wood Equity","Paycheck","2018-08-01",NA,"Wood, Deborah",NA,"Payroll Clearing (owner's time)",400,NA,5000
"2751","Deborah Wood Equity","Paycheck","2018-08-01",NA,"Wood, Deborah",NA,"Payroll Clearing (owner's time)",200,NA,5200
"2752","Deborah Wood Equity","Paycheck","2018-08-01",NA,"Wood, Deborah",NA,"Payroll Clearing (owner's time)",100,NA,5300
"2753","Deborah Wood Equity","Paycheck","2018-08-01",NA,"Wood, Deborah",NA,"Payroll Clearing (owner's time)",1400,NA,6700
"2754","Deborah Wood Equity","Paycheck","2018-08-01",NA,"Wood, Deborah",NA,"Payroll Clearing (owner's time)",500,NA,7200
"2755","Deborah Wood Equity","Paycheck","2018-08-01",NA,"Wood, Deborah",NA,"Payroll Clearing (owner's time)",400,NA,7600
"2756","Deborah Wood Equity","Paycheck","2018-08-01",NA,"Wood, Deborah",NA,"Payroll Clearing (owner's time)",300,NA,7900
"2757","Deborah Wood Equity","Paycheck","2018-08-01",NA,"Wood, Deborah",NA,"Payroll Clearing (owner's time)",100,NA,8000
"2758","Deborah Wood Equity","Paycheck","2018-08-01",NA,"Wood, Deborah",NA,"Payroll Clearing (owner's time)",100,NA,8100
"2759","Deborah Wood Equity","Paycheck","2018-08-01",NA,"Wood, Deborah",NA,"Payroll Clearing (owner's time)",400,NA,8500
"2760","Deborah Wood Equity","Paycheck","2018-08-01",NA,"Wood, Deborah",NA,"Payroll Clearing (owner's time)",400,NA,8900
"2761","Deborah Wood Equity","Paycheck","2018-08-01",NA,"Wood, Deborah",NA,"Payroll Clearing (owner's time)",200,NA,9100
"2762","Deborah Wood Equity","Paycheck","2018-08-01",NA,"Wood, Deborah",NA,"Payroll Clearing (owner's time)",400,NA,9500
"2763","Deborah Wood Equity","Paycheck","2018-08-01",NA,"Wood, Deborah",NA,"Payroll Clearing (owner's time)",400,NA,9900
"2765","Deborah Wood Equity","Paycheck","2018-09-03",NA,"Wood, Deborah",NA,"Payroll Clearing (owner's time)",1100,NA,1100
"2766","Deborah Wood Equity","Paycheck","2018-09-03",NA,"Wood, Deborah",NA,"Payroll Clearing (owner's time)",400,NA,1500
"2767","Deborah Wood Equity","Paycheck","2018-09-03",NA,"Wood, Deborah",NA,"Payroll Clearing (owner's time)",1500,NA,3000
"2768","Deborah Wood Equity","Paycheck","2018-09-03",NA,"Wood, Deborah",NA,"Payroll Clearing (owner's time)",200,NA,3200
"2769","Deborah Wood Equity","Paycheck","2018-09-03",NA,"Wood, Deborah",NA,"Payroll Clearing (owner's time)",100,NA,3300
"2770","Deborah Wood Equity","Paycheck","2018-09-03",NA,"Wood, Deborah",NA,"Payroll Clearing (owner's time)",400,NA,3700
"2771","Deborah Wood Equity","Paycheck","2018-09-03",NA,"Wood, Deborah",NA,"Payroll Clearing (owner's time)",1450,NA,5150
"2772","Deborah Wood Equity","Paycheck","2018-09-03",NA,"Wood, Deborah",NA,"Payroll Clearing (owner's time)",1300,NA,6450
"2773","Deborah Wood Equity","Paycheck","2018-09-03",NA,"Wood, Deborah",NA,"Payroll Clearing (owner's time)",600,NA,7050
"2774","Deborah Wood Equity","Paycheck","2018-09-03",NA,"Wood, Deborah",NA,"Payroll Clearing (owner's time)",300,NA,7350
"2775","Deborah Wood Equity","Paycheck","2018-09-03",NA,"Wood, Deborah",NA,"Payroll Clearing (owner's time)",200,NA,7550
"2776","Deborah Wood Equity","Paycheck","2018-09-03",NA,"Wood, Deborah",NA,"Payroll Clearing (owner's time)",400,NA,7950
"2777","Deborah Wood Equity","Paycheck","2018-09-03",NA,"Wood, Deborah",NA,"Payroll Clearing (owner's time)",200,NA,8150
"2778","Deborah Wood Equity","Paycheck","2018-09-03",NA,"Wood, Deborah",NA,"Payroll Clearing (owner's time)",100,NA,8250
"2779","Deborah Wood Equity","Paycheck","2018-09-03",NA,"Wood, Deborah",NA,"Payroll Clearing (owner's time)",400,NA,8650
"2780","Deborah Wood Equity","Paycheck","2018-09-03",NA,"Wood, Deborah",NA,"Payroll Clearing (owner's time)",400,NA,9050
"2781","Deborah Wood Equity","Paycheck","2018-09-03",NA,"Wood, Deborah",NA,"Payroll Clearing (owner's time)",750,NA,9800
"2782","Deborah Wood Equity","Paycheck","2018-09-03",NA,"Wood, Deborah",NA,"Payroll Clearing (owner's time)",200,NA,10000
"2783","Deborah Wood Equity","Paycheck","2018-09-03",NA,"Wood, Deborah",NA,"Payroll Clearing (owner's time)",350,NA,10350
"2784","Deborah Wood Equity","Paycheck","2018-09-03",NA,"Wood, Deborah",NA,"Payroll Clearing (owner's time)",150,NA,10500
"2785","Deborah Wood Equity","Paycheck","2018-09-03",NA,"Wood, Deborah",NA,"Payroll Clearing (owner's time)",300,NA,10800
"2786","Deborah Wood Equity","Paycheck","2018-09-03",NA,"Wood, Deborah",NA,"Payroll Clearing (owner's time)",400,NA,11200
"2787","Deborah Wood Equity","Paycheck","2018-09-03",NA,"Wood, Deborah",NA,"Payroll Clearing (owner's time)",400,NA,11600
"2788","Deborah Wood Equity","Paycheck","2018-09-03",NA,"Wood, Deborah",NA,"Payroll Clearing (owner's time)",300,NA,11900
"2789","Deborah Wood Equity","Paycheck","2018-09-03",NA,"Wood, Deborah",NA,"Payroll Clearing (owner's time)",300,NA,12200
"2791","Deborah Wood Equity","Paycheck","2018-10-01",NA,"Wood, Deborah",NA,"Payroll Clearing (owner's time)",2200,NA,2200
"2792","Deborah Wood Equity","Paycheck","2018-10-01",NA,"Wood, Deborah",NA,"Payroll Clearing (owner's time)",300,NA,2500
"2793","Deborah Wood Equity","Paycheck","2018-10-01",NA,"Wood, Deborah",NA,"Payroll Clearing (owner's time)",300,NA,2800
"2794","Deborah Wood Equity","Paycheck","2018-10-01",NA,"Wood, Deborah",NA,"Payroll Clearing (owner's time)",2950,NA,5750
"2795","Deborah Wood Equity","Paycheck","2018-10-01",NA,"Wood, Deborah",NA,"Payroll Clearing (owner's time)",300,NA,6050
"2796","Deborah Wood Equity","Paycheck","2018-10-01",NA,"Wood, Deborah",NA,"Payroll Clearing (owner's time)",400,NA,6450
"2797","Deborah Wood Equity","Paycheck","2018-10-01",NA,"Wood, Deborah",NA,"Payroll Clearing (owner's time)",400,NA,6850
"2798","Deborah Wood Equity","Paycheck","2018-10-01",NA,"Wood, Deborah",NA,"Payroll Clearing (owner's time)",400,NA,7250
"2799","Deborah Wood Equity","Paycheck","2018-10-01",NA,"Wood, Deborah",NA,"Payroll Clearing (owner's time)",400,NA,7650
"2800","Deborah Wood Equity","Paycheck","2018-10-01",NA,"Wood, Deborah",NA,"Payroll Clearing (owner's time)",200,NA,7850
"2801","Deborah Wood Equity","Paycheck","2018-10-01",NA,"Wood, Deborah",NA,"Payroll Clearing (owner's time)",200,NA,8050
"2802","Deborah Wood Equity","Paycheck","2018-10-01",NA,"Wood, Deborah",NA,"Payroll Clearing (owner's time)",200,NA,8250
"2803","Deborah Wood Equity","Paycheck","2018-10-01",NA,"Wood, Deborah",NA,"Payroll Clearing (owner's time)",600,NA,8850
"2804","Deborah Wood Equity","Paycheck","2018-10-01",NA,"Wood, Deborah",NA,"Payroll Clearing (owner's time)",300,NA,9150
"2805","Deborah Wood Equity","Paycheck","2018-10-01",NA,"Wood, Deborah",NA,"Payroll Clearing (owner's time)",300,NA,9450
"2806","Deborah Wood Equity","Paycheck","2018-10-01",NA,"Wood, Deborah",NA,"Payroll Clearing (owner's time)",100,NA,9550
"2807","Deborah Wood Equity","Paycheck","2018-10-01",NA,"Wood, Deborah",NA,"Payroll Clearing (owner's time)",300,NA,9850
"2808","Deborah Wood Equity","Paycheck","2018-10-01",NA,"Wood, Deborah",NA,"Payroll Clearing (owner's time)",300,NA,10150
"2809","Deborah Wood Equity","Paycheck","2018-10-01",NA,"Wood, Deborah",NA,"Payroll Clearing (owner's time)",400,NA,10550
"2810","Deborah Wood Equity","Paycheck","2018-10-01",NA,"Wood, Deborah",NA,"Payroll Clearing (owner's time)",50,NA,10600
"2811","Deborah Wood Equity","Paycheck","2018-10-01",NA,"Wood, Deborah",NA,"Payroll Clearing (owner's time)",200,NA,10800
"2812","Deborah Wood Equity","Paycheck","2018-10-01",NA,"Wood, Deborah",NA,"Payroll Clearing (owner's time)",300,NA,11100
"2813","Deborah Wood Equity","Paycheck","2018-10-01",NA,"Wood, Deborah",NA,"Payroll Clearing (owner's time)",500,NA,11600
"2814","Deborah Wood Equity","Paycheck","2018-10-01",NA,"Wood, Deborah",NA,"Payroll Clearing (owner's time)",400,NA,12000
"2815","Deborah Wood Equity","Paycheck","2018-10-01",NA,"Wood, Deborah",NA,"Payroll Clearing (owner's time)",300,NA,12300
"2816","Deborah Wood Equity","Paycheck","2018-10-01",NA,"Wood, Deborah",NA,"Payroll Clearing (owner's time)",300,NA,12600
"2818","Deborah Wood Equity","Paycheck","2018-11-01",NA,"Wood, Deborah",NA,"Payroll Clearing (owner's time)",1300,NA,1300
"2819","Deborah Wood Equity","Paycheck","2018-11-01",NA,"Wood, Deborah",NA,"Payroll Clearing (owner's time)",700,NA,2000
"2820","Deborah Wood Equity","Paycheck","2018-11-01",NA,"Wood, Deborah",NA,"Payroll Clearing (owner's time)",800,NA,2800
"2821","Deborah Wood Equity","Paycheck","2018-11-01",NA,"Wood, Deborah",NA,"Payroll Clearing (owner's time)",200,NA,3000
"2822","Deborah Wood Equity","Paycheck","2018-11-01",NA,"Wood, Deborah",NA,"Payroll Clearing (owner's time)",500,NA,3500
"2823","Deborah Wood Equity","Paycheck","2018-11-01",NA,"Wood, Deborah",NA,"Payroll Clearing (owner's time)",1700,NA,5200
"2824","Deborah Wood Equity","Paycheck","2018-11-01",NA,"Wood, Deborah",NA,"Payroll Clearing (owner's time)",300,NA,5500
"2825","Deborah Wood Equity","Paycheck","2018-11-01",NA,"Wood, Deborah",NA,"Payroll Clearing (owner's time)",400,NA,5900
"2826","Deborah Wood Equity","Paycheck","2018-11-01",NA,"Wood, Deborah",NA,"Payroll Clearing (owner's time)",600,NA,6500
"2827","Deborah Wood Equity","Paycheck","2018-11-01",NA,"Wood, Deborah",NA,"Payroll Clearing (owner's time)",350,NA,6850
"2828","Deborah Wood Equity","Paycheck","2018-11-01",NA,"Wood, Deborah",NA,"Payroll Clearing (owner's time)",350,NA,7200
"2829","Deborah Wood Equity","Paycheck","2018-11-01",NA,"Wood, Deborah",NA,"Payroll Clearing (owner's time)",800,NA,8000
"2830","Deborah Wood Equity","Paycheck","2018-11-01",NA,"Wood, Deborah",NA,"Payroll Clearing (owner's time)",400,NA,8400
"2831","Deborah Wood Equity","Paycheck","2018-11-01",NA,"Wood, Deborah",NA,"Payroll Clearing (owner's time)",600,NA,9000
"2832","Deborah Wood Equity","Paycheck","2018-11-01",NA,"Wood, Deborah",NA,"Payroll Clearing (owner's time)",700,NA,9700
"2833","Deborah Wood Equity","Paycheck","2018-11-01",NA,"Wood, Deborah",NA,"Payroll Clearing (owner's time)",800,NA,10500
"2834","Deborah Wood Equity","Paycheck","2018-11-01",NA,"Wood, Deborah",NA,"Payroll Clearing (owner's time)",400,NA,10900
"2835","Deborah Wood Equity","Paycheck","2018-11-01",NA,"Wood, Deborah",NA,"Payroll Clearing (owner's time)",300,NA,11200
"2836","Deborah Wood Equity","Paycheck","2018-11-01",NA,"Wood, Deborah",NA,"Payroll Clearing (owner's time)",300,NA,11500
"2838","Deborah Wood Equity","Paycheck","2018-12-03",NA,"Wood, Deborah",NA,"Payroll Clearing (owner's time)",1250,NA,1250
"2839","Deborah Wood Equity","Paycheck","2018-12-03",NA,"Wood, Deborah",NA,"Payroll Clearing (owner's time)",250,NA,1500
"2840","Deborah Wood Equity","Paycheck","2018-12-03",NA,"Wood, Deborah",NA,"Payroll Clearing (owner's time)",1300,NA,2800
"2841","Deborah Wood Equity","Paycheck","2018-12-03",NA,"Wood, Deborah",NA,"Payroll Clearing (owner's time)",400,NA,3200
"2842","Deborah Wood Equity","Paycheck","2018-12-03",NA,"Wood, Deborah",NA,"Payroll Clearing (owner's time)",800,NA,4000
"2843","Deborah Wood Equity","Paycheck","2018-12-03",NA,"Wood, Deborah",NA,"Payroll Clearing (owner's time)",400,NA,4400
"2844","Deborah Wood Equity","Paycheck","2018-12-03",NA,"Wood, Deborah",NA,"Payroll Clearing (owner's time)",600,NA,5000
"2845","Deborah Wood Equity","Paycheck","2018-12-03",NA,"Wood, Deborah",NA,"Payroll Clearing (owner's time)",200,NA,5200
"2846","Deborah Wood Equity","Paycheck","2018-12-03",NA,"Wood, Deborah",NA,"Payroll Clearing (owner's time)",300,NA,5500
"2847","Deborah Wood Equity","Paycheck","2018-12-03",NA,"Wood, Deborah",NA,"Payroll Clearing (owner's time)",300,NA,5800
"2848","Deborah Wood Equity","Paycheck","2018-12-03",NA,"Wood, Deborah",NA,"Payroll Clearing (owner's time)",1000,NA,6800
"2849","Deborah Wood Equity","Paycheck","2018-12-03",NA,"Wood, Deborah",NA,"Payroll Clearing (owner's time)",1000,NA,7800
"2850","Deborah Wood Equity","Paycheck","2018-12-03",NA,"Wood, Deborah",NA,"Payroll Clearing (owner's time)",300,NA,8100
"2851","Deborah Wood Equity","Paycheck","2018-12-03",NA,"Wood, Deborah",NA,"Payroll Clearing (owner's time)",100,NA,8200
"2853","Deborah Wood Equity","Paycheck","2018-12-15","5363","Wood, Deborah",NA,"Company Checking Account",2000,NA,2000
"2857","Deborah Wood Equity","Check","2018-01-26","5019","Deborah Wood (Owner)","Owners Draw","Company Checking Account",10500,NA,10500
"2858","Deborah Wood Equity","Check","2018-02-26","5051","Deborah Wood (Owner)","Owner's Draw","Company Checking Account",12250,NA,22750
"2859","Deborah Wood Equity","Check","2018-03-26","5075","Deborah Wood (Owner)","Owner's Draw","Company Checking Account",10000,NA,32750
"2860","Deborah Wood Equity","Check","2018-04-25","5100","Deborah Wood (Owner)","Owner's Draw","Company Checking Account",11750,NA,44500
"2861","Deborah Wood Equity","Check","2018-05-25","5124","Deborah Wood (Owner)","Owner's Draw","Company Checking Account",12000,NA,56500
"2862","Deborah Wood Equity","Check","2018-06-25","5154","Deborah Wood (Owner)","Owner's Draw","Company Checking Account",11250,NA,67750
"2863","Deborah Wood Equity","Check","2018-07-25","5179","Deborah Wood (Owner)","Owner's Draw","Company Checking Account",10000,NA,77750
"2864","Deborah Wood Equity","Check","2018-08-27","5214","Deborah Wood (Owner)","Owner's Draw","Company Checking Account",12000,NA,89750
"2865","Deborah Wood Equity","Check","2018-09-25","5236","Deborah Wood (Owner)","Owner's Draw","Company Checking Account",11500,NA,101250
"2866","Deborah Wood Equity","Check","2018-10-25","5261","Deborah Wood (Owner)","Owner's Draw","Company Checking Account",11000,NA,112250
"2867","Deborah Wood Equity","Check","2018-11-26","5287","Deborah Wood (Owner)","Owner's Draw","Company Checking Account",10750,NA,123000
"2868","Deborah Wood Equity","Check","2018-12-21","5309","Deborah Wood (Owner)","Owner's Draw","Company Checking Account",12000,NA,135000
"2876","Opening Bal Equity","Inventory Adjust","2018-12-15",NA,NA,"Indoor Electrical Wire Opening balance","Inventory Asset",NA,375,-44324.8
"2883","Revenue","Invoice","2018-01-06","71047","Baker's Professional Lighting:Store #25","Pearl Nickle, 5 Light, Medium Base (100 watt max)","Accounts Receivable",NA,570,-570
"2884","Revenue","Invoice","2018-01-06","71047","Baker's Professional Lighting:Store #25","Black Finish, Solid Brass, Clear Glass, Hanging, 2-60 watt max.","Accounts Receivable",NA,84,-654
"2885","Revenue","Invoice","2018-01-06","71047","Baker's Professional Lighting:Store #25","Beveled Mirror, Etched Ribbed Glass (75 watt max)","Accounts Receivable",NA,144,-798
"2886","Revenue","Invoice","2018-01-06","71047","Baker's Professional Lighting:Store #25","Tiffany Collection,Golden Baroque, 1-light lantern, medium base (100 watt max)","Accounts Receivable",NA,510,-1308
"2887","Revenue","Invoice","2018-01-06","71047","Baker's Professional Lighting:Store #25","Burnished Brass (60 watt)  w/Golden Umber Accents","Accounts Receivable",NA,600,-1908
"2888","Revenue","Invoice","2018-01-06","71047","Baker's Professional Lighting:Store #25","Specialty Bulbs, 100 watt (6 pack)","Accounts Receivable",NA,55,-1963
"2889","Revenue","Invoice","2018-01-06","71047","Baker's Professional Lighting:Store #25","Pendant Bar, Cobblestone, 50lbs. max","Accounts Receivable",NA,50,-2013
"2890","Revenue","Invoice","2018-01-06","71047","Baker's Professional Lighting:Store #25","Verona Collection, Pendant, Cobblestone, Etched Alabaster Glass, 150 watt max","Accounts Receivable",NA,300,-2313
"2891","Revenue","Invoice","2018-01-06","71047","Baker's Professional Lighting:Store #25","Halogen Lamp, 20 watts, Luminous Intensity","Accounts Receivable",NA,12,-2325
"2892","Revenue","Invoice","2018-01-06","71047","Baker's Professional Lighting:Store #25","Cand. Light, 20 watts (8 pack)","Accounts Receivable",NA,56,-2381
"2893","Revenue","Invoice","2018-01-14","71050","Godwin Lighting Depot:Store #202","Pearl Nickle, 5 Light, Medium Base (100 watt max)","Accounts Receivable",NA,2375,-4756
"2894","Revenue","Invoice","2018-01-14","71050","Godwin Lighting Depot:Store #202","Roman Bronze, 1-light Lantern, w/tail, (100 watt max)","Accounts Receivable",NA,850,-5606
"2895","Revenue","Invoice","2018-01-14","71050","Godwin Lighting Depot:Store #202","Flush Mount, Polished Brass (2, 13 watt)  White acrylic diffuser","Accounts Receivable",NA,608,-6214
"2896","Revenue","Invoice","2018-01-14","71050","Godwin Lighting Depot:Store #202","Brushed Nickel, Pendant, 1-100 watt Medium Base, Satin Etched Glass","Accounts Receivable",NA,660,-6874
"2897","Revenue","Invoice","2018-01-14","71050","Godwin Lighting Depot:Store #202","Tiffany Collection,Golden Baroque, 1-light lantern, medium base (100 watt max)","Accounts Receivable",NA,1020,-7894
"2898","Revenue","Invoice","2018-01-14","71050","Godwin Lighting Depot:Store #202","River Rock (8/60 watt)  Faux Alabaster Glass","Accounts Receivable",NA,1800,-9694
"2899","Revenue","Invoice","2018-01-14","71050","Godwin Lighting Depot:Store #202","Specialty, Stage & Studio Bulbs  60 watt","Accounts Receivable",NA,325,-10019
"2900","Revenue","Invoice","2018-01-14","71050","Godwin Lighting Depot:Store #202","Specialty Bulbs, 100 watt (6 pack)","Accounts Receivable",NA,110,-10129
"2901","Revenue","Invoice","2018-01-14","71050","Godwin Lighting Depot:Store #202","Halogen Lamp, 20 watts, Luminous Intensity","Accounts Receivable",NA,38.4,-10167.4
"2902","Revenue","Invoice","2018-01-17","71055","Miscellaneous - Retail:Ms. Jann Minor","Polished Brass Pendant, 1-100 watt Medium Base, Clear Ribbed Glass","Accounts Receivable",NA,350,-10517.4
"2903","Revenue","Invoice","2018-01-17","71055","Miscellaneous - Retail:Ms. Jann Minor","Pendant Bar, Textured White, 50lbs max","Accounts Receivable",NA,50,-10567.4
"2904","Revenue","Invoice","2018-01-17","71055","Miscellaneous - Retail:Ms. Jann Minor","Golden Umber (100 watt)  Six Light Chandelier","Accounts Receivable",NA,315,-10882.4
"2905","Revenue","Invoice","2018-01-17","71055","Miscellaneous - Retail:Ms. Jann Minor","Beveled Mirror, Etched Ribbed Glass (75 watt max)","Accounts Receivable",NA,144,-11026.4
"2906","Revenue","Invoice","2018-01-17","71055","Miscellaneous - Retail:Ms. Jann Minor","Sunset, Clear Glass, 1-100 watt max.","Accounts Receivable",NA,140,-11166.4
"2907","Revenue","Invoice","2018-01-17","71055","Miscellaneous - Retail:Ms. Jann Minor","Black Finish, Solid Brass, Hanging w/Clear Glass (2x60watt max)","Accounts Receivable",NA,85,-11251.4
"2908","Revenue","Invoice","2018-01-18","71092","Miscellaneous - Retail:Brian Stern","Sunset, Clear Glass, 1-100 watt max.","Accounts Receivable",NA,175,-11426.4
"2909","Revenue","Invoice","2018-01-18","71092","Miscellaneous - Retail:Brian Stern","Beveled Mirror, Etched Ribbed Glass (75 watt max)","Accounts Receivable",NA,144,-11570.4
"2910","Revenue","Invoice","2018-01-18","71092","Miscellaneous - Retail:Brian Stern","Athena Collection, (100 watt max) Copper Verde, Seeded Glass","Accounts Receivable",NA,225,-11795.4
"2911","Revenue","Invoice","2018-01-18","71092","Miscellaneous - Retail:Brian Stern","Burnished Brass (60 watt)  w/Golden Umber Accents","Accounts Receivable",NA,300,-12095.4
"2912","Revenue","Invoice","2018-01-18","71092","Miscellaneous - Retail:Brian Stern","Polished Brass Pendant, 1-100 watt Medium Base, Clear Ribbed Glass","Accounts Receivable",NA,232,-12327.4
"2913","Revenue","Invoice","2018-01-18","71092","Miscellaneous - Retail:Brian Stern","Pendant Bar, Textured White, 50lbs max","Accounts Receivable",NA,50,-12377.4
"2914","Revenue","Invoice","2018-01-28","71053","Miscellaneous - Retail:Alison Johnson","Tapestry, (2-60 watt Med), Etched Cracked Glass, Finish 10","Accounts Receivable",NA,90,-12467.4
"2915","Revenue","Invoice","2018-01-28","71053","Miscellaneous - Retail:Alison Johnson","Tapestry (8/60 watt)  Faux Alabaster Glass","Accounts Receivable",NA,300,-12767.4
"2916","Revenue","Invoice","2018-01-28","71053","Miscellaneous - Retail:Alison Johnson","Vianne Lanterns, Satin Antiqued Solid Brass, 3-light wall latern, Candelabra base (60 watt max)","Accounts Receivable",NA,400,-13167.4
"2917","Revenue","Invoice","2018-01-28","71053","Miscellaneous - Retail:Alison Johnson","White, 4.5x7.5, 1-100 watt Medium Base, Satin White Glass","Accounts Receivable",NA,64,-13231.4
"2918","Revenue","Invoice","2018-01-28","71072","Cole Home Builders:Phase 2 - Lot 5","Die Cast Lanterns, Black, 1-100 watt, Medium Base, Clear Cracked Glass","Accounts Receivable",NA,367.2,-13598.6
"2919","Revenue","Invoice","2018-01-28","71072","Cole Home Builders:Phase 2 - Lot 5","Tapestry, (2-60 watt Med), Etched Cracked Glass, Finish 10","Accounts Receivable",NA,243,-13841.6
"2920","Revenue","Invoice","2018-01-28","71072","Cole Home Builders:Phase 2 - Lot 5","Pearl Nickle, 5 Light, Medium Base (100 watt max)","Accounts Receivable",NA,342,-14183.6
"2921","Revenue","Invoice","2018-01-28","71072","Cole Home Builders:Phase 2 - Lot 5","Sunset, Clear Glass, 1-100 watt max.","Accounts Receivable",NA,126,-14309.6
"2922","Revenue","Invoice","2018-01-28","71072","Cole Home Builders:Phase 2 - Lot 5","Black Finish, Solid Brass, Clear Glass, Hanging, 2-60 watt max.","Accounts Receivable",NA,113.4,-14423
"2923","Revenue","Invoice","2018-01-28","71072","Cole Home Builders:Phase 2 - Lot 5","Burnished Brass (60 watt)  w/Golden Umber Accents","Accounts Receivable",NA,270,-14693
"2924","Revenue","Invoice","2018-01-28","71072","Cole Home Builders:Phase 2 - Lot 5","Chestnut (3/60 watt)  Marble Glass","Accounts Receivable",NA,292.5,-14985.5
"2925","Revenue","Invoice","2018-01-28","71072","Cole Home Builders:Phase 2 - Lot 5","Pendant Bar, Textured White, 50lbs max","Accounts Receivable",NA,22.5,-15008
"2926","Revenue","Invoice","2018-01-28","71072","Cole Home Builders:Phase 2 - Lot 5","Athena Collection, (100 watt max) Copper Verde, Seeded Glass","Accounts Receivable",NA,81,-15089
"2927","Revenue","Invoice","2018-01-28","71072","Cole Home Builders:Phase 2 - Lot 5","Cand. Light, 20 watts (8 pack)","Accounts Receivable",NA,50.4,-15139.4
"2928","Revenue","Invoice","2018-01-28","71072","Cole Home Builders:Phase 2 - Lot 5","Fluorescent Lamp, T-12, Medium Bipin  (30pack)","Accounts Receivable",NA,13.5,-15152.9
"2929","Revenue","Invoice","2018-01-28","71072","Cole Home Builders:Phase 2 - Lot 5","Fluorescent Lamp, T-5, Bipin","Accounts Receivable",NA,18,-15170.9
"2930","Revenue","Invoice","2018-01-28","71072","Cole Home Builders:Phase 2 - Lot 5","Halogen Lamp, Volts:3.5  Tubular","Accounts Receivable",NA,4.95,-15175.85
"2931","Revenue","Invoice","2018-01-28","71072","Cole Home Builders:Phase 2 - Lot 5","Specialty Bulbs, 100 watt (6 pack)","Accounts Receivable",NA,19.8,-15195.65
"2932","Revenue","Invoice","2018-01-28","71072","Cole Home Builders:Phase 2 - Lot 5","Specialty, Stage & Studio Bulbs  60 watt","Accounts Receivable",NA,46.8,-15242.45
"2933","Revenue","Invoice","2018-01-28","71072","Cole Home Builders:Phase 2 - Lot 5","Flat Glass, (25 watt max) Polished Brass, 4 light","Accounts Receivable",NA,90,-15332.45
"2934","Revenue","Invoice","2018-01-28","71072","Cole Home Builders:Phase 2 - Lot 5","Beveled Mirror, Etched Ribbed Glass (75 watt max)","Accounts Receivable",NA,86.4,-15418.85
"2935","Revenue","Invoice","2018-01-29","71124","Kern Lighting Warehouse:Store #34","Burnished Brass (60 watt)  w/Golden Umber Accents","Accounts Receivable",NA,8400,-23818.85
"2936","Revenue","Invoice","2018-01-31","71059","Godwin Lighting Depot:Store #303","Black Finish, Solid Brass, Clear Glass, Hanging, 2-60 watt max.","Accounts Receivable",NA,113.4,-23932.25
"2937","Revenue","Invoice","2018-01-31","71059","Godwin Lighting Depot:Store #303","Black Finish, Solid Brass,Wall Mount w/Clear Glass (2x60watt max)","Accounts Receivable",NA,337.5,-24269.75
"2938","Revenue","Invoice","2018-01-31","71059","Godwin Lighting Depot:Store #303","Tapestry (8/60 watt)  Faux Alabaster Glass","Accounts Receivable",NA,540,-24809.75
"2939","Revenue","Invoice","2018-01-31","71059","Godwin Lighting Depot:Store #303","Athena Collection, (100 watt max) Copper Verde, Seeded Glass","Accounts Receivable",NA,405,-25214.75
"2940","Revenue","Invoice","2018-01-31","71059","Godwin Lighting Depot:Store #303","Broadway Collection, Polished Chrome, 4 Light (60 watt max)","Accounts Receivable",NA,126.9,-25341.65
"2941","Revenue","Invoice","2018-01-31","71059","Godwin Lighting Depot:Store #303","Halogen Lamp, Volts:3.5  Tubular","Accounts Receivable",NA,9.9,-25351.55
"2942","Revenue","Invoice","2018-01-31","71059","Godwin Lighting Depot:Store #303","Specialty Bulbs, 100 watt (6 pack)","Accounts Receivable",NA,19.8,-25371.35
"2943","Revenue","Invoice","2018-01-31","71059","Godwin Lighting Depot:Store #303","Specialty, Stage & Studio Bulbs  60 watt","Accounts Receivable",NA,40.95,-25412.3
"2944","Revenue","Invoice","2018-01-31","71059","Godwin Lighting Depot:Store #303","Fluorescent Lamp, T-12, Medium Bipin  (30pack)","Accounts Receivable",NA,13.5,-25425.8
"2945","Revenue","Invoice","2018-01-31","71059","Godwin Lighting Depot:Store #303","Domes, White, 59x21x6 5/8 ht, 120v HPF","Accounts Receivable",NA,81,-25506.8
"2946","Revenue","Invoice","2018-02-01","71121","Kern Lighting Warehouse:Store #34","Brushed Nickel, Pendant, 1-100 watt Medium Base, Satin Etched Glass","Accounts Receivable",NA,550,-26056.8
"2947","Revenue","Invoice","2018-02-01","71121","Kern Lighting Warehouse:Store #34","Tapestry, (2-60 watt Med), Etched Cracked Glass, Finish 10","Accounts Receivable",NA,675,-26731.8
"2948","Revenue","Invoice","2018-02-01","71121","Kern Lighting Warehouse:Store #34","18x8x10, Solid Brass, 3-60watt Medium Base, Satin Etched Glass","Accounts Receivable",NA,1320,-28051.8
"2949","Revenue","Invoice","2018-02-01","71121","Kern Lighting Warehouse:Store #34","18x8x10, Solid Brass, 3-60watt Medium Base, Satin Etched Glass","Accounts Receivable",NA,1980,-30031.8
"2950","Revenue","Invoice","2018-02-01","71121","Kern Lighting Warehouse:Store #34","Solid Brass, 4-light, 25x13x10.75, 4-60 watt, Medium Base, Satin Etched Glass","Accounts Receivable",NA,1260,-31291.8
"2951","Revenue","Invoice","2018-02-01","71121","Kern Lighting Warehouse:Store #34","White, 4.5x7.5, 1-100 watt Medium Base, Satin White Glass","Accounts Receivable",NA,960,-32251.8
"2952","Revenue","Invoice","2018-02-10","71051","Cole Home Builders:Phase 2 - Lot 5","Specialty Bulbs, 100 watt (6 pack)","Accounts Receivable",NA,132,-32383.8
"2953","Revenue","Invoice","2018-02-10","71051","Cole Home Builders:Phase 2 - Lot 5","Cand. Light, 20 watts (8 pack)","Accounts Receivable",NA,112,-32495.8
"2954","Revenue","Invoice","2018-02-10","71051","Cole Home Builders:Phase 2 - Lot 5","Golden Umber (100 watt)  Six Light Chandelier","Accounts Receivable",NA,1890,-34385.8
"2955","Revenue","Invoice","2018-02-10","71051","Cole Home Builders:Phase 2 - Lot 5","Acid Verde, 10x21x10, 2-60 watt cand.","Accounts Receivable",NA,340,-34725.8
"2956","Revenue","Invoice","2018-02-10","71051","Cole Home Builders:Phase 2 - Lot 5","18x8x10, Solid Brass, 3-60watt Medium Base, Satin Etched Glass","Accounts Receivable",NA,990,-35715.8
"2957","Revenue","Invoice","2018-02-10","71051","Cole Home Builders:Phase 2 - Lot 5","Athena Collection, (100 watt max) Copper Verde, Seeded Glass","Accounts Receivable",NA,900,-36615.8
"2958","Revenue","Invoice","2018-02-11","71112","Thompson Lighting Stores:Store #15","Acid Verde, 10x21x10, 2-60 watt cand.","Accounts Receivable",NA,348,-36963.8
"2959","Revenue","Invoice","2018-02-11","71112","Thompson Lighting Stores:Store #15","Die Cast Lanterns, Black, 1-100 watt, Medium Base, Clear Cracked Glass","Accounts Receivable",NA,272,-37235.8
"2960","Revenue","Invoice","2018-02-11","71112","Thompson Lighting Stores:Store #15","Polished Brass Pendant, 1-100 watt Medium Base, Clear Ribbed Glass","Accounts Receivable",NA,232,-37467.8
"2961","Revenue","Invoice","2018-02-11","71112","Thompson Lighting Stores:Store #15","2032 Series, (3-60 watt, Med) Desert Stone Finish","Accounts Receivable",NA,88,-37555.8
"2962","Revenue","Invoice","2018-02-11","71112","Thompson Lighting Stores:Store #15","Brushed Nickel, 18x7.75x6, 3-60 watt Medium Base, Satin Opal Glass","Accounts Receivable",NA,100,-37655.8
"2963","Revenue","Invoice","2018-02-11","71112","Thompson Lighting Stores:Store #15","Tapestry (8/60 watt)  Faux Alabaster Glass","Accounts Receivable",NA,300,-37955.8
"2964","Revenue","Invoice","2018-02-11","71112","Thompson Lighting Stores:Store #15","Frosted Taupe (3/60 watt)  Marble Glass  ","Accounts Receivable",NA,310,-38265.8
"2965","Revenue","Invoice","2018-02-11","71112","Thompson Lighting Stores:Store #15","Roman Bronze, 1-light Lantern, w/tail, (100 watt max)","Accounts Receivable",NA,340,-38605.8
"2966","Revenue","Invoice","2018-02-11","71112","Thompson Lighting Stores:Store #15","Domes, White, 59x21x6 5/8 ht, 120v HPF","Accounts Receivable",NA,135,-38740.8
"2967","Revenue","Invoice","2018-02-11","71112","Thompson Lighting Stores:Store #15","Flat Glass, (25 watt max) Polished Brass, 4 light","Accounts Receivable",NA,125,-38865.8
"2968","Revenue","Invoice","2018-02-11","71112","Thompson Lighting Stores:Store #15","Burnished Brass (60 watt)  w/Golden Umber Accents","Accounts Receivable",NA,300,-39165.8
"2969","Revenue","Invoice","2018-02-11","71112","Thompson Lighting Stores:Store #15","Pearl Nickle, 5 Light, Medium Base (100 watt max)","Accounts Receivable",NA,475,-39640.8
"2970","Revenue","Invoice","2018-02-12","71088","Cole Home Builders:Phase 1 - Lot 2","Die Cast Lanterns, Black, 1-100 watt, Medium Base, Clear Cracked Glass","Accounts Receivable",NA,367.2,-40008
"2971","Revenue","Invoice","2018-02-12","71088","Cole Home Builders:Phase 1 - Lot 2","Tapestry, (2-60 watt Med), Etched Cracked Glass, Finish 10","Accounts Receivable",NA,243,-40251
"2972","Revenue","Invoice","2018-02-12","71088","Cole Home Builders:Phase 1 - Lot 2","Pearl Nickle, 5 Light, Medium Base (100 watt max)","Accounts Receivable",NA,342,-40593
"2973","Revenue","Invoice","2018-02-12","71088","Cole Home Builders:Phase 1 - Lot 2","Sunset, Clear Glass, 1-100 watt max.","Accounts Receivable",NA,126,-40719
"2974","Revenue","Invoice","2018-02-12","71088","Cole Home Builders:Phase 1 - Lot 2","Black Finish, Solid Brass, Clear Glass, Hanging, 2-60 watt max.","Accounts Receivable",NA,113.4,-40832.4
"2975","Revenue","Invoice","2018-02-12","71088","Cole Home Builders:Phase 1 - Lot 2","Burnished Brass (60 watt)  w/Golden Umber Accents","Accounts Receivable",NA,270,-41102.4
"2976","Revenue","Invoice","2018-02-12","71088","Cole Home Builders:Phase 1 - Lot 2","Chestnut (3/60 watt)  Marble Glass","Accounts Receivable",NA,292.5,-41394.9
"2977","Revenue","Invoice","2018-02-12","71088","Cole Home Builders:Phase 1 - Lot 2","Pendant Bar, Textured White, 50lbs max","Accounts Receivable",NA,22.5,-41417.4
"2978","Revenue","Invoice","2018-02-12","71088","Cole Home Builders:Phase 1 - Lot 2","Athena Collection, (100 watt max) Copper Verde, Seeded Glass","Accounts Receivable",NA,81,-41498.4
"2979","Revenue","Invoice","2018-02-12","71088","Cole Home Builders:Phase 1 - Lot 2","Cand. Light, 20 watts (8 pack)","Accounts Receivable",NA,50.4,-41548.8
"2980","Revenue","Invoice","2018-02-12","71088","Cole Home Builders:Phase 1 - Lot 2","Fluorescent Lamp, T-12, Medium Bipin  (30pack)","Accounts Receivable",NA,13.5,-41562.3
"2981","Revenue","Invoice","2018-02-12","71088","Cole Home Builders:Phase 1 - Lot 2","Fluorescent Lamp, T-5, Bipin","Accounts Receivable",NA,18,-41580.3
"2982","Revenue","Invoice","2018-02-12","71088","Cole Home Builders:Phase 1 - Lot 2","Halogen Lamp, Volts:3.5  Tubular","Accounts Receivable",NA,4.95,-41585.25
"2983","Revenue","Invoice","2018-02-12","71088","Cole Home Builders:Phase 1 - Lot 2","Specialty Bulbs, 100 watt (6 pack)","Accounts Receivable",NA,19.8,-41605.05
"2984","Revenue","Invoice","2018-02-12","71088","Cole Home Builders:Phase 1 - Lot 2","Specialty, Stage & Studio Bulbs  60 watt","Accounts Receivable",NA,46.8,-41651.85
"2985","Revenue","Invoice","2018-02-12","71088","Cole Home Builders:Phase 1 - Lot 2","Flat Glass, (25 watt max) Polished Brass, 4 light","Accounts Receivable",NA,90,-41741.85
"2986","Revenue","Invoice","2018-02-12","71088","Cole Home Builders:Phase 1 - Lot 2","Beveled Mirror, Etched Ribbed Glass (75 watt max)","Accounts Receivable",NA,86.4,-41828.25
"2987","Revenue","Invoice","2018-02-14","71110","Baker's Professional Lighting:Store #05","River Rock (8/60 watt)  Faux Alabaster Glass","Accounts Receivable",NA,600,-42428.25
"2988","Revenue","Invoice","2018-02-14","71110","Baker's Professional Lighting:Store #05","Chestnut (3/60 watt)  Marble Glass","Accounts Receivable",NA,325,-42753.25
"2989","Revenue","Invoice","2018-02-14","71110","Baker's Professional Lighting:Store #05","Roman Bronze, 1-light Lantern, w/tail, (100 watt max)","Accounts Receivable",NA,850,-43603.25
"2990","Revenue","Invoice","2018-02-14","71110","Baker's Professional Lighting:Store #05","Broadway Collection, Polished Brass, 6 Light (60 watt max)","Accounts Receivable",NA,144,-43747.25
"2991","Revenue","Invoice","2018-02-14","71110","Baker's Professional Lighting:Store #05","Pearl Nickle, 5 Light, Medium Base (100 watt max)","Accounts Receivable",NA,190,-43937.25
"2992","Revenue","Invoice","2018-02-14","71110","Baker's Professional Lighting:Store #05","Polished Brass Pendant, 1-100 watt Medium Base, Clear Ribbed Glass","Accounts Receivable",NA,232,-44169.25
"2993","Revenue","Invoice","2018-02-14","71110","Baker's Professional Lighting:Store #05","Pendant Bar, Cobblestone, 50lbs. max","Accounts Receivable",NA,50,-44219.25
"2994","Revenue","Invoice","2018-02-18","71093","Miscellaneous - Retail:Ruth Kuver","Chestnut (3/60 watt)  Marble Glass","Accounts Receivable",NA,650,-44869.25
"2995","Revenue","Invoice","2018-02-18","71093","Miscellaneous - Retail:Ruth Kuver","Verona Collection, Pendant, Cobblestone, Etched Alabaster Glass, 150 watt max","Accounts Receivable",NA,450,-45319.25
"2996","Revenue","Invoice","2018-02-18","71093","Miscellaneous - Retail:Ruth Kuver","Pendant Bar, Cobblestone, 50lbs. max","Accounts Receivable",NA,50,-45369.25
"2997","Revenue","Invoice","2018-02-18","71093","Miscellaneous - Retail:Ruth Kuver","Broadway Collection, Polished Brass, 6 Light (60 watt max)","Accounts Receivable",NA,216,-45585.25
"2998","Revenue","Invoice","2018-02-20","71054","Miscellaneous - Retail:Mrs. Chris Holly","Vianne Lanterns, Satin Antiqued Solid Brass, 3-light wall latern, Candelabra base (60 watt max)","Accounts Receivable",NA,500,-46085.25
"2999","Revenue","Invoice","2018-02-20","71054","Miscellaneous - Retail:Mrs. Chris Holly","White, 4.5x7.5, 1-100 watt Medium Base, Satin White Glass","Accounts Receivable",NA,96,-46181.25
"3000","Revenue","Invoice","2018-02-20","71054","Miscellaneous - Retail:Mrs. Chris Holly","Frosted Taupe (3/60 watt)  Marble Glass  ","Accounts Receivable",NA,310,-46491.25
"3001","Revenue","Invoice","2018-02-20","71054","Miscellaneous - Retail:Mrs. Chris Holly","Athena Collection, Pendant, Textured White, Med. Base, 100 watt max.","Accounts Receivable",NA,260,-46751.25
"3002","Revenue","Invoice","2018-02-20","71054","Miscellaneous - Retail:Mrs. Chris Holly","Pendant Bar, Cobblestone, 50lbs. max","Accounts Receivable",NA,50,-46801.25
"3003","Revenue","Invoice","2018-02-20","71054","Miscellaneous - Retail:Mrs. Chris Holly","Drop Opal w/Solid Oak Frame, 49 1/2 x 17, 120v HPF","Accounts Receivable",NA,84,-46885.25
"3004","Revenue","Invoice","2018-02-23","71094","Miscellaneous - Retail:David Lo","Domes, White, 59x21x6 5/8 ht, 120v HPF","Accounts Receivable",NA,450,-47335.25
"3005","Revenue","Invoice","2018-02-23","71094","Miscellaneous - Retail:David Lo","Tiffany Collection,Golden Baroque, 1-light lantern, medium base (100 watt max)","Accounts Receivable",NA,510,-47845.25
"3006","Revenue","Invoice","2018-02-23","71094","Miscellaneous - Retail:David Lo","Chestnut (3/60 watt)  Marble Glass","Accounts Receivable",NA,650,-48495.25
"3007","Revenue","Invoice","2018-02-23","71094","Miscellaneous - Retail:David Lo","Pearl Nickle, 5 Light, Medium Base (100 watt max)","Accounts Receivable",NA,190,-48685.25
"3008","Revenue","Invoice","2018-02-23","71094","Miscellaneous - Retail:David Lo","18x8x10, Solid Brass, 3-60watt Medium Base, Satin Etched Glass","Accounts Receivable",NA,132,-48817.25
"3009","Revenue","Invoice","2018-02-27","71052","Baker's Professional Lighting:Store #15","Acid Verde, 10x21x10, 2-60 watt cand.","Accounts Receivable",NA,272,-49089.25
"3010","Revenue","Invoice","2018-02-27","71052","Baker's Professional Lighting:Store #15","Polished Brass Pendant, 1-100 watt Medium Base, Clear Ribbed Glass","Accounts Receivable",NA,210,-49299.25
"3011","Revenue","Invoice","2018-02-27","71052","Baker's Professional Lighting:Store #15","River Rock (8/60 watt)  Faux Alabaster Glass","Accounts Receivable",NA,600,-49899.25
"3012","Revenue","Invoice","2018-02-27","71052","Baker's Professional Lighting:Store #15","Brushed Nickel, 18x7.75x6, 3-60 watt Medium Base, Satin Opal Glass","Accounts Receivable",NA,120,-50019.25
"3013","Revenue","Invoice","2018-02-27","71052","Baker's Professional Lighting:Store #15","Halogen Lamp, 20 watts, Luminous Intensity","Accounts Receivable",NA,12,-50031.25
"3014","Revenue","Invoice","2018-02-27","71052","Baker's Professional Lighting:Store #15","Specialty, Stage & Studio Bulbs  60 watt","Accounts Receivable",NA,26,-50057.25
"3015","Revenue","Invoice","2018-02-27","71052","Baker's Professional Lighting:Store #15","2032 Series, (3-60 watt, Med) Desert Stone Finish","Accounts Receivable",NA,210,-50267.25
"3016","Revenue","Invoice","2018-02-27","71052","Baker's Professional Lighting:Store #15","Tapestry (8/60 watt)  Faux Alabaster Glass","Accounts Receivable",NA,300,-50567.25
"3017","Revenue","Invoice","2018-02-27","71052","Baker's Professional Lighting:Store #15","Drop Opal w/Solid Oak Frame, 49 1/2 x 17, 120v HPF","Accounts Receivable",NA,126,-50693.25
"3018","Revenue","Invoice","2018-02-27","71052","Baker's Professional Lighting:Store #15","Fluorescent Lamp, T-5, Bipin","Accounts Receivable",NA,9,-50702.25
"3019","Revenue","Invoice","2018-02-28","71122","Lavery Lighting & Design:Store #JL-08","Custom Chandelier","Accounts Receivable",NA,600,-51302.25
"3020","Revenue","Invoice","2018-03-11","71048","Baker's Professional Lighting:Store #20","Die Cast Lanterns, Black, 1-100 watt, Medium Base, Clear Cracked Glass","Accounts Receivable",NA,430,-51732.25
"3021","Revenue","Invoice","2018-03-11","71048","Baker's Professional Lighting:Store #20","Polished Brass Pendant, 1-100 watt Medium Base, Clear Ribbed Glass","Accounts Receivable",NA,490,-52222.25
"3022","Revenue","Invoice","2018-03-11","71048","Baker's Professional Lighting:Store #20","Golden Umber (100 watt)  Six Light Chandelier","Accounts Receivable",NA,630,-52852.25
"3023","Revenue","Invoice","2018-03-11","71048","Baker's Professional Lighting:Store #20","Pendant Bar, Cobblestone, 50lbs. max","Accounts Receivable",NA,25,-52877.25
"3024","Revenue","Invoice","2018-03-11","71048","Baker's Professional Lighting:Store #20","Broadway Collection, Polished Brass, 6 Light (60 watt max)","Accounts Receivable",NA,216,-53093.25
"3025","Revenue","Invoice","2018-03-11","71048","Baker's Professional Lighting:Store #20","Black Finish, Solid Brass, Clear Glass, Hanging, 2-60 watt max.","Accounts Receivable",NA,42,-53135.25
"3026","Revenue","Invoice","2018-03-11","71048","Baker's Professional Lighting:Store #20","Cand. Light, 20 watts (8 pack)","Accounts Receivable",NA,28,-53163.25
"3027","Revenue","Invoice","2018-03-11","71048","Baker's Professional Lighting:Store #20","Specialty Bulbs, 100 watt (6 pack)","Accounts Receivable",NA,11,-53174.25
"3028","Revenue","Invoice","2018-03-12","71049","Lavery Lighting & Design:Store #JL-06","Tapestry, (2-60 watt Med), Etched Cracked Glass, Finish 10","Accounts Receivable",NA,225,-53399.25
"3029","Revenue","Invoice","2018-03-12","71049","Lavery Lighting & Design:Store #JL-06","Frosted Taupe (3/60 watt)  Marble Glass  ","Accounts Receivable",NA,1860,-55259.25
"3030","Revenue","Invoice","2018-03-12","71049","Lavery Lighting & Design:Store #JL-06","Brushed Nickel, (3-60 watt, Med) Ribbed Glass","Accounts Receivable",NA,400,-55659.25
"3031","Revenue","Invoice","2018-03-12","71049","Lavery Lighting & Design:Store #JL-06","Vianne Lanterns, Satin Antiqued Solid Brass, 3-light wall latern, Candelabra base (60 watt max)","Accounts Receivable",NA,1000,-56659.25
"3032","Revenue","Invoice","2018-03-12","71049","Lavery Lighting & Design:Store #JL-06","Athena Collection, Pendant, Textured White, Med. Base, 100 watt max.","Accounts Receivable",NA,780,-57439.25
"3033","Revenue","Invoice","2018-03-12","71049","Lavery Lighting & Design:Store #JL-06","Pendant Bar, Textured White, 50lbs max","Accounts Receivable",NA,100,-57539.25
"3034","Revenue","Invoice","2018-03-12","71049","Lavery Lighting & Design:Store #JL-06","Sunset, Clear Glass, 1-100 watt max.","Accounts Receivable",NA,210,-57749.25
"3035","Revenue","Invoice","2018-03-12","71049","Lavery Lighting & Design:Store #JL-06","Specialty, Stage & Studio Bulbs  60 watt","Accounts Receivable",NA,97.5,-57846.75
"3036","Revenue","Invoice","2018-03-12","71049","Lavery Lighting & Design:Store #JL-06","Specialty Bulbs, 100 watt (6 pack)","Accounts Receivable",NA,22,-57868.75
"3037","Revenue","Invoice","2018-03-15","71056","Miscellaneous - Retail:Mr. Fred Kaseman","Die Cast Lanterns, Black, 1-100 watt, Medium Base, Clear Cracked Glass","Accounts Receivable",NA,430,-58298.75
"3038","Revenue","Invoice","2018-03-15","71056","Miscellaneous - Retail:Mr. Fred Kaseman","Black Finish, Solid Brass, Hanging w/Clear Glass (2x60watt max)","Accounts Receivable",NA,255,-58553.75
"3039","Revenue","Invoice","2018-03-15","71056","Miscellaneous - Retail:Mr. Fred Kaseman","Verona Collection, Pendant, Cobblestone, Etched Alabaster Glass, 150 watt max","Accounts Receivable",NA,600,-59153.75
"3040","Revenue","Invoice","2018-03-15","71056","Miscellaneous - Retail:Mr. Fred Kaseman","Pendant Bar, Cobblestone, 50lbs. max","Accounts Receivable",NA,100,-59253.75
"3041","Revenue","Invoice","2018-03-15","71056","Miscellaneous - Retail:Mr. Fred Kaseman","Frosted Taupe (3/60 watt)  Marble Glass  ","Accounts Receivable",NA,620,-59873.75
"3042","Revenue","Invoice","2018-03-15","71056","Miscellaneous - Retail:Mr. Fred Kaseman","Broadway Collection, Polished Brass, 6 Light (60 watt max)","Accounts Receivable",NA,216,-60089.75
"3043","Revenue","Invoice","2018-03-26","71065","Godwin Lighting Depot:Store #303","Vianne Lanterns, Satin Antiqued Solid Brass, 3-light wall latern, Candelabra base (60 watt max)","Accounts Receivable",NA,360,-60449.75
"3044","Revenue","Invoice","2018-03-26","71065","Godwin Lighting Depot:Store #303","Renaissance Collection, (100 watt max) Millstone Finish, One-light","Accounts Receivable",NA,324,-60773.75
"3045","Revenue","Invoice","2018-03-26","71065","Godwin Lighting Depot:Store #303","Drop Opal w/Solid Oak Frame, 49 1/2 x 17, 120v HPF","Accounts Receivable",NA,75.6,-60849.35
"3046","Revenue","Invoice","2018-03-26","71065","Godwin Lighting Depot:Store #303","Beveled Mirror, Etched Ribbed Glass (75 watt max)","Accounts Receivable",NA,129.6,-60978.95
"3047","Revenue","Invoice","2018-03-26","71065","Godwin Lighting Depot:Store #303","Chestnut (3/60 watt)  Marble Glass","Accounts Receivable",NA,585,-61563.95
"3048","Revenue","Invoice","2018-03-26","71065","Godwin Lighting Depot:Store #303","2032 Series, (3-60 watt, Med) Desert Stone Finish","Accounts Receivable",NA,99,-61662.95
"3049","Revenue","Invoice","2018-03-26","71065","Godwin Lighting Depot:Store #303","Pearl Nickle, 5 Light, Medium Base (100 watt max)","Accounts Receivable",NA,171,-61833.95
"3050","Revenue","Invoice","2018-03-26","71065","Godwin Lighting Depot:Store #303","Verona Collection, Pendant, Cobblestone, Etched Alabaster Glass, 150 watt max","Accounts Receivable",NA,540,-62373.95
"3051","Revenue","Invoice","2018-03-26","71065","Godwin Lighting Depot:Store #303","Pendant Bar, Cobblestone, 50lbs. max","Accounts Receivable",NA,90,-62463.95
"3052","Revenue","Invoice","2018-03-26","71065","Godwin Lighting Depot:Store #303","Cand. Light, 20 watts (8 pack)","Accounts Receivable",NA,75.6,-62539.55
"3053","Revenue","Invoice","2018-03-26","71065","Godwin Lighting Depot:Store #303","Fluorescent Lamp, T-12, Medium Bipin  (30pack)","Accounts Receivable",NA,13.5,-62553.05
"3054","Revenue","Invoice","2018-03-26","71065","Godwin Lighting Depot:Store #303","Halogen Lamp, 20 watts, Luminous Intensity","Accounts Receivable",NA,43.2,-62596.25
"3055","Revenue","Invoice","2018-03-26","71065","Godwin Lighting Depot:Store #303","Specialty Bulbs, 100 watt (6 pack)","Accounts Receivable",NA,19.8,-62616.05
"3056","Revenue","Invoice","2018-03-26","71065","Godwin Lighting Depot:Store #303","Specialty, Stage & Studio Bulbs  60 watt","Accounts Receivable",NA,52.65,-62668.7
"3057","Revenue","Invoice","2018-03-27","71060","Godwin Lighting Depot:Store #404","Black Finish, Solid Brass, Clear Glass, Hanging, 2-60 watt max.","Accounts Receivable",NA,113.4,-62782.1
"3058","Revenue","Invoice","2018-03-27","71060","Godwin Lighting Depot:Store #404","Black Finish, Solid Brass,Wall Mount w/Clear Glass (2x60watt max)","Accounts Receivable",NA,337.5,-63119.6
"3059","Revenue","Invoice","2018-03-27","71060","Godwin Lighting Depot:Store #404","Tapestry (8/60 watt)  Faux Alabaster Glass","Accounts Receivable",NA,540,-63659.6
"3060","Revenue","Invoice","2018-03-27","71060","Godwin Lighting Depot:Store #404","Athena Collection, (100 watt max) Copper Verde, Seeded Glass","Accounts Receivable",NA,405,-64064.6
"3061","Revenue","Invoice","2018-03-27","71060","Godwin Lighting Depot:Store #404","Broadway Collection, Polished Chrome, 4 Light (60 watt max)","Accounts Receivable",NA,126.9,-64191.5
"3062","Revenue","Invoice","2018-03-27","71060","Godwin Lighting Depot:Store #404","Halogen Lamp, Volts:3.5  Tubular","Accounts Receivable",NA,9.9,-64201.4
"3063","Revenue","Invoice","2018-03-27","71060","Godwin Lighting Depot:Store #404","Specialty Bulbs, 100 watt (6 pack)","Accounts Receivable",NA,19.8,-64221.2
"3064","Revenue","Invoice","2018-03-27","71060","Godwin Lighting Depot:Store #404","Specialty, Stage & Studio Bulbs  60 watt","Accounts Receivable",NA,40.95,-64262.15
"3065","Revenue","Invoice","2018-03-27","71060","Godwin Lighting Depot:Store #404","Fluorescent Lamp, T-12, Medium Bipin  (30pack)","Accounts Receivable",NA,13.5,-64275.65
"3066","Revenue","Invoice","2018-03-27","71060","Godwin Lighting Depot:Store #404","Domes, White, 59x21x6 5/8 ht, 120v HPF","Accounts Receivable",NA,81,-64356.65
"3067","Revenue","Invoice","2018-03-28","71071","Dan A. North Builders:McCarthy Properties","Flat Glass, (25 watt max) Polished Brass, 4 light","Accounts Receivable",NA,1875,-66231.65
"3068","Revenue","Invoice","2018-03-28","71071","Dan A. North Builders:McCarthy Properties","Domes, White, 59x21x6 5/8 ht, 120v HPF","Accounts Receivable",NA,4500,-70731.65
"3069","Revenue","Invoice","2018-03-28","71071","Dan A. North Builders:McCarthy Properties","Flush Mount, Polished Brass (2, 13 watt)  White acrylic diffuser","Accounts Receivable",NA,850,-71581.65
"3070","Revenue","Invoice","2018-03-28","71071","Dan A. North Builders:McCarthy Properties","Halogen Lamp, Volts:3.5  Tubular","Accounts Receivable",NA,110,-71691.65
"3071","Revenue","Invoice","2018-03-28","71071","Dan A. North Builders:McCarthy Properties","Fluorescent Lamp, T-5, Bipin","Accounts Receivable",NA,100,-71791.65
"3072","Revenue","Invoice","2018-03-28","71071","Dan A. North Builders:McCarthy Properties","Fluorescent Lamp, T-12, Medium Bipin  (30pack)","Accounts Receivable",NA,150,-71941.65
"3073","Revenue","Invoice","2018-03-28","71071","Dan A. North Builders:McCarthy Properties","Drop Opal w/Solid Oak Frame, 49 1/2 x 17, 120v HPF","Accounts Receivable",NA,1344,-73285.65
"3074","Revenue","Invoice","2018-03-28","71125","Kern Lighting Warehouse:Store #45","Vianne Lanterns, Satin Antiqued Solid Brass, 3-light wall latern, Candelabra base (60 watt max)","Accounts Receivable",NA,2900,-76185.65
"3075","Revenue","Invoice","2018-03-28","71125","Kern Lighting Warehouse:Store #45","Cand. Light, 20 watts (8 pack)","Accounts Receivable",NA,5600,-81785.65
"3076","Revenue","Invoice","2018-04-10","71057","Miscellaneous - Retail:Mr. Jay Jessen","Chestnut (3/60 watt)  Marble Glass","Accounts Receivable",NA,975,-82760.65
"3077","Revenue","Invoice","2018-04-10","71057","Miscellaneous - Retail:Mr. Jay Jessen","Domes, White, 59x21x6 5/8 ht, 120v HPF","Accounts Receivable",NA,180,-82940.65
"3078","Revenue","Invoice","2018-04-10","71057","Miscellaneous - Retail:Mr. Jay Jessen","Drop Opal w/Solid Oak Frame, 49 1/2 x 17, 120v HPF","Accounts Receivable",NA,84,-83024.65
"3079","Revenue","Invoice","2018-04-13","71126","Kern Lighting Warehouse:Store #13","Golden Umber (100 watt)  Six Light Chandelier","Accounts Receivable",NA,12600,-95624.65
"3080","Revenue","Invoice","2018-04-16","71087","Cole Home Builders:Phase 1 - Lot 5","Die Cast Lanterns, Black, 1-100 watt, Medium Base, Clear Cracked Glass","Accounts Receivable",NA,367.2,-95991.85
"3081","Revenue","Invoice","2018-04-16","71087","Cole Home Builders:Phase 1 - Lot 5","Tapestry, (2-60 watt Med), Etched Cracked Glass, Finish 10","Accounts Receivable",NA,243,-96234.85
"3082","Revenue","Invoice","2018-04-16","71087","Cole Home Builders:Phase 1 - Lot 5","Pearl Nickle, 5 Light, Medium Base (100 watt max)","Accounts Receivable",NA,342,-96576.85
"3083","Revenue","Invoice","2018-04-16","71087","Cole Home Builders:Phase 1 - Lot 5","Sunset, Clear Glass, 1-100 watt max.","Accounts Receivable",NA,126,-96702.85
"3084","Revenue","Invoice","2018-04-16","71087","Cole Home Builders:Phase 1 - Lot 5","Black Finish, Solid Brass, Clear Glass, Hanging, 2-60 watt max.","Accounts Receivable",NA,113.4,-96816.25
"3085","Revenue","Invoice","2018-04-16","71087","Cole Home Builders:Phase 1 - Lot 5","Burnished Brass (60 watt)  w/Golden Umber Accents","Accounts Receivable",NA,270,-97086.25
"3086","Revenue","Invoice","2018-04-16","71087","Cole Home Builders:Phase 1 - Lot 5","Chestnut (3/60 watt)  Marble Glass","Accounts Receivable",NA,292.5,-97378.75
"3087","Revenue","Invoice","2018-04-16","71087","Cole Home Builders:Phase 1 - Lot 5","Pendant Bar, Textured White, 50lbs max","Accounts Receivable",NA,22.5,-97401.25
"3088","Revenue","Invoice","2018-04-16","71087","Cole Home Builders:Phase 1 - Lot 5","Athena Collection, (100 watt max) Copper Verde, Seeded Glass","Accounts Receivable",NA,81,-97482.25
"3089","Revenue","Invoice","2018-04-16","71087","Cole Home Builders:Phase 1 - Lot 5","Cand. Light, 20 watts (8 pack)","Accounts Receivable",NA,50.4,-97532.65
"3090","Revenue","Invoice","2018-04-16","71087","Cole Home Builders:Phase 1 - Lot 5","Fluorescent Lamp, T-12, Medium Bipin  (30pack)","Accounts Receivable",NA,13.5,-97546.15
"3091","Revenue","Invoice","2018-04-16","71087","Cole Home Builders:Phase 1 - Lot 5","Fluorescent Lamp, T-5, Bipin","Accounts Receivable",NA,18,-97564.15
"3092","Revenue","Invoice","2018-04-16","71087","Cole Home Builders:Phase 1 - Lot 5","Halogen Lamp, Volts:3.5  Tubular","Accounts Receivable",NA,4.95,-97569.1
"3093","Revenue","Invoice","2018-04-16","71087","Cole Home Builders:Phase 1 - Lot 5","Specialty Bulbs, 100 watt (6 pack)","Accounts Receivable",NA,19.8,-97588.9
"3094","Revenue","Invoice","2018-04-16","71087","Cole Home Builders:Phase 1 - Lot 5","Specialty, Stage & Studio Bulbs  60 watt","Accounts Receivable",NA,46.8,-97635.7
"3095","Revenue","Invoice","2018-04-16","71087","Cole Home Builders:Phase 1 - Lot 5","Flat Glass, (25 watt max) Polished Brass, 4 light","Accounts Receivable",NA,90,-97725.7
"3096","Revenue","Invoice","2018-04-16","71087","Cole Home Builders:Phase 1 - Lot 5","Beveled Mirror, Etched Ribbed Glass (75 watt max)","Accounts Receivable",NA,86.4,-97812.1
"3097","Revenue","Invoice","2018-04-17","71061","Godwin Lighting Depot:Store #202","Black Finish, Solid Brass, Clear Glass, Hanging, 2-60 watt max.","Accounts Receivable",NA,113.4,-97925.5
"3098","Revenue","Invoice","2018-04-17","71061","Godwin Lighting Depot:Store #202","Black Finish, Solid Brass,Wall Mount w/Clear Glass (2x60watt max)","Accounts Receivable",NA,337.5,-98263
"3099","Revenue","Invoice","2018-04-17","71061","Godwin Lighting Depot:Store #202","Tapestry (8/60 watt)  Faux Alabaster Glass","Accounts Receivable",NA,540,-98803
"3100","Revenue","Invoice","2018-04-17","71061","Godwin Lighting Depot:Store #202","Athena Collection, (100 watt max) Copper Verde, Seeded Glass","Accounts Receivable",NA,405,-99208
"3101","Revenue","Invoice","2018-04-17","71061","Godwin Lighting Depot:Store #202","Broadway Collection, Polished Chrome, 4 Light (60 watt max)","Accounts Receivable",NA,126.9,-99334.9
"3102","Revenue","Invoice","2018-04-17","71061","Godwin Lighting Depot:Store #202","Halogen Lamp, Volts:3.5  Tubular","Accounts Receivable",NA,9.9,-99344.8
"3103","Revenue","Invoice","2018-04-17","71061","Godwin Lighting Depot:Store #202","Specialty Bulbs, 100 watt (6 pack)","Accounts Receivable",NA,19.8,-99364.6
"3104","Revenue","Invoice","2018-04-17","71061","Godwin Lighting Depot:Store #202","Specialty, Stage & Studio Bulbs  60 watt","Accounts Receivable",NA,40.95,-99405.55
"3105","Revenue","Invoice","2018-04-17","71061","Godwin Lighting Depot:Store #202","Fluorescent Lamp, T-12, Medium Bipin  (30pack)","Accounts Receivable",NA,13.5,-99419.05
"3106","Revenue","Invoice","2018-04-17","71061","Godwin Lighting Depot:Store #202","Domes, White, 59x21x6 5/8 ht, 120v HPF","Accounts Receivable",NA,81,-99500.05
"3107","Revenue","Invoice","2018-04-22","71064","Godwin Lighting Depot:Store #404","Vianne Lanterns, Satin Antiqued Solid Brass, 3-light wall latern, Candelabra base (60 watt max)","Accounts Receivable",NA,360,-99860.05
"3108","Revenue","Invoice","2018-04-22","71064","Godwin Lighting Depot:Store #404","Renaissance Collection, (100 watt max) Millstone Finish, One-light","Accounts Receivable",NA,324,-100184.05
"3109","Revenue","Invoice","2018-04-22","71064","Godwin Lighting Depot:Store #404","Drop Opal w/Solid Oak Frame, 49 1/2 x 17, 120v HPF","Accounts Receivable",NA,75.6,-100259.65
"3110","Revenue","Invoice","2018-04-22","71064","Godwin Lighting Depot:Store #404","Beveled Mirror, Etched Ribbed Glass (75 watt max)","Accounts Receivable",NA,129.6,-100389.25
"3111","Revenue","Invoice","2018-04-22","71064","Godwin Lighting Depot:Store #404","Chestnut (3/60 watt)  Marble Glass","Accounts Receivable",NA,585,-100974.25
"3112","Revenue","Invoice","2018-04-22","71064","Godwin Lighting Depot:Store #404","2032 Series, (3-60 watt, Med) Desert Stone Finish","Accounts Receivable",NA,99,-101073.25
"3113","Revenue","Invoice","2018-04-22","71064","Godwin Lighting Depot:Store #404","Pearl Nickle, 5 Light, Medium Base (100 watt max)","Accounts Receivable",NA,171,-101244.25
"3114","Revenue","Invoice","2018-04-22","71064","Godwin Lighting Depot:Store #404","Verona Collection, Pendant, Cobblestone, Etched Alabaster Glass, 150 watt max","Accounts Receivable",NA,540,-101784.25
"3115","Revenue","Invoice","2018-04-22","71064","Godwin Lighting Depot:Store #404","Pendant Bar, Cobblestone, 50lbs. max","Accounts Receivable",NA,90,-101874.25
"3116","Revenue","Invoice","2018-04-22","71064","Godwin Lighting Depot:Store #404","Cand. Light, 20 watts (8 pack)","Accounts Receivable",NA,75.6,-101949.85
"3117","Revenue","Invoice","2018-04-22","71064","Godwin Lighting Depot:Store #404","Fluorescent Lamp, T-12, Medium Bipin  (30pack)","Accounts Receivable",NA,13.5,-101963.35
"3118","Revenue","Invoice","2018-04-22","71064","Godwin Lighting Depot:Store #404","Halogen Lamp, 20 watts, Luminous Intensity","Accounts Receivable",NA,43.2,-102006.55
"3119","Revenue","Invoice","2018-04-22","71064","Godwin Lighting Depot:Store #404","Specialty Bulbs, 100 watt (6 pack)","Accounts Receivable",NA,19.8,-102026.35
"3120","Revenue","Invoice","2018-04-22","71064","Godwin Lighting Depot:Store #404","Specialty, Stage & Studio Bulbs  60 watt","Accounts Receivable",NA,52.65,-102079
"3121","Revenue","Invoice","2018-04-25","71058","Miscellaneous - Retail:Mrs. Anne Hemp","River Rock (8/60 watt)  Faux Alabaster Glass","Accounts Receivable",NA,600,-102679
"3122","Revenue","Invoice","2018-04-25","71058","Miscellaneous - Retail:Mrs. Anne Hemp","Tiffany Collection,Golden Baroque, 1-light lantern, medium base (100 watt max)","Accounts Receivable",NA,408,-103087
"3123","Revenue","Invoice","2018-04-25","71058","Miscellaneous - Retail:Mrs. Anne Hemp","Brushed Nickel, Pendant, 1-100 watt Medium Base, Satin Etched Glass","Accounts Receivable",NA,220,-103307
"3124","Revenue","Invoice","2018-04-25","71058","Miscellaneous - Retail:Mrs. Anne Hemp","Pendant Bar, Textured White, 50lbs max","Accounts Receivable",NA,50,-103357
"3125","Revenue","Invoice","2018-04-25","71058","Miscellaneous - Retail:Mrs. Anne Hemp","Pearl Nickle, 5 Light, Medium Base (100 watt max)","Accounts Receivable",NA,285,-103642
"3126","Revenue","Invoice","2018-04-28","71066","Godwin Lighting Depot:Store #909","Vianne Lanterns, Satin Antiqued Solid Brass, 3-light wall latern, Candelabra base (60 watt max)","Accounts Receivable",NA,360,-104002
"3127","Revenue","Invoice","2018-04-28","71066","Godwin Lighting Depot:Store #909","Renaissance Collection, (100 watt max) Millstone Finish, One-light","Accounts Receivable",NA,324,-104326
"3128","Revenue","Invoice","2018-04-28","71066","Godwin Lighting Depot:Store #909","Drop Opal w/Solid Oak Frame, 49 1/2 x 17, 120v HPF","Accounts Receivable",NA,75.6,-104401.6
"3129","Revenue","Invoice","2018-04-28","71066","Godwin Lighting Depot:Store #909","Beveled Mirror, Etched Ribbed Glass (75 watt max)","Accounts Receivable",NA,129.6,-104531.2
"3130","Revenue","Invoice","2018-04-28","71066","Godwin Lighting Depot:Store #909","Chestnut (3/60 watt)  Marble Glass","Accounts Receivable",NA,585,-105116.2
"3131","Revenue","Invoice","2018-04-28","71066","Godwin Lighting Depot:Store #909","2032 Series, (3-60 watt, Med) Desert Stone Finish","Accounts Receivable",NA,99,-105215.2
"3132","Revenue","Invoice","2018-04-28","71066","Godwin Lighting Depot:Store #909","Pearl Nickle, 5 Light, Medium Base (100 watt max)","Accounts Receivable",NA,171,-105386.2
"3133","Revenue","Invoice","2018-04-28","71066","Godwin Lighting Depot:Store #909","Verona Collection, Pendant, Cobblestone, Etched Alabaster Glass, 150 watt max","Accounts Receivable",NA,540,-105926.2
"3134","Revenue","Invoice","2018-04-28","71066","Godwin Lighting Depot:Store #909","Pendant Bar, Cobblestone, 50lbs. max","Accounts Receivable",NA,90,-106016.2
"3135","Revenue","Invoice","2018-04-28","71066","Godwin Lighting Depot:Store #909","Cand. Light, 20 watts (8 pack)","Accounts Receivable",NA,75.6,-106091.8
"3136","Revenue","Invoice","2018-04-28","71066","Godwin Lighting Depot:Store #909","Fluorescent Lamp, T-12, Medium Bipin  (30pack)","Accounts Receivable",NA,13.5,-106105.3
"3137","Revenue","Invoice","2018-04-28","71066","Godwin Lighting Depot:Store #909","Halogen Lamp, 20 watts, Luminous Intensity","Accounts Receivable",NA,43.2,-106148.5
"3138","Revenue","Invoice","2018-04-28","71066","Godwin Lighting Depot:Store #909","Specialty Bulbs, 100 watt (6 pack)","Accounts Receivable",NA,19.8,-106168.3
"3139","Revenue","Invoice","2018-04-28","71066","Godwin Lighting Depot:Store #909","Specialty, Stage & Studio Bulbs  60 watt","Accounts Receivable",NA,52.65,-106220.95
"3140","Revenue","Invoice","2018-04-28","71067","Dan A. North Builders:Wagner Suites","Colonial, Brushed Steel Finish, Opal White Glass (60 watt)","Accounts Receivable",NA,2100,-108320.95
"3141","Revenue","Invoice","2018-04-28","71067","Dan A. North Builders:Wagner Suites","Beveled Mirror, Etched Ribbed Glass (75 watt max)","Accounts Receivable",NA,2400,-110720.95
"3142","Revenue","Invoice","2018-04-28","71067","Dan A. North Builders:Wagner Suites","Specialty, Stage & Studio Bulbs  60 watt","Accounts Receivable",NA,65,-110785.95
"3143","Revenue","Invoice","2018-04-28","71067","Dan A. North Builders:Wagner Suites","Specialty Bulbs, 100 watt (6 pack)","Accounts Receivable",NA,275,-111060.95
"3144","Revenue","Invoice","2018-04-28","71067","Dan A. North Builders:Wagner Suites","Flush Mount, Polished Brass (2, 13 watt)  White acrylic diffuser","Accounts Receivable",NA,2975,-114035.95
"3145","Revenue","Invoice","2018-04-28","71067","Dan A. North Builders:Wagner Suites","Fluorescent Lamp, T-12, Medium Bipin  (30pack)","Accounts Receivable",NA,75,-114110.95
"3146","Revenue","Invoice","2018-05-02","71062","Godwin Lighting Depot:Store #404","Black Finish, Solid Brass, Clear Glass, Hanging, 2-60 watt max.","Accounts Receivable",NA,113.4,-114224.35
"3147","Revenue","Invoice","2018-05-02","71062","Godwin Lighting Depot:Store #404","Black Finish, Solid Brass,Wall Mount w/Clear Glass (2x60watt max)","Accounts Receivable",NA,337.5,-114561.85
"3148","Revenue","Invoice","2018-05-02","71062","Godwin Lighting Depot:Store #404","Tapestry (8/60 watt)  Faux Alabaster Glass","Accounts Receivable",NA,540,-115101.85
"3149","Revenue","Invoice","2018-05-02","71062","Godwin Lighting Depot:Store #404","Athena Collection, (100 watt max) Copper Verde, Seeded Glass","Accounts Receivable",NA,405,-115506.85
"3150","Revenue","Invoice","2018-05-02","71062","Godwin Lighting Depot:Store #404","Broadway Collection, Polished Chrome, 4 Light (60 watt max)","Accounts Receivable",NA,126.9,-115633.75
"3151","Revenue","Invoice","2018-05-02","71062","Godwin Lighting Depot:Store #404","Halogen Lamp, Volts:3.5  Tubular","Accounts Receivable",NA,9.9,-115643.65
"3152","Revenue","Invoice","2018-05-02","71062","Godwin Lighting Depot:Store #404","Specialty Bulbs, 100 watt (6 pack)","Accounts Receivable",NA,19.8,-115663.45
"3153","Revenue","Invoice","2018-05-02","71062","Godwin Lighting Depot:Store #404","Specialty, Stage & Studio Bulbs  60 watt","Accounts Receivable",NA,40.95,-115704.4
"3154","Revenue","Invoice","2018-05-02","71062","Godwin Lighting Depot:Store #404","Fluorescent Lamp, T-12, Medium Bipin  (30pack)","Accounts Receivable",NA,13.5,-115717.9
"3155","Revenue","Invoice","2018-05-02","71062","Godwin Lighting Depot:Store #404","Domes, White, 59x21x6 5/8 ht, 120v HPF","Accounts Receivable",NA,81,-115798.9
"3156","Revenue","Invoice","2018-05-09","71111","Baker's Professional Lighting:Store #10","Acid Verde, 10x21x10, 2-60 watt cand.","Accounts Receivable",NA,464,-116262.9
"3157","Revenue","Invoice","2018-05-09","71111","Baker's Professional Lighting:Store #10","Beveled Mirror, Etched Ribbed Glass (75 watt max)","Accounts Receivable",NA,240,-116502.9
"3158","Revenue","Invoice","2018-05-09","71111","Baker's Professional Lighting:Store #10","Golden Umber (100 watt)  Six Light Chandelier","Accounts Receivable",NA,630,-117132.9
"3159","Revenue","Invoice","2018-05-09","71111","Baker's Professional Lighting:Store #10","Burnished Brass (60 watt)  w/Golden Umber Accents","Accounts Receivable",NA,600,-117732.9
"3160","Revenue","Invoice","2018-05-09","71111","Baker's Professional Lighting:Store #10","Specialty Bulbs, 100 watt (6 pack)","Accounts Receivable",NA,22,-117754.9
"3161","Revenue","Invoice","2018-05-09","71111","Baker's Professional Lighting:Store #10","Specialty, Stage & Studio Bulbs  60 watt","Accounts Receivable",NA,26,-117780.9
"3162","Revenue","Invoice","2018-05-09","71111","Baker's Professional Lighting:Store #10","Cand. Light, 20 watts (8 pack)","Accounts Receivable",NA,56,-117836.9
"3163","Revenue","Invoice","2018-05-10","71068","Godwin Lighting Depot:Store #909","Vianne Lanterns, Satin Antiqued Solid Brass, 3-light wall latern, Candelabra base (60 watt max)","Accounts Receivable",NA,360,-118196.9
"3164","Revenue","Invoice","2018-05-10","71068","Godwin Lighting Depot:Store #909","Renaissance Collection, (100 watt max) Millstone Finish, One-light","Accounts Receivable",NA,324,-118520.9
"3165","Revenue","Invoice","2018-05-10","71068","Godwin Lighting Depot:Store #909","Drop Opal w/Solid Oak Frame, 49 1/2 x 17, 120v HPF","Accounts Receivable",NA,75.6,-118596.5
"3166","Revenue","Invoice","2018-05-10","71068","Godwin Lighting Depot:Store #909","Beveled Mirror, Etched Ribbed Glass (75 watt max)","Accounts Receivable",NA,129.6,-118726.1
"3167","Revenue","Invoice","2018-05-10","71068","Godwin Lighting Depot:Store #909","Chestnut (3/60 watt)  Marble Glass","Accounts Receivable",NA,585,-119311.1
"3168","Revenue","Invoice","2018-05-10","71068","Godwin Lighting Depot:Store #909","2032 Series, (3-60 watt, Med) Desert Stone Finish","Accounts Receivable",NA,99,-119410.1
"3169","Revenue","Invoice","2018-05-10","71068","Godwin Lighting Depot:Store #909","Pearl Nickle, 5 Light, Medium Base (100 watt max)","Accounts Receivable",NA,171,-119581.1
"3170","Revenue","Invoice","2018-05-10","71068","Godwin Lighting Depot:Store #909","Verona Collection, Pendant, Cobblestone, Etched Alabaster Glass, 150 watt max","Accounts Receivable",NA,540,-120121.1
"3171","Revenue","Invoice","2018-05-10","71068","Godwin Lighting Depot:Store #909","Pendant Bar, Cobblestone, 50lbs. max","Accounts Receivable",NA,90,-120211.1
"3172","Revenue","Invoice","2018-05-10","71068","Godwin Lighting Depot:Store #909","Cand. Light, 20 watts (8 pack)","Accounts Receivable",NA,75.6,-120286.7
"3173","Revenue","Invoice","2018-05-10","71068","Godwin Lighting Depot:Store #909","Fluorescent Lamp, T-12, Medium Bipin  (30pack)","Accounts Receivable",NA,13.5,-120300.2
"3174","Revenue","Invoice","2018-05-10","71068","Godwin Lighting Depot:Store #909","Halogen Lamp, 20 watts, Luminous Intensity","Accounts Receivable",NA,43.2,-120343.4
"3175","Revenue","Invoice","2018-05-10","71068","Godwin Lighting Depot:Store #909","Specialty Bulbs, 100 watt (6 pack)","Accounts Receivable",NA,19.8,-120363.2
"3176","Revenue","Invoice","2018-05-10","71068","Godwin Lighting Depot:Store #909","Specialty, Stage & Studio Bulbs  60 watt","Accounts Receivable",NA,52.65,-120415.85
"3177","Revenue","Invoice","2018-05-16","71095","Miscellaneous - Retail:Carlos Nazar","Acid Verde, 10x21x10, 2-60 watt cand.","Accounts Receivable",NA,580,-120995.85
"3178","Revenue","Invoice","2018-05-16","71095","Miscellaneous - Retail:Carlos Nazar","Frosted Taupe (3/60 watt)  Marble Glass  ","Accounts Receivable",NA,620,-121615.85
"3179","Revenue","Invoice","2018-05-16","71095","Miscellaneous - Retail:Carlos Nazar","Black Finish, Solid Brass, Clear Glass, Hanging, 2-60 watt max.","Accounts Receivable",NA,168,-121783.85
"3180","Revenue","Invoice","2018-05-16","71095","Miscellaneous - Retail:Carlos Nazar","Beveled Mirror, Etched Ribbed Glass (75 watt max)","Accounts Receivable",NA,192,-121975.85
"3181","Revenue","Invoice","2018-05-16","71095","Miscellaneous - Retail:Carlos Nazar","Athena Collection, Pendant, Textured White, Med. Base, 100 watt max.","Accounts Receivable",NA,390,-122365.85
"3182","Revenue","Invoice","2018-05-16","71095","Miscellaneous - Retail:Carlos Nazar","Pendant Bar, Cobblestone, 50lbs. max","Accounts Receivable",NA,75,-122440.85
"3183","Revenue","Invoice","2018-05-16","71113","Thompson Lighting Stores:Store #20","Acid Verde, 10x21x10, 2-60 watt cand.","Accounts Receivable",NA,348,-122788.85
"3184","Revenue","Invoice","2018-05-16","71113","Thompson Lighting Stores:Store #20","Die Cast Lanterns, Black, 1-100 watt, Medium Base, Clear Cracked Glass","Accounts Receivable",NA,272,-123060.85
"3185","Revenue","Invoice","2018-05-16","71113","Thompson Lighting Stores:Store #20","Polished Brass Pendant, 1-100 watt Medium Base, Clear Ribbed Glass","Accounts Receivable",NA,232,-123292.85
"3186","Revenue","Invoice","2018-05-16","71113","Thompson Lighting Stores:Store #20","2032 Series, (3-60 watt, Med) Desert Stone Finish","Accounts Receivable",NA,88,-123380.85
"3187","Revenue","Invoice","2018-05-16","71113","Thompson Lighting Stores:Store #20","Brushed Nickel, 18x7.75x6, 3-60 watt Medium Base, Satin Opal Glass","Accounts Receivable",NA,100,-123480.85
"3188","Revenue","Invoice","2018-05-16","71113","Thompson Lighting Stores:Store #20","Tapestry (8/60 watt)  Faux Alabaster Glass","Accounts Receivable",NA,300,-123780.85
"3189","Revenue","Invoice","2018-05-16","71113","Thompson Lighting Stores:Store #20","Frosted Taupe (3/60 watt)  Marble Glass  ","Accounts Receivable",NA,310,-124090.85
"3190","Revenue","Invoice","2018-05-16","71113","Thompson Lighting Stores:Store #20","Roman Bronze, 1-light Lantern, w/tail, (100 watt max)","Accounts Receivable",NA,340,-124430.85
"3191","Revenue","Invoice","2018-05-16","71113","Thompson Lighting Stores:Store #20","Domes, White, 59x21x6 5/8 ht, 120v HPF","Accounts Receivable",NA,135,-124565.85
"3192","Revenue","Invoice","2018-05-16","71113","Thompson Lighting Stores:Store #20","Flat Glass, (25 watt max) Polished Brass, 4 light","Accounts Receivable",NA,125,-124690.85
"3193","Revenue","Invoice","2018-05-16","71113","Thompson Lighting Stores:Store #20","Burnished Brass (60 watt)  w/Golden Umber Accents","Accounts Receivable",NA,300,-124990.85
"3194","Revenue","Invoice","2018-05-16","71113","Thompson Lighting Stores:Store #20","Pearl Nickle, 5 Light, Medium Base (100 watt max)","Accounts Receivable",NA,475,-125465.85
"3195","Revenue","Invoice","2018-05-18","71084","Cole Home Builders:Phase 1 - Lot 5","Acid Verde, 10x21x10, 2-60 watt cand.","Accounts Receivable",NA,104.4,-125570.25
"3196","Revenue","Invoice","2018-05-18","71084","Cole Home Builders:Phase 1 - Lot 5","Sunset, Clear Glass, 1-100 watt max.","Accounts Receivable",NA,94.5,-125664.75
"3197","Revenue","Invoice","2018-05-18","71084","Cole Home Builders:Phase 1 - Lot 5","Tapestry (8/60 watt)  Faux Alabaster Glass","Accounts Receivable",NA,270,-125934.75
"3198","Revenue","Invoice","2018-05-18","71084","Cole Home Builders:Phase 1 - Lot 5","Chestnut (3/60 watt)  Marble Glass","Accounts Receivable",NA,292.5,-126227.25
"3199","Revenue","Invoice","2018-05-18","71084","Cole Home Builders:Phase 1 - Lot 5","Tiffany Collection,Golden Baroque, 1-light lantern, medium base (100 watt max)","Accounts Receivable",NA,183.6,-126410.85
"3200","Revenue","Invoice","2018-05-18","71084","Cole Home Builders:Phase 1 - Lot 5","2032 Series, (3-60 watt, Med) Desert Stone Finish","Accounts Receivable",NA,59.4,-126470.25
"3201","Revenue","Invoice","2018-05-18","71084","Cole Home Builders:Phase 1 - Lot 5","Tapestry, (2-60 watt Med), Etched Cracked Glass, Finish 10","Accounts Receivable",NA,81,-126551.25
"3202","Revenue","Invoice","2018-05-18","71084","Cole Home Builders:Phase 1 - Lot 5","18x8x10, Solid Brass, 3-60watt Medium Base, Satin Etched Glass","Accounts Receivable",NA,118.8,-126670.05
"3203","Revenue","Invoice","2018-05-18","71084","Cole Home Builders:Phase 1 - Lot 5","White, 4.5x7.5, 1-100 watt Medium Base, Satin White Glass","Accounts Receivable",NA,86.4,-126756.45
"3204","Revenue","Invoice","2018-05-18","71084","Cole Home Builders:Phase 1 - Lot 5","Drop Opal w/Solid Oak Frame, 49 1/2 x 17, 120v HPF","Accounts Receivable",NA,113.4,-126869.85
"3205","Revenue","Invoice","2018-05-18","71084","Cole Home Builders:Phase 1 - Lot 5","Verona Collection, Pendant, Cobblestone, Etched Alabaster Glass, 150 watt max","Accounts Receivable",NA,135,-127004.85
"3206","Revenue","Invoice","2018-05-18","71084","Cole Home Builders:Phase 1 - Lot 5","Fluorescent Lamp, T-12, Medium Bipin  (30pack)","Accounts Receivable",NA,13.5,-127018.35
"3207","Revenue","Invoice","2018-05-18","71084","Cole Home Builders:Phase 1 - Lot 5","Specialty Bulbs, 100 watt (6 pack)","Accounts Receivable",NA,49.5,-127067.85
"3208","Revenue","Invoice","2018-05-18","71084","Cole Home Builders:Phase 1 - Lot 5","Specialty, Stage & Studio Bulbs  60 watt","Accounts Receivable",NA,35.1,-127102.95
"3209","Revenue","Invoice","2018-05-19","71063","Godwin Lighting Depot:Store #404","Black Finish, Solid Brass, Clear Glass, Hanging, 2-60 watt max.","Accounts Receivable",NA,113.4,-127216.35
"3210","Revenue","Invoice","2018-05-19","71063","Godwin Lighting Depot:Store #404","Black Finish, Solid Brass,Wall Mount w/Clear Glass (2x60watt max)","Accounts Receivable",NA,337.5,-127553.85
"3211","Revenue","Invoice","2018-05-19","71063","Godwin Lighting Depot:Store #404","Tapestry (8/60 watt)  Faux Alabaster Glass","Accounts Receivable",NA,540,-128093.85
"3212","Revenue","Invoice","2018-05-19","71063","Godwin Lighting Depot:Store #404","Athena Collection, (100 watt max) Copper Verde, Seeded Glass","Accounts Receivable",NA,405,-128498.85
"3213","Revenue","Invoice","2018-05-19","71063","Godwin Lighting Depot:Store #404","Broadway Collection, Polished Chrome, 4 Light (60 watt max)","Accounts Receivable",NA,126.9,-128625.75
"3214","Revenue","Invoice","2018-05-19","71063","Godwin Lighting Depot:Store #404","Halogen Lamp, Volts:3.5  Tubular","Accounts Receivable",NA,9.9,-128635.65
"3215","Revenue","Invoice","2018-05-19","71063","Godwin Lighting Depot:Store #404","Specialty Bulbs, 100 watt (6 pack)","Accounts Receivable",NA,19.8,-128655.45
"3216","Revenue","Invoice","2018-05-19","71063","Godwin Lighting Depot:Store #404","Specialty, Stage & Studio Bulbs  60 watt","Accounts Receivable",NA,40.95,-128696.4
"3217","Revenue","Invoice","2018-05-19","71063","Godwin Lighting Depot:Store #404","Fluorescent Lamp, T-12, Medium Bipin  (30pack)","Accounts Receivable",NA,13.5,-128709.9
"3218","Revenue","Invoice","2018-05-19","71063","Godwin Lighting Depot:Store #404","Domes, White, 59x21x6 5/8 ht, 120v HPF","Accounts Receivable",NA,81,-128790.9
"3219","Revenue","Invoice","2018-05-22","71127","Kern Lighting Warehouse:Store #34","Domes, White, 59x21x6 5/8 ht, 120v HPF","Accounts Receivable",NA,6750,-135540.9
"3220","Revenue","Invoice","2018-05-22","71127","Kern Lighting Warehouse:Store #34","Flush Mount, Polished Brass (2, 13 watt)  White acrylic diffuser","Accounts Receivable",NA,1700,-137240.9
"3221","Revenue","Invoice","2018-05-22","71127","Kern Lighting Warehouse:Store #34","Tiffany Collection,Golden Baroque, 1-light lantern, medium base (100 watt max)","Accounts Receivable",NA,306,-137546.9
"3222","Revenue","Invoice","2018-05-24","71086","Cole Home Builders:Phase 1 - Lot 4","Die Cast Lanterns, Black, 1-100 watt, Medium Base, Clear Cracked Glass","Accounts Receivable",NA,367.2,-137914.1
"3223","Revenue","Invoice","2018-05-24","71086","Cole Home Builders:Phase 1 - Lot 4","Tapestry, (2-60 watt Med), Etched Cracked Glass, Finish 10","Accounts Receivable",NA,243,-138157.1
"3224","Revenue","Invoice","2018-05-24","71086","Cole Home Builders:Phase 1 - Lot 4","Pearl Nickle, 5 Light, Medium Base (100 watt max)","Accounts Receivable",NA,342,-138499.1
"3225","Revenue","Invoice","2018-05-24","71086","Cole Home Builders:Phase 1 - Lot 4","Sunset, Clear Glass, 1-100 watt max.","Accounts Receivable",NA,126,-138625.1
"3226","Revenue","Invoice","2018-05-24","71086","Cole Home Builders:Phase 1 - Lot 4","Black Finish, Solid Brass, Clear Glass, Hanging, 2-60 watt max.","Accounts Receivable",NA,113.4,-138738.5
"3227","Revenue","Invoice","2018-05-24","71086","Cole Home Builders:Phase 1 - Lot 4","Burnished Brass (60 watt)  w/Golden Umber Accents","Accounts Receivable",NA,270,-139008.5
"3228","Revenue","Invoice","2018-05-24","71086","Cole Home Builders:Phase 1 - Lot 4","Chestnut (3/60 watt)  Marble Glass","Accounts Receivable",NA,292.5,-139301
"3229","Revenue","Invoice","2018-05-24","71086","Cole Home Builders:Phase 1 - Lot 4","Pendant Bar, Textured White, 50lbs max","Accounts Receivable",NA,22.5,-139323.5
"3230","Revenue","Invoice","2018-05-24","71086","Cole Home Builders:Phase 1 - Lot 4","Athena Collection, (100 watt max) Copper Verde, Seeded Glass","Accounts Receivable",NA,81,-139404.5
"3231","Revenue","Invoice","2018-05-24","71086","Cole Home Builders:Phase 1 - Lot 4","Cand. Light, 20 watts (8 pack)","Accounts Receivable",NA,50.4,-139454.9
"3232","Revenue","Invoice","2018-05-24","71086","Cole Home Builders:Phase 1 - Lot 4","Fluorescent Lamp, T-12, Medium Bipin  (30pack)","Accounts Receivable",NA,13.5,-139468.4
"3233","Revenue","Invoice","2018-05-24","71086","Cole Home Builders:Phase 1 - Lot 4","Fluorescent Lamp, T-5, Bipin","Accounts Receivable",NA,18,-139486.4
"3234","Revenue","Invoice","2018-05-24","71086","Cole Home Builders:Phase 1 - Lot 4","Halogen Lamp, Volts:3.5  Tubular","Accounts Receivable",NA,4.95,-139491.35
"3235","Revenue","Invoice","2018-05-24","71086","Cole Home Builders:Phase 1 - Lot 4","Specialty Bulbs, 100 watt (6 pack)","Accounts Receivable",NA,19.8,-139511.15
"3236","Revenue","Invoice","2018-05-24","71086","Cole Home Builders:Phase 1 - Lot 4","Specialty, Stage & Studio Bulbs  60 watt","Accounts Receivable",NA,46.8,-139557.95
"3237","Revenue","Invoice","2018-05-24","71086","Cole Home Builders:Phase 1 - Lot 4","Flat Glass, (25 watt max) Polished Brass, 4 light","Accounts Receivable",NA,90,-139647.95
"3238","Revenue","Invoice","2018-05-24","71086","Cole Home Builders:Phase 1 - Lot 4","Beveled Mirror, Etched Ribbed Glass (75 watt max)","Accounts Receivable",NA,86.4,-139734.35
"3239","Revenue","Invoice","2018-05-30","71069","Godwin Lighting Depot:Store #1020","Vianne Lanterns, Satin Antiqued Solid Brass, 3-light wall latern, Candelabra base (60 watt max)","Accounts Receivable",NA,360,-140094.35
"3240","Revenue","Invoice","2018-05-30","71069","Godwin Lighting Depot:Store #1020","Renaissance Collection, (100 watt max) Millstone Finish, One-light","Accounts Receivable",NA,324,-140418.35
"3241","Revenue","Invoice","2018-05-30","71069","Godwin Lighting Depot:Store #1020","Drop Opal w/Solid Oak Frame, 49 1/2 x 17, 120v HPF","Accounts Receivable",NA,75.6,-140493.95
"3242","Revenue","Invoice","2018-05-30","71069","Godwin Lighting Depot:Store #1020","Beveled Mirror, Etched Ribbed Glass (75 watt max)","Accounts Receivable",NA,129.6,-140623.55
"3243","Revenue","Invoice","2018-05-30","71069","Godwin Lighting Depot:Store #1020","Chestnut (3/60 watt)  Marble Glass","Accounts Receivable",NA,585,-141208.55
"3244","Revenue","Invoice","2018-05-30","71069","Godwin Lighting Depot:Store #1020","2032 Series, (3-60 watt, Med) Desert Stone Finish","Accounts Receivable",NA,99,-141307.55
"3245","Revenue","Invoice","2018-05-30","71069","Godwin Lighting Depot:Store #1020","Pearl Nickle, 5 Light, Medium Base (100 watt max)","Accounts Receivable",NA,171,-141478.55
"3246","Revenue","Invoice","2018-05-30","71069","Godwin Lighting Depot:Store #1020","Verona Collection, Pendant, Cobblestone, Etched Alabaster Glass, 150 watt max","Accounts Receivable",NA,540,-142018.55
"3247","Revenue","Invoice","2018-05-30","71069","Godwin Lighting Depot:Store #1020","Pendant Bar, Cobblestone, 50lbs. max","Accounts Receivable",NA,90,-142108.55
"3248","Revenue","Invoice","2018-05-30","71069","Godwin Lighting Depot:Store #1020","Cand. Light, 20 watts (8 pack)","Accounts Receivable",NA,75.6,-142184.15
"3249","Revenue","Invoice","2018-05-30","71069","Godwin Lighting Depot:Store #1020","Fluorescent Lamp, T-12, Medium Bipin  (30pack)","Accounts Receivable",NA,13.5,-142197.65
"3250","Revenue","Invoice","2018-05-30","71069","Godwin Lighting Depot:Store #1020","Halogen Lamp, 20 watts, Luminous Intensity","Accounts Receivable",NA,43.2,-142240.85
"3251","Revenue","Invoice","2018-05-30","71069","Godwin Lighting Depot:Store #1020","Specialty Bulbs, 100 watt (6 pack)","Accounts Receivable",NA,19.8,-142260.65
"3252","Revenue","Invoice","2018-05-30","71069","Godwin Lighting Depot:Store #1020","Specialty, Stage & Studio Bulbs  60 watt","Accounts Receivable",NA,52.65,-142313.3
"3253","Revenue","Invoice","2018-05-31","71083","Cole Home Builders:Phase 2 - Lot 5","Acid Verde, 10x21x10, 2-60 watt cand.","Accounts Receivable",NA,104.4,-142417.7
"3254","Revenue","Invoice","2018-05-31","71083","Cole Home Builders:Phase 2 - Lot 5","Sunset, Clear Glass, 1-100 watt max.","Accounts Receivable",NA,94.5,-142512.2
"3255","Revenue","Invoice","2018-05-31","71083","Cole Home Builders:Phase 2 - Lot 5","Tapestry (8/60 watt)  Faux Alabaster Glass","Accounts Receivable",NA,270,-142782.2
"3256","Revenue","Invoice","2018-05-31","71083","Cole Home Builders:Phase 2 - Lot 5","Chestnut (3/60 watt)  Marble Glass","Accounts Receivable",NA,292.5,-143074.7
"3257","Revenue","Invoice","2018-05-31","71083","Cole Home Builders:Phase 2 - Lot 5","Tiffany Collection,Golden Baroque, 1-light lantern, medium base (100 watt max)","Accounts Receivable",NA,183.6,-143258.3
"3258","Revenue","Invoice","2018-05-31","71083","Cole Home Builders:Phase 2 - Lot 5","2032 Series, (3-60 watt, Med) Desert Stone Finish","Accounts Receivable",NA,59.4,-143317.7
"3259","Revenue","Invoice","2018-05-31","71083","Cole Home Builders:Phase 2 - Lot 5","Tapestry, (2-60 watt Med), Etched Cracked Glass, Finish 10","Accounts Receivable",NA,81,-143398.7
"3260","Revenue","Invoice","2018-05-31","71083","Cole Home Builders:Phase 2 - Lot 5","18x8x10, Solid Brass, 3-60watt Medium Base, Satin Etched Glass","Accounts Receivable",NA,118.8,-143517.5
"3261","Revenue","Invoice","2018-05-31","71083","Cole Home Builders:Phase 2 - Lot 5","White, 4.5x7.5, 1-100 watt Medium Base, Satin White Glass","Accounts Receivable",NA,86.4,-143603.9
"3262","Revenue","Invoice","2018-05-31","71083","Cole Home Builders:Phase 2 - Lot 5","Drop Opal w/Solid Oak Frame, 49 1/2 x 17, 120v HPF","Accounts Receivable",NA,113.4,-143717.3
"3263","Revenue","Invoice","2018-05-31","71083","Cole Home Builders:Phase 2 - Lot 5","Verona Collection, Pendant, Cobblestone, Etched Alabaster Glass, 150 watt max","Accounts Receivable",NA,135,-143852.3
"3264","Revenue","Invoice","2018-05-31","71083","Cole Home Builders:Phase 2 - Lot 5","Fluorescent Lamp, T-12, Medium Bipin  (30pack)","Accounts Receivable",NA,13.5,-143865.8
"3265","Revenue","Invoice","2018-05-31","71083","Cole Home Builders:Phase 2 - Lot 5","Specialty Bulbs, 100 watt (6 pack)","Accounts Receivable",NA,49.5,-143915.3
"3266","Revenue","Invoice","2018-05-31","71083","Cole Home Builders:Phase 2 - Lot 5","Specialty, Stage & Studio Bulbs  60 watt","Accounts Receivable",NA,35.1,-143950.4
"3267","Revenue","Invoice","2018-06-05","71096","Miscellaneous - Retail:Anne Loomis","Die Cast Lanterns, Black, 1-100 watt, Medium Base, Clear Cracked Glass","Accounts Receivable",NA,680,-144630.4
"3268","Revenue","Invoice","2018-06-05","71096","Miscellaneous - Retail:Anne Loomis","Brushed Nickel, Pendant, 1-100 watt Medium Base, Satin Etched Glass","Accounts Receivable",NA,550,-145180.4
"3269","Revenue","Invoice","2018-06-05","71096","Miscellaneous - Retail:Anne Loomis","Colonial, Brushed Steel Finish, Opal White Glass (60 watt)","Accounts Receivable",NA,84,-145264.4
"3270","Revenue","Invoice","2018-06-05","71096","Miscellaneous - Retail:Anne Loomis","Solid Brass, 4-light, 25x13x10.75, 4-60 watt, Medium Base, Satin Etched Glass","Accounts Receivable",NA,168,-145432.4
"3271","Revenue","Invoice","2018-06-05","71096","Miscellaneous - Retail:Anne Loomis","Drop Opal w/Solid Oak Frame, 49 1/2 x 17, 120v HPF","Accounts Receivable",NA,126,-145558.4
"3272","Revenue","Invoice","2018-06-07","71085","Cole Home Builders:Phase 1 - Lot 5","Die Cast Lanterns, Black, 1-100 watt, Medium Base, Clear Cracked Glass","Accounts Receivable",NA,367.2,-145925.6
"3273","Revenue","Invoice","2018-06-07","71085","Cole Home Builders:Phase 1 - Lot 5","Tapestry, (2-60 watt Med), Etched Cracked Glass, Finish 10","Accounts Receivable",NA,243,-146168.6
"3274","Revenue","Invoice","2018-06-07","71085","Cole Home Builders:Phase 1 - Lot 5","Pearl Nickle, 5 Light, Medium Base (100 watt max)","Accounts Receivable",NA,342,-146510.6
"3275","Revenue","Invoice","2018-06-07","71085","Cole Home Builders:Phase 1 - Lot 5","Sunset, Clear Glass, 1-100 watt max.","Accounts Receivable",NA,126,-146636.6
"3276","Revenue","Invoice","2018-06-07","71085","Cole Home Builders:Phase 1 - Lot 5","Black Finish, Solid Brass, Clear Glass, Hanging, 2-60 watt max.","Accounts Receivable",NA,113.4,-146750
"3277","Revenue","Invoice","2018-06-07","71085","Cole Home Builders:Phase 1 - Lot 5","Burnished Brass (60 watt)  w/Golden Umber Accents","Accounts Receivable",NA,270,-147020
"3278","Revenue","Invoice","2018-06-07","71085","Cole Home Builders:Phase 1 - Lot 5","Chestnut (3/60 watt)  Marble Glass","Accounts Receivable",NA,292.5,-147312.5
"3279","Revenue","Invoice","2018-06-07","71085","Cole Home Builders:Phase 1 - Lot 5","Pendant Bar, Textured White, 50lbs max","Accounts Receivable",NA,22.5,-147335
"3280","Revenue","Invoice","2018-06-07","71085","Cole Home Builders:Phase 1 - Lot 5","Athena Collection, (100 watt max) Copper Verde, Seeded Glass","Accounts Receivable",NA,81,-147416
"3281","Revenue","Invoice","2018-06-07","71085","Cole Home Builders:Phase 1 - Lot 5","Cand. Light, 20 watts (8 pack)","Accounts Receivable",NA,50.4,-147466.4
"3282","Revenue","Invoice","2018-06-07","71085","Cole Home Builders:Phase 1 - Lot 5","Fluorescent Lamp, T-12, Medium Bipin  (30pack)","Accounts Receivable",NA,13.5,-147479.9
"3283","Revenue","Invoice","2018-06-07","71085","Cole Home Builders:Phase 1 - Lot 5","Fluorescent Lamp, T-5, Bipin","Accounts Receivable",NA,18,-147497.9
"3284","Revenue","Invoice","2018-06-07","71085","Cole Home Builders:Phase 1 - Lot 5","Halogen Lamp, Volts:3.5  Tubular","Accounts Receivable",NA,4.95,-147502.85
"3285","Revenue","Invoice","2018-06-07","71085","Cole Home Builders:Phase 1 - Lot 5","Specialty Bulbs, 100 watt (6 pack)","Accounts Receivable",NA,19.8,-147522.65
"3286","Revenue","Invoice","2018-06-07","71085","Cole Home Builders:Phase 1 - Lot 5","Specialty, Stage & Studio Bulbs  60 watt","Accounts Receivable",NA,46.8,-147569.45
"3287","Revenue","Invoice","2018-06-07","71085","Cole Home Builders:Phase 1 - Lot 5","Flat Glass, (25 watt max) Polished Brass, 4 light","Accounts Receivable",NA,90,-147659.45
"3288","Revenue","Invoice","2018-06-07","71085","Cole Home Builders:Phase 1 - Lot 5","Beveled Mirror, Etched Ribbed Glass (75 watt max)","Accounts Receivable",NA,86.4,-147745.85
"3289","Revenue","Invoice","2018-06-10","71128","Kern Lighting Warehouse:Store #45","Fluorescent Lamp, T-12, Medium Bipin  (30pack)","Accounts Receivable",NA,4500,-152245.85
"3290","Revenue","Invoice","2018-06-10","71128","Kern Lighting Warehouse:Store #45","Specialty, Stage & Studio Bulbs  60 watt","Accounts Receivable",NA,975,-153220.85
"3291","Revenue","Invoice","2018-06-10","71128","Kern Lighting Warehouse:Store #45","Drop Opal w/Solid Oak Frame, 49 1/2 x 17, 120v HPF","Accounts Receivable",NA,1260,-154480.85
"3292","Revenue","Invoice","2018-06-10","71128","Kern Lighting Warehouse:Store #45","Sunset, Clear Glass, 1-100 watt max.","Accounts Receivable",NA,1400,-155880.85
"3293","Revenue","Invoice","2018-06-10","71128","Kern Lighting Warehouse:Store #45","Black Finish, Solid Brass, Clear Glass, Hanging, 2-60 watt max.","Accounts Receivable",NA,2100,-157980.85
"3294","Revenue","Invoice","2018-06-10","71128","Kern Lighting Warehouse:Store #45","Solid Brass, 4-light, 25x13x10.75, 4-60 watt, Medium Base, Satin Etched Glass","Accounts Receivable",NA,840,-158820.85
"3295","Revenue","Invoice","2018-06-10","71128","Kern Lighting Warehouse:Store #45","Brushed Nickel, (3-60 watt, Med) Ribbed Glass","Accounts Receivable",NA,800,-159620.85
"3296","Revenue","Invoice","2018-06-10","71128","Kern Lighting Warehouse:Store #45","Halogen Lamp, 20 watts, Luminous Intensity","Accounts Receivable",NA,120,-159740.85
"3297","Revenue","Invoice","2018-06-10","71128","Kern Lighting Warehouse:Store #45","Halogen Lamp, Volts:3.5  Tubular","Accounts Receivable",NA,55,-159795.85
"3298","Revenue","Invoice","2018-06-10","71128","Kern Lighting Warehouse:Store #45","Roman Bronze, 1-light Lantern, w/tail, (100 watt max)","Accounts Receivable",NA,2125,-161920.85
"3299","Revenue","Invoice","2018-06-11","71070","Godwin Lighting Depot:Store #303","Vianne Lanterns, Satin Antiqued Solid Brass, 3-light wall latern, Candelabra base (60 watt max)","Accounts Receivable",NA,360,-162280.85
"3300","Revenue","Invoice","2018-06-11","71070","Godwin Lighting Depot:Store #303","Renaissance Collection, (100 watt max) Millstone Finish, One-light","Accounts Receivable",NA,324,-162604.85
"3301","Revenue","Invoice","2018-06-11","71070","Godwin Lighting Depot:Store #303","Drop Opal w/Solid Oak Frame, 49 1/2 x 17, 120v HPF","Accounts Receivable",NA,75.6,-162680.45
"3302","Revenue","Invoice","2018-06-11","71070","Godwin Lighting Depot:Store #303","Beveled Mirror, Etched Ribbed Glass (75 watt max)","Accounts Receivable",NA,129.6,-162810.05
"3303","Revenue","Invoice","2018-06-11","71070","Godwin Lighting Depot:Store #303","Chestnut (3/60 watt)  Marble Glass","Accounts Receivable",NA,585,-163395.05
"3304","Revenue","Invoice","2018-06-11","71070","Godwin Lighting Depot:Store #303","2032 Series, (3-60 watt, Med) Desert Stone Finish","Accounts Receivable",NA,99,-163494.05
"3305","Revenue","Invoice","2018-06-11","71070","Godwin Lighting Depot:Store #303","Pearl Nickle, 5 Light, Medium Base (100 watt max)","Accounts Receivable",NA,171,-163665.05
"3306","Revenue","Invoice","2018-06-11","71070","Godwin Lighting Depot:Store #303","Verona Collection, Pendant, Cobblestone, Etched Alabaster Glass, 150 watt max","Accounts Receivable",NA,540,-164205.05
"3307","Revenue","Invoice","2018-06-11","71070","Godwin Lighting Depot:Store #303","Pendant Bar, Cobblestone, 50lbs. max","Accounts Receivable",NA,90,-164295.05
"3308","Revenue","Invoice","2018-06-11","71070","Godwin Lighting Depot:Store #303","Cand. Light, 20 watts (8 pack)","Accounts Receivable",NA,75.6,-164370.65
"3309","Revenue","Invoice","2018-06-11","71070","Godwin Lighting Depot:Store #303","Fluorescent Lamp, T-12, Medium Bipin  (30pack)","Accounts Receivable",NA,13.5,-164384.15
"3310","Revenue","Invoice","2018-06-11","71070","Godwin Lighting Depot:Store #303","Halogen Lamp, 20 watts, Luminous Intensity","Accounts Receivable",NA,43.2,-164427.35
"3311","Revenue","Invoice","2018-06-11","71070","Godwin Lighting Depot:Store #303","Specialty Bulbs, 100 watt (6 pack)","Accounts Receivable",NA,19.8,-164447.15
"3312","Revenue","Invoice","2018-06-11","71070","Godwin Lighting Depot:Store #303","Specialty, Stage & Studio Bulbs  60 watt","Accounts Receivable",NA,52.65,-164499.8
"3313","Revenue","Invoice","2018-06-12","71080","Cole Home Builders:Phase 1 - Lot 5","BrassGuard Lanterns, Polished Brass, 1-light Wall, (100 watt max)","Accounts Receivable",NA,288,-164787.8
"3314","Revenue","Invoice","2018-06-12","71080","Cole Home Builders:Phase 1 - Lot 5","Die Cast Lanterns, Black, 1-100 watt, Medium Base, Clear Cracked Glass","Accounts Receivable",NA,122.4,-164910.2
"3315","Revenue","Invoice","2018-06-12","71080","Cole Home Builders:Phase 1 - Lot 5","Sunset, Clear Glass, 1-100 watt max.","Accounts Receivable",NA,63,-164973.2
"3316","Revenue","Invoice","2018-06-12","71080","Cole Home Builders:Phase 1 - Lot 5","Beveled Mirror, Etched Ribbed Glass (75 watt max)","Accounts Receivable",NA,129.6,-165102.8
"3317","Revenue","Invoice","2018-06-12","71080","Cole Home Builders:Phase 1 - Lot 5","Broadway Collection, Polished Brass, 6 Light (60 watt max)","Accounts Receivable",NA,129.6,-165232.4
"3318","Revenue","Invoice","2018-06-12","71080","Cole Home Builders:Phase 1 - Lot 5","Brushed Nickel, 18x7.75x6, 3-60 watt Medium Base, Satin Opal Glass","Accounts Receivable",NA,45,-165277.4
"3319","Revenue","Invoice","2018-06-12","71080","Cole Home Builders:Phase 1 - Lot 5","Brushed Nickel, (3-60 watt, Med) Ribbed Glass","Accounts Receivable",NA,180,-165457.4
"3320","Revenue","Invoice","2018-06-12","71080","Cole Home Builders:Phase 1 - Lot 5","Brushed Nickel, Pendant, 1-100 watt Medium Base, Satin Etched Glass","Accounts Receivable",NA,198,-165655.4
"3321","Revenue","Invoice","2018-06-12","71080","Cole Home Builders:Phase 1 - Lot 5","Pendant Bar, Cobblestone, 50lbs. max","Accounts Receivable",NA,22.5,-165677.9
"3322","Revenue","Invoice","2018-06-12","71080","Cole Home Builders:Phase 1 - Lot 5","Verona Collection, Pendant, Cobblestone, Etched Alabaster Glass, 150 watt max","Accounts Receivable",NA,135,-165812.9
"3323","Revenue","Invoice","2018-06-12","71080","Cole Home Builders:Phase 1 - Lot 5","Chestnut (3/60 watt)  Marble Glass","Accounts Receivable",NA,292.5,-166105.4
"3324","Revenue","Invoice","2018-06-12","71080","Cole Home Builders:Phase 1 - Lot 5","Frosted Taupe (3/60 watt)  Marble Glass  ","Accounts Receivable",NA,279,-166384.4
"3325","Revenue","Invoice","2018-06-12","71080","Cole Home Builders:Phase 1 - Lot 5","Cand. Light, 20 watts (8 pack)","Accounts Receivable",NA,75.6,-166460
"3326","Revenue","Invoice","2018-06-12","71080","Cole Home Builders:Phase 1 - Lot 5","Specialty Bulbs, 100 watt (6 pack)","Accounts Receivable",NA,19.8,-166479.8
"3327","Revenue","Invoice","2018-06-12","71080","Cole Home Builders:Phase 1 - Lot 5","Specialty, Stage & Studio Bulbs  60 watt","Accounts Receivable",NA,29.25,-166509.05
"3328","Revenue","Invoice","2018-06-12","71081","Cole Home Builders:Phase 2 - Lot 5","Acid Verde, 10x21x10, 2-60 watt cand.","Accounts Receivable",NA,104.4,-166613.45
"3329","Revenue","Invoice","2018-06-12","71081","Cole Home Builders:Phase 2 - Lot 5","Sunset, Clear Glass, 1-100 watt max.","Accounts Receivable",NA,94.5,-166707.95
"3330","Revenue","Invoice","2018-06-12","71081","Cole Home Builders:Phase 2 - Lot 5","Tapestry (8/60 watt)  Faux Alabaster Glass","Accounts Receivable",NA,270,-166977.95
"3331","Revenue","Invoice","2018-06-12","71081","Cole Home Builders:Phase 2 - Lot 5","Chestnut (3/60 watt)  Marble Glass","Accounts Receivable",NA,292.5,-167270.45
"3332","Revenue","Invoice","2018-06-12","71081","Cole Home Builders:Phase 2 - Lot 5","Tiffany Collection,Golden Baroque, 1-light lantern, medium base (100 watt max)","Accounts Receivable",NA,183.6,-167454.05
"3333","Revenue","Invoice","2018-06-12","71081","Cole Home Builders:Phase 2 - Lot 5","2032 Series, (3-60 watt, Med) Desert Stone Finish","Accounts Receivable",NA,59.4,-167513.45
"3334","Revenue","Invoice","2018-06-12","71081","Cole Home Builders:Phase 2 - Lot 5","Tapestry, (2-60 watt Med), Etched Cracked Glass, Finish 10","Accounts Receivable",NA,81,-167594.45
"3335","Revenue","Invoice","2018-06-12","71081","Cole Home Builders:Phase 2 - Lot 5","18x8x10, Solid Brass, 3-60watt Medium Base, Satin Etched Glass","Accounts Receivable",NA,118.8,-167713.25
"3336","Revenue","Invoice","2018-06-12","71081","Cole Home Builders:Phase 2 - Lot 5","White, 4.5x7.5, 1-100 watt Medium Base, Satin White Glass","Accounts Receivable",NA,86.4,-167799.65
"3337","Revenue","Invoice","2018-06-12","71081","Cole Home Builders:Phase 2 - Lot 5","Drop Opal w/Solid Oak Frame, 49 1/2 x 17, 120v HPF","Accounts Receivable",NA,113.4,-167913.05
"3338","Revenue","Invoice","2018-06-12","71081","Cole Home Builders:Phase 2 - Lot 5","Verona Collection, Pendant, Cobblestone, Etched Alabaster Glass, 150 watt max","Accounts Receivable",NA,135,-168048.05
"3339","Revenue","Invoice","2018-06-12","71081","Cole Home Builders:Phase 2 - Lot 5","Fluorescent Lamp, T-12, Medium Bipin  (30pack)","Accounts Receivable",NA,13.5,-168061.55
"3340","Revenue","Invoice","2018-06-12","71081","Cole Home Builders:Phase 2 - Lot 5","Specialty Bulbs, 100 watt (6 pack)","Accounts Receivable",NA,49.5,-168111.05
"3341","Revenue","Invoice","2018-06-12","71081","Cole Home Builders:Phase 2 - Lot 5","Specialty, Stage & Studio Bulbs  60 watt","Accounts Receivable",NA,35.1,-168146.15
"3342","Revenue","Invoice","2018-06-12","71114","Thompson Lighting Stores:Store #30","Acid Verde, 10x21x10, 2-60 watt cand.","Accounts Receivable",NA,348,-168494.15
"3343","Revenue","Invoice","2018-06-12","71114","Thompson Lighting Stores:Store #30","Die Cast Lanterns, Black, 1-100 watt, Medium Base, Clear Cracked Glass","Accounts Receivable",NA,272,-168766.15
"3344","Revenue","Invoice","2018-06-12","71114","Thompson Lighting Stores:Store #30","Polished Brass Pendant, 1-100 watt Medium Base, Clear Ribbed Glass","Accounts Receivable",NA,232,-168998.15
"3345","Revenue","Invoice","2018-06-12","71114","Thompson Lighting Stores:Store #30","2032 Series, (3-60 watt, Med) Desert Stone Finish","Accounts Receivable",NA,88,-169086.15
"3346","Revenue","Invoice","2018-06-12","71114","Thompson Lighting Stores:Store #30","Brushed Nickel, 18x7.75x6, 3-60 watt Medium Base, Satin Opal Glass","Accounts Receivable",NA,100,-169186.15
"3347","Revenue","Invoice","2018-06-12","71114","Thompson Lighting Stores:Store #30","Tapestry (8/60 watt)  Faux Alabaster Glass","Accounts Receivable",NA,300,-169486.15
"3348","Revenue","Invoice","2018-06-12","71114","Thompson Lighting Stores:Store #30","Frosted Taupe (3/60 watt)  Marble Glass  ","Accounts Receivable",NA,310,-169796.15
"3349","Revenue","Invoice","2018-06-12","71114","Thompson Lighting Stores:Store #30","Roman Bronze, 1-light Lantern, w/tail, (100 watt max)","Accounts Receivable",NA,340,-170136.15
"3350","Revenue","Invoice","2018-06-12","71114","Thompson Lighting Stores:Store #30","Domes, White, 59x21x6 5/8 ht, 120v HPF","Accounts Receivable",NA,135,-170271.15
"3351","Revenue","Invoice","2018-06-12","71114","Thompson Lighting Stores:Store #30","Flat Glass, (25 watt max) Polished Brass, 4 light","Accounts Receivable",NA,125,-170396.15
"3352","Revenue","Invoice","2018-06-12","71114","Thompson Lighting Stores:Store #30","Burnished Brass (60 watt)  w/Golden Umber Accents","Accounts Receivable",NA,300,-170696.15
"3353","Revenue","Invoice","2018-06-12","71114","Thompson Lighting Stores:Store #30","Pearl Nickle, 5 Light, Medium Base (100 watt max)","Accounts Receivable",NA,475,-171171.15
"3354","Revenue","Invoice","2018-06-15","71082","Cole Home Builders:Phase 1 - Lot 5","Acid Verde, 10x21x10, 2-60 watt cand.","Accounts Receivable",NA,104.4,-171275.55
"3355","Revenue","Invoice","2018-06-15","71082","Cole Home Builders:Phase 1 - Lot 5","Sunset, Clear Glass, 1-100 watt max.","Accounts Receivable",NA,94.5,-171370.05
"3356","Revenue","Invoice","2018-06-15","71082","Cole Home Builders:Phase 1 - Lot 5","Tapestry (8/60 watt)  Faux Alabaster Glass","Accounts Receivable",NA,270,-171640.05
"3357","Revenue","Invoice","2018-06-15","71082","Cole Home Builders:Phase 1 - Lot 5","Chestnut (3/60 watt)  Marble Glass","Accounts Receivable",NA,292.5,-171932.55
"3358","Revenue","Invoice","2018-06-15","71082","Cole Home Builders:Phase 1 - Lot 5","Tiffany Collection,Golden Baroque, 1-light lantern, medium base (100 watt max)","Accounts Receivable",NA,183.6,-172116.15
"3359","Revenue","Invoice","2018-06-15","71082","Cole Home Builders:Phase 1 - Lot 5","2032 Series, (3-60 watt, Med) Desert Stone Finish","Accounts Receivable",NA,59.4,-172175.55
"3360","Revenue","Invoice","2018-06-15","71082","Cole Home Builders:Phase 1 - Lot 5","Tapestry, (2-60 watt Med), Etched Cracked Glass, Finish 10","Accounts Receivable",NA,81,-172256.55
"3361","Revenue","Invoice","2018-06-15","71082","Cole Home Builders:Phase 1 - Lot 5","18x8x10, Solid Brass, 3-60watt Medium Base, Satin Etched Glass","Accounts Receivable",NA,118.8,-172375.35
"3362","Revenue","Invoice","2018-06-15","71082","Cole Home Builders:Phase 1 - Lot 5","White, 4.5x7.5, 1-100 watt Medium Base, Satin White Glass","Accounts Receivable",NA,86.4,-172461.75
"3363","Revenue","Invoice","2018-06-15","71082","Cole Home Builders:Phase 1 - Lot 5","Drop Opal w/Solid Oak Frame, 49 1/2 x 17, 120v HPF","Accounts Receivable",NA,113.4,-172575.15
"3364","Revenue","Invoice","2018-06-15","71082","Cole Home Builders:Phase 1 - Lot 5","Verona Collection, Pendant, Cobblestone, Etched Alabaster Glass, 150 watt max","Accounts Receivable",NA,135,-172710.15
"3365","Revenue","Invoice","2018-06-15","71082","Cole Home Builders:Phase 1 - Lot 5","Fluorescent Lamp, T-12, Medium Bipin  (30pack)","Accounts Receivable",NA,13.5,-172723.65
"3366","Revenue","Invoice","2018-06-15","71082","Cole Home Builders:Phase 1 - Lot 5","Specialty Bulbs, 100 watt (6 pack)","Accounts Receivable",NA,49.5,-172773.15
"3367","Revenue","Invoice","2018-06-15","71082","Cole Home Builders:Phase 1 - Lot 5","Specialty, Stage & Studio Bulbs  60 watt","Accounts Receivable",NA,35.1,-172808.25
"3368","Revenue","Invoice","2018-06-28","71116","Thompson Lighting Stores:Store #50","Acid Verde, 10x21x10, 2-60 watt cand.","Accounts Receivable",NA,348,-173156.25
"3369","Revenue","Invoice","2018-06-28","71116","Thompson Lighting Stores:Store #50","Die Cast Lanterns, Black, 1-100 watt, Medium Base, Clear Cracked Glass","Accounts Receivable",NA,272,-173428.25
"3370","Revenue","Invoice","2018-06-28","71116","Thompson Lighting Stores:Store #50","Polished Brass Pendant, 1-100 watt Medium Base, Clear Ribbed Glass","Accounts Receivable",NA,232,-173660.25
"3371","Revenue","Invoice","2018-06-28","71116","Thompson Lighting Stores:Store #50","2032 Series, (3-60 watt, Med) Desert Stone Finish","Accounts Receivable",NA,88,-173748.25
"3372","Revenue","Invoice","2018-06-28","71116","Thompson Lighting Stores:Store #50","Brushed Nickel, 18x7.75x6, 3-60 watt Medium Base, Satin Opal Glass","Accounts Receivable",NA,100,-173848.25
"3373","Revenue","Invoice","2018-06-28","71116","Thompson Lighting Stores:Store #50","Tapestry (8/60 watt)  Faux Alabaster Glass","Accounts Receivable",NA,300,-174148.25
"3374","Revenue","Invoice","2018-06-28","71116","Thompson Lighting Stores:Store #50","Frosted Taupe (3/60 watt)  Marble Glass  ","Accounts Receivable",NA,310,-174458.25
"3375","Revenue","Invoice","2018-06-28","71116","Thompson Lighting Stores:Store #50","Roman Bronze, 1-light Lantern, w/tail, (100 watt max)","Accounts Receivable",NA,340,-174798.25
"3376","Revenue","Invoice","2018-06-28","71116","Thompson Lighting Stores:Store #50","Domes, White, 59x21x6 5/8 ht, 120v HPF","Accounts Receivable",NA,135,-174933.25
"3377","Revenue","Invoice","2018-06-28","71116","Thompson Lighting Stores:Store #50","Flat Glass, (25 watt max) Polished Brass, 4 light","Accounts Receivable",NA,125,-175058.25
"3378","Revenue","Invoice","2018-06-28","71116","Thompson Lighting Stores:Store #50","Burnished Brass (60 watt)  w/Golden Umber Accents","Accounts Receivable",NA,300,-175358.25
"3379","Revenue","Invoice","2018-06-28","71116","Thompson Lighting Stores:Store #50","Pearl Nickle, 5 Light, Medium Base (100 watt max)","Accounts Receivable",NA,475,-175833.25
"3380","Revenue","Invoice","2018-07-05","71089","Cole Home Builders:Phase 1 - Lot 5","Acid Verde, 10x21x10, 2-60 watt cand.","Accounts Receivable",NA,104.4,-175937.65
"3381","Revenue","Invoice","2018-07-05","71089","Cole Home Builders:Phase 1 - Lot 5","Sunset, Clear Glass, 1-100 watt max.","Accounts Receivable",NA,94.5,-176032.15
"3382","Revenue","Invoice","2018-07-05","71089","Cole Home Builders:Phase 1 - Lot 5","Tapestry (8/60 watt)  Faux Alabaster Glass","Accounts Receivable",NA,270,-176302.15
"3383","Revenue","Invoice","2018-07-05","71089","Cole Home Builders:Phase 1 - Lot 5","Chestnut (3/60 watt)  Marble Glass","Accounts Receivable",NA,292.5,-176594.65
"3384","Revenue","Invoice","2018-07-05","71089","Cole Home Builders:Phase 1 - Lot 5","Tiffany Collection,Golden Baroque, 1-light lantern, medium base (100 watt max)","Accounts Receivable",NA,183.6,-176778.25
"3385","Revenue","Invoice","2018-07-05","71089","Cole Home Builders:Phase 1 - Lot 5","2032 Series, (3-60 watt, Med) Desert Stone Finish","Accounts Receivable",NA,59.4,-176837.65
"3386","Revenue","Invoice","2018-07-05","71089","Cole Home Builders:Phase 1 - Lot 5","Tapestry, (2-60 watt Med), Etched Cracked Glass, Finish 10","Accounts Receivable",NA,81,-176918.65
"3387","Revenue","Invoice","2018-07-05","71089","Cole Home Builders:Phase 1 - Lot 5","18x8x10, Solid Brass, 3-60watt Medium Base, Satin Etched Glass","Accounts Receivable",NA,118.8,-177037.45
"3388","Revenue","Invoice","2018-07-05","71089","Cole Home Builders:Phase 1 - Lot 5","White, 4.5x7.5, 1-100 watt Medium Base, Satin White Glass","Accounts Receivable",NA,86.4,-177123.85
"3389","Revenue","Invoice","2018-07-05","71089","Cole Home Builders:Phase 1 - Lot 5","Drop Opal w/Solid Oak Frame, 49 1/2 x 17, 120v HPF","Accounts Receivable",NA,113.4,-177237.25
"3390","Revenue","Invoice","2018-07-05","71089","Cole Home Builders:Phase 1 - Lot 5","Verona Collection, Pendant, Cobblestone, Etched Alabaster Glass, 150 watt max","Accounts Receivable",NA,135,-177372.25
"3391","Revenue","Invoice","2018-07-05","71089","Cole Home Builders:Phase 1 - Lot 5","Fluorescent Lamp, T-12, Medium Bipin  (30pack)","Accounts Receivable",NA,13.5,-177385.75
"3392","Revenue","Invoice","2018-07-05","71089","Cole Home Builders:Phase 1 - Lot 5","Specialty Bulbs, 100 watt (6 pack)","Accounts Receivable",NA,49.5,-177435.25
"3393","Revenue","Invoice","2018-07-05","71089","Cole Home Builders:Phase 1 - Lot 5","Specialty, Stage & Studio Bulbs  60 watt","Accounts Receivable",NA,35.1,-177470.35
"3394","Revenue","Invoice","2018-07-12","71079","Cole Home Builders:Phase 1 - Lot 5","BrassGuard Lanterns, Polished Brass, 1-light Wall, (100 watt max)","Accounts Receivable",NA,288,-177758.35
"3395","Revenue","Invoice","2018-07-12","71079","Cole Home Builders:Phase 1 - Lot 5","Die Cast Lanterns, Black, 1-100 watt, Medium Base, Clear Cracked Glass","Accounts Receivable",NA,122.4,-177880.75
"3396","Revenue","Invoice","2018-07-12","71079","Cole Home Builders:Phase 1 - Lot 5","Sunset, Clear Glass, 1-100 watt max.","Accounts Receivable",NA,63,-177943.75
"3397","Revenue","Invoice","2018-07-12","71079","Cole Home Builders:Phase 1 - Lot 5","Beveled Mirror, Etched Ribbed Glass (75 watt max)","Accounts Receivable",NA,129.6,-178073.35
"3398","Revenue","Invoice","2018-07-12","71079","Cole Home Builders:Phase 1 - Lot 5","Broadway Collection, Polished Brass, 6 Light (60 watt max)","Accounts Receivable",NA,129.6,-178202.95
"3399","Revenue","Invoice","2018-07-12","71079","Cole Home Builders:Phase 1 - Lot 5","Brushed Nickel, 18x7.75x6, 3-60 watt Medium Base, Satin Opal Glass","Accounts Receivable",NA,45,-178247.95
"3400","Revenue","Invoice","2018-07-12","71079","Cole Home Builders:Phase 1 - Lot 5","Brushed Nickel, (3-60 watt, Med) Ribbed Glass","Accounts Receivable",NA,180,-178427.95
"3401","Revenue","Invoice","2018-07-12","71079","Cole Home Builders:Phase 1 - Lot 5","Brushed Nickel, Pendant, 1-100 watt Medium Base, Satin Etched Glass","Accounts Receivable",NA,198,-178625.95
"3402","Revenue","Invoice","2018-07-12","71079","Cole Home Builders:Phase 1 - Lot 5","Pendant Bar, Cobblestone, 50lbs. max","Accounts Receivable",NA,22.5,-178648.45
"3403","Revenue","Invoice","2018-07-12","71079","Cole Home Builders:Phase 1 - Lot 5","Verona Collection, Pendant, Cobblestone, Etched Alabaster Glass, 150 watt max","Accounts Receivable",NA,135,-178783.45
"3404","Revenue","Invoice","2018-07-12","71079","Cole Home Builders:Phase 1 - Lot 5","Chestnut (3/60 watt)  Marble Glass","Accounts Receivable",NA,292.5,-179075.95
"3405","Revenue","Invoice","2018-07-12","71079","Cole Home Builders:Phase 1 - Lot 5","Frosted Taupe (3/60 watt)  Marble Glass  ","Accounts Receivable",NA,279,-179354.95
"3406","Revenue","Invoice","2018-07-12","71079","Cole Home Builders:Phase 1 - Lot 5","Cand. Light, 20 watts (8 pack)","Accounts Receivable",NA,75.6,-179430.55
"3407","Revenue","Invoice","2018-07-12","71079","Cole Home Builders:Phase 1 - Lot 5","Specialty Bulbs, 100 watt (6 pack)","Accounts Receivable",NA,19.8,-179450.35
"3408","Revenue","Invoice","2018-07-12","71079","Cole Home Builders:Phase 1 - Lot 5","Specialty, Stage & Studio Bulbs  60 watt","Accounts Receivable",NA,29.25,-179479.6
"3409","Revenue","Invoice","2018-07-13","71119","Kern Lighting Warehouse:Store #01","Golden Umber (100 watt)  Six Light Chandelier","Accounts Receivable",NA,3150,-182629.6
"3410","Revenue","Invoice","2018-07-13","71119","Kern Lighting Warehouse:Store #01","Burnished Brass (60 watt)  w/Golden Umber Accents","Accounts Receivable",NA,3000,-185629.6
"3411","Revenue","Invoice","2018-07-16","71076","Cole Home Builders:Phase 1 - Lot 5","Golden Umber (100 watt)  Six Light Chandelier","Accounts Receivable",NA,283.5,-185913.1
"3412","Revenue","Invoice","2018-07-16","71076","Cole Home Builders:Phase 1 - Lot 5","Tapestry (8/60 watt)  Faux Alabaster Glass","Accounts Receivable",NA,270,-186183.1
"3413","Revenue","Invoice","2018-07-16","71076","Cole Home Builders:Phase 1 - Lot 5","Polished Brass Pendant, 1-100 watt Medium Base, Clear Ribbed Glass","Accounts Receivable",NA,261,-186444.1
"3414","Revenue","Invoice","2018-07-16","71076","Cole Home Builders:Phase 1 - Lot 5","Tapestry, (2-60 watt Med), Etched Cracked Glass, Finish 10","Accounts Receivable",NA,162,-186606.1
"3415","Revenue","Invoice","2018-07-16","71076","Cole Home Builders:Phase 1 - Lot 5","Verona Collection, Pendant, Cobblestone, Etched Alabaster Glass, 150 watt max","Accounts Receivable",NA,270,-186876.1
"3416","Revenue","Invoice","2018-07-16","71076","Cole Home Builders:Phase 1 - Lot 5","Pendant Bar, Cobblestone, 50lbs. max","Accounts Receivable",NA,45,-186921.1
"3417","Revenue","Invoice","2018-07-16","71076","Cole Home Builders:Phase 1 - Lot 5","Pearl Nickle, 5 Light, Medium Base (100 watt max)","Accounts Receivable",NA,171,-187092.1
"3418","Revenue","Invoice","2018-07-16","71076","Cole Home Builders:Phase 1 - Lot 5","White, 4.5x7.5, 1-100 watt Medium Base, Satin White Glass","Accounts Receivable",NA,57.6,-187149.7
"3419","Revenue","Invoice","2018-07-16","71076","Cole Home Builders:Phase 1 - Lot 5","Solid Brass, 4-light, 25x13x10.75, 4-60 watt, Medium Base, Satin Etched Glass","Accounts Receivable",NA,37.8,-187187.5
"3420","Revenue","Invoice","2018-07-16","71076","Cole Home Builders:Phase 1 - Lot 5","Acid Verde, 10x21x10, 2-60 watt cand.","Accounts Receivable",NA,104.4,-187291.9
"3421","Revenue","Invoice","2018-07-16","71076","Cole Home Builders:Phase 1 - Lot 5","BrassGuard Lanterns, Polished Brass, 1-light Wall, (100 watt max)","Accounts Receivable",NA,216,-187507.9
"3422","Revenue","Invoice","2018-07-16","71076","Cole Home Builders:Phase 1 - Lot 5","Black Finish, Solid Brass, Clear Glass, Hanging, 2-60 watt max.","Accounts Receivable",NA,75.6,-187583.5
"3423","Revenue","Invoice","2018-07-16","71076","Cole Home Builders:Phase 1 - Lot 5","Specialty, Stage & Studio Bulbs  60 watt","Accounts Receivable",NA,35.1,-187618.6
"3424","Revenue","Invoice","2018-07-16","71076","Cole Home Builders:Phase 1 - Lot 5","Specialty Bulbs, 100 watt (6 pack)","Accounts Receivable",NA,99,-187717.6
"3425","Revenue","Invoice","2018-07-16","71076","Cole Home Builders:Phase 1 - Lot 5","Cand. Light, 20 watts (8 pack)","Accounts Receivable",NA,50.4,-187768
"3426","Revenue","Invoice","2018-07-16","71115","Thompson Lighting Stores:Store #40","Acid Verde, 10x21x10, 2-60 watt cand.","Accounts Receivable",NA,348,-188116
"3427","Revenue","Invoice","2018-07-16","71115","Thompson Lighting Stores:Store #40","Die Cast Lanterns, Black, 1-100 watt, Medium Base, Clear Cracked Glass","Accounts Receivable",NA,272,-188388
"3428","Revenue","Invoice","2018-07-16","71115","Thompson Lighting Stores:Store #40","Polished Brass Pendant, 1-100 watt Medium Base, Clear Ribbed Glass","Accounts Receivable",NA,232,-188620
"3429","Revenue","Invoice","2018-07-16","71115","Thompson Lighting Stores:Store #40","2032 Series, (3-60 watt, Med) Desert Stone Finish","Accounts Receivable",NA,88,-188708
"3430","Revenue","Invoice","2018-07-16","71115","Thompson Lighting Stores:Store #40","Brushed Nickel, 18x7.75x6, 3-60 watt Medium Base, Satin Opal Glass","Accounts Receivable",NA,100,-188808
"3431","Revenue","Invoice","2018-07-16","71115","Thompson Lighting Stores:Store #40","Tapestry (8/60 watt)  Faux Alabaster Glass","Accounts Receivable",NA,300,-189108
"3432","Revenue","Invoice","2018-07-16","71115","Thompson Lighting Stores:Store #40","Frosted Taupe (3/60 watt)  Marble Glass  ","Accounts Receivable",NA,310,-189418
"3433","Revenue","Invoice","2018-07-16","71115","Thompson Lighting Stores:Store #40","Roman Bronze, 1-light Lantern, w/tail, (100 watt max)","Accounts Receivable",NA,340,-189758
"3434","Revenue","Invoice","2018-07-16","71115","Thompson Lighting Stores:Store #40","Domes, White, 59x21x6 5/8 ht, 120v HPF","Accounts Receivable",NA,135,-189893
"3435","Revenue","Invoice","2018-07-16","71115","Thompson Lighting Stores:Store #40","Flat Glass, (25 watt max) Polished Brass, 4 light","Accounts Receivable",NA,125,-190018
"3436","Revenue","Invoice","2018-07-16","71115","Thompson Lighting Stores:Store #40","Burnished Brass (60 watt)  w/Golden Umber Accents","Accounts Receivable",NA,300,-190318
"3437","Revenue","Invoice","2018-07-16","71115","Thompson Lighting Stores:Store #40","Pearl Nickle, 5 Light, Medium Base (100 watt max)","Accounts Receivable",NA,475,-190793
"3438","Revenue","Invoice","2018-07-17","71129","Kern Lighting Warehouse:Store #01","Sunset, Clear Glass, 1-100 watt max.","Accounts Receivable",NA,1225,-192018
"3439","Revenue","Invoice","2018-07-17","71129","Kern Lighting Warehouse:Store #01","Beveled Mirror, Etched Ribbed Glass (75 watt max)","Accounts Receivable",NA,960,-192978
"3440","Revenue","Invoice","2018-07-17","71129","Kern Lighting Warehouse:Store #01","Pendant Bar, Textured White, 50lbs max","Accounts Receivable",NA,625,-193603
"3441","Revenue","Invoice","2018-07-17","71129","Kern Lighting Warehouse:Store #01","Drop Opal w/Solid Oak Frame, 49 1/2 x 17, 120v HPF","Accounts Receivable",NA,630,-194233
"3442","Revenue","Invoice","2018-07-17","71129","Kern Lighting Warehouse:Store #01","Flat Glass, (25 watt max) Polished Brass, 4 light","Accounts Receivable",NA,625,-194858
"3443","Revenue","Invoice","2018-07-17","71129","Kern Lighting Warehouse:Store #01","Verona Collection, Pendant, Cobblestone, Etched Alabaster Glass, 150 watt max","Accounts Receivable",NA,3750,-198608
"3444","Revenue","Invoice","2018-07-17","71129","Kern Lighting Warehouse:Store #01","Athena Collection, Pendant, Textured White, Med. Base, 100 watt max.","Accounts Receivable",NA,3250,-201858
"3445","Revenue","Invoice","2018-07-17","71129","Kern Lighting Warehouse:Store #01","Golden Umber (100 watt)  Six Light Chandelier","Accounts Receivable",NA,7875,-209733
"3446","Revenue","Invoice","2018-07-24","71097","Miscellaneous - Retail:Sean Martin","Black Finish, Solid Brass,Wall Mount w/Clear Glass (2x60watt max)","Accounts Receivable",NA,750,-210483
"3447","Revenue","Invoice","2018-07-24","71097","Miscellaneous - Retail:Sean Martin","Golden Umber (100 watt)  Six Light Chandelier","Accounts Receivable",NA,630,-211113
"3448","Revenue","Invoice","2018-07-24","71097","Miscellaneous - Retail:Sean Martin","Brushed Nickel, 18x7.75x6, 3-60 watt Medium Base, Satin Opal Glass","Accounts Receivable",NA,75,-211188
"3449","Revenue","Invoice","2018-07-24","71097","Miscellaneous - Retail:Sean Martin","Domes, White, 59x21x6 5/8 ht, 120v HPF","Accounts Receivable",NA,45,-211233
"3450","Revenue","Invoice","2018-07-24","71097","Miscellaneous - Retail:Sean Martin","Drop Opal w/Solid Oak Frame, 49 1/2 x 17, 120v HPF","Accounts Receivable",NA,42,-211275
"3451","Revenue","Invoice","2018-07-27","71078","Cole Home Builders:Phase 1 - Lot 5","BrassGuard Lanterns, Polished Brass, 1-light Wall, (100 watt max)","Accounts Receivable",NA,288,-211563
"3452","Revenue","Invoice","2018-07-27","71078","Cole Home Builders:Phase 1 - Lot 5","Die Cast Lanterns, Black, 1-100 watt, Medium Base, Clear Cracked Glass","Accounts Receivable",NA,122.4,-211685.4
"3453","Revenue","Invoice","2018-07-27","71078","Cole Home Builders:Phase 1 - Lot 5","Sunset, Clear Glass, 1-100 watt max.","Accounts Receivable",NA,63,-211748.4
"3454","Revenue","Invoice","2018-07-27","71078","Cole Home Builders:Phase 1 - Lot 5","Beveled Mirror, Etched Ribbed Glass (75 watt max)","Accounts Receivable",NA,129.6,-211878
"3455","Revenue","Invoice","2018-07-27","71078","Cole Home Builders:Phase 1 - Lot 5","Broadway Collection, Polished Brass, 6 Light (60 watt max)","Accounts Receivable",NA,129.6,-212007.6
"3456","Revenue","Invoice","2018-07-27","71078","Cole Home Builders:Phase 1 - Lot 5","Brushed Nickel, 18x7.75x6, 3-60 watt Medium Base, Satin Opal Glass","Accounts Receivable",NA,45,-212052.6
"3457","Revenue","Invoice","2018-07-27","71078","Cole Home Builders:Phase 1 - Lot 5","Brushed Nickel, (3-60 watt, Med) Ribbed Glass","Accounts Receivable",NA,180,-212232.6
"3458","Revenue","Invoice","2018-07-27","71078","Cole Home Builders:Phase 1 - Lot 5","Brushed Nickel, Pendant, 1-100 watt Medium Base, Satin Etched Glass","Accounts Receivable",NA,198,-212430.6
"3459","Revenue","Invoice","2018-07-27","71078","Cole Home Builders:Phase 1 - Lot 5","Pendant Bar, Cobblestone, 50lbs. max","Accounts Receivable",NA,22.5,-212453.1
"3460","Revenue","Invoice","2018-07-27","71078","Cole Home Builders:Phase 1 - Lot 5","Verona Collection, Pendant, Cobblestone, Etched Alabaster Glass, 150 watt max","Accounts Receivable",NA,135,-212588.1
"3461","Revenue","Invoice","2018-07-27","71078","Cole Home Builders:Phase 1 - Lot 5","Chestnut (3/60 watt)  Marble Glass","Accounts Receivable",NA,292.5,-212880.6
"3462","Revenue","Invoice","2018-07-27","71078","Cole Home Builders:Phase 1 - Lot 5","Frosted Taupe (3/60 watt)  Marble Glass  ","Accounts Receivable",NA,279,-213159.6
"3463","Revenue","Invoice","2018-07-27","71078","Cole Home Builders:Phase 1 - Lot 5","Cand. Light, 20 watts (8 pack)","Accounts Receivable",NA,75.6,-213235.2
"3464","Revenue","Invoice","2018-07-27","71078","Cole Home Builders:Phase 1 - Lot 5","Specialty Bulbs, 100 watt (6 pack)","Accounts Receivable",NA,19.8,-213255
"3465","Revenue","Invoice","2018-07-27","71078","Cole Home Builders:Phase 1 - Lot 5","Specialty, Stage & Studio Bulbs  60 watt","Accounts Receivable",NA,29.25,-213284.25
"3466","Revenue","Invoice","2018-07-31","71077","Cole Home Builders:Phase 1 - Lot 5","BrassGuard Lanterns, Polished Brass, 1-light Wall, (100 watt max)","Accounts Receivable",NA,288,-213572.25
"3467","Revenue","Invoice","2018-07-31","71077","Cole Home Builders:Phase 1 - Lot 5","Die Cast Lanterns, Black, 1-100 watt, Medium Base, Clear Cracked Glass","Accounts Receivable",NA,122.4,-213694.65
"3468","Revenue","Invoice","2018-07-31","71077","Cole Home Builders:Phase 1 - Lot 5","Sunset, Clear Glass, 1-100 watt max.","Accounts Receivable",NA,63,-213757.65
"3469","Revenue","Invoice","2018-07-31","71077","Cole Home Builders:Phase 1 - Lot 5","Beveled Mirror, Etched Ribbed Glass (75 watt max)","Accounts Receivable",NA,129.6,-213887.25
"3470","Revenue","Invoice","2018-07-31","71077","Cole Home Builders:Phase 1 - Lot 5","Broadway Collection, Polished Brass, 6 Light (60 watt max)","Accounts Receivable",NA,129.6,-214016.85
"3471","Revenue","Invoice","2018-07-31","71077","Cole Home Builders:Phase 1 - Lot 5","Brushed Nickel, 18x7.75x6, 3-60 watt Medium Base, Satin Opal Glass","Accounts Receivable",NA,45,-214061.85
"3472","Revenue","Invoice","2018-07-31","71077","Cole Home Builders:Phase 1 - Lot 5","Brushed Nickel, (3-60 watt, Med) Ribbed Glass","Accounts Receivable",NA,180,-214241.85
"3473","Revenue","Invoice","2018-07-31","71077","Cole Home Builders:Phase 1 - Lot 5","Brushed Nickel, Pendant, 1-100 watt Medium Base, Satin Etched Glass","Accounts Receivable",NA,198,-214439.85
"3474","Revenue","Invoice","2018-07-31","71077","Cole Home Builders:Phase 1 - Lot 5","Pendant Bar, Cobblestone, 50lbs. max","Accounts Receivable",NA,22.5,-214462.35
"3475","Revenue","Invoice","2018-07-31","71077","Cole Home Builders:Phase 1 - Lot 5","Verona Collection, Pendant, Cobblestone, Etched Alabaster Glass, 150 watt max","Accounts Receivable",NA,135,-214597.35
"3476","Revenue","Invoice","2018-07-31","71077","Cole Home Builders:Phase 1 - Lot 5","Chestnut (3/60 watt)  Marble Glass","Accounts Receivable",NA,292.5,-214889.85
"3477","Revenue","Invoice","2018-07-31","71077","Cole Home Builders:Phase 1 - Lot 5","Frosted Taupe (3/60 watt)  Marble Glass  ","Accounts Receivable",NA,279,-215168.85
"3478","Revenue","Invoice","2018-07-31","71077","Cole Home Builders:Phase 1 - Lot 5","Cand. Light, 20 watts (8 pack)","Accounts Receivable",NA,75.6,-215244.45
"3479","Revenue","Invoice","2018-07-31","71077","Cole Home Builders:Phase 1 - Lot 5","Specialty Bulbs, 100 watt (6 pack)","Accounts Receivable",NA,19.8,-215264.25
"3480","Revenue","Invoice","2018-07-31","71077","Cole Home Builders:Phase 1 - Lot 5","Specialty, Stage & Studio Bulbs  60 watt","Accounts Receivable",NA,29.25,-215293.5
"3481","Revenue","Invoice","2018-08-07","71098","Miscellaneous - Retail:Jann Minor","Acid Verde, 10x21x10, 2-60 watt cand.","Accounts Receivable",NA,870,-216163.5
"3482","Revenue","Invoice","2018-08-07","71098","Miscellaneous - Retail:Jann Minor","Beveled Mirror, Etched Ribbed Glass (75 watt max)","Accounts Receivable",NA,240,-216403.5
"3483","Revenue","Invoice","2018-08-07","71098","Miscellaneous - Retail:Jann Minor","Chestnut (3/60 watt)  Marble Glass","Accounts Receivable",NA,975,-217378.5
"3484","Revenue","Invoice","2018-08-10","71090","Cole Home Builders:Phase 2 - Lot 5","BrassGuard Lanterns, Polished Brass, 1-light Wall, (100 watt max)","Accounts Receivable",NA,288,-217666.5
"3485","Revenue","Invoice","2018-08-10","71090","Cole Home Builders:Phase 2 - Lot 5","Die Cast Lanterns, Black, 1-100 watt, Medium Base, Clear Cracked Glass","Accounts Receivable",NA,122.4,-217788.9
"3486","Revenue","Invoice","2018-08-10","71090","Cole Home Builders:Phase 2 - Lot 5","Sunset, Clear Glass, 1-100 watt max.","Accounts Receivable",NA,63,-217851.9
"3487","Revenue","Invoice","2018-08-10","71090","Cole Home Builders:Phase 2 - Lot 5","Beveled Mirror, Etched Ribbed Glass (75 watt max)","Accounts Receivable",NA,129.6,-217981.5
"3488","Revenue","Invoice","2018-08-10","71090","Cole Home Builders:Phase 2 - Lot 5","Broadway Collection, Polished Brass, 6 Light (60 watt max)","Accounts Receivable",NA,129.6,-218111.1
"3489","Revenue","Invoice","2018-08-10","71090","Cole Home Builders:Phase 2 - Lot 5","Brushed Nickel, 18x7.75x6, 3-60 watt Medium Base, Satin Opal Glass","Accounts Receivable",NA,45,-218156.1
"3490","Revenue","Invoice","2018-08-10","71090","Cole Home Builders:Phase 2 - Lot 5","Brushed Nickel, (3-60 watt, Med) Ribbed Glass","Accounts Receivable",NA,180,-218336.1
"3491","Revenue","Invoice","2018-08-10","71090","Cole Home Builders:Phase 2 - Lot 5","Brushed Nickel, Pendant, 1-100 watt Medium Base, Satin Etched Glass","Accounts Receivable",NA,198,-218534.1
"3492","Revenue","Invoice","2018-08-10","71090","Cole Home Builders:Phase 2 - Lot 5","Pendant Bar, Cobblestone, 50lbs. max","Accounts Receivable",NA,22.5,-218556.6
"3493","Revenue","Invoice","2018-08-10","71090","Cole Home Builders:Phase 2 - Lot 5","Verona Collection, Pendant, Cobblestone, Etched Alabaster Glass, 150 watt max","Accounts Receivable",NA,135,-218691.6
"3494","Revenue","Invoice","2018-08-10","71090","Cole Home Builders:Phase 2 - Lot 5","Chestnut (3/60 watt)  Marble Glass","Accounts Receivable",NA,292.5,-218984.1
"3495","Revenue","Invoice","2018-08-10","71090","Cole Home Builders:Phase 2 - Lot 5","Frosted Taupe (3/60 watt)  Marble Glass  ","Accounts Receivable",NA,279,-219263.1
"3496","Revenue","Invoice","2018-08-10","71090","Cole Home Builders:Phase 2 - Lot 5","Cand. Light, 20 watts (8 pack)","Accounts Receivable",NA,75.6,-219338.7
"3497","Revenue","Invoice","2018-08-10","71090","Cole Home Builders:Phase 2 - Lot 5","Specialty Bulbs, 100 watt (6 pack)","Accounts Receivable",NA,19.8,-219358.5
"3498","Revenue","Invoice","2018-08-10","71090","Cole Home Builders:Phase 2 - Lot 5","Specialty, Stage & Studio Bulbs  60 watt","Accounts Receivable",NA,29.25,-219387.75
"3499","Revenue","Invoice","2018-08-17","71075","Cole Home Builders:Phase 1 - Lot 5","Golden Umber (100 watt)  Six Light Chandelier","Accounts Receivable",NA,283.5,-219671.25
"3500","Revenue","Invoice","2018-08-17","71075","Cole Home Builders:Phase 1 - Lot 5","Tapestry (8/60 watt)  Faux Alabaster Glass","Accounts Receivable",NA,270,-219941.25
"3501","Revenue","Invoice","2018-08-17","71075","Cole Home Builders:Phase 1 - Lot 5","Polished Brass Pendant, 1-100 watt Medium Base, Clear Ribbed Glass","Accounts Receivable",NA,261,-220202.25
"3502","Revenue","Invoice","2018-08-17","71075","Cole Home Builders:Phase 1 - Lot 5","Tapestry, (2-60 watt Med), Etched Cracked Glass, Finish 10","Accounts Receivable",NA,162,-220364.25
"3503","Revenue","Invoice","2018-08-17","71075","Cole Home Builders:Phase 1 - Lot 5","Verona Collection, Pendant, Cobblestone, Etched Alabaster Glass, 150 watt max","Accounts Receivable",NA,270,-220634.25
"3504","Revenue","Invoice","2018-08-17","71075","Cole Home Builders:Phase 1 - Lot 5","Pendant Bar, Cobblestone, 50lbs. max","Accounts Receivable",NA,45,-220679.25
"3505","Revenue","Invoice","2018-08-17","71075","Cole Home Builders:Phase 1 - Lot 5","Pearl Nickle, 5 Light, Medium Base (100 watt max)","Accounts Receivable",NA,171,-220850.25
"3506","Revenue","Invoice","2018-08-17","71075","Cole Home Builders:Phase 1 - Lot 5","White, 4.5x7.5, 1-100 watt Medium Base, Satin White Glass","Accounts Receivable",NA,57.6,-220907.85
"3507","Revenue","Invoice","2018-08-17","71075","Cole Home Builders:Phase 1 - Lot 5","Solid Brass, 4-light, 25x13x10.75, 4-60 watt, Medium Base, Satin Etched Glass","Accounts Receivable",NA,37.8,-220945.65
"3508","Revenue","Invoice","2018-08-17","71075","Cole Home Builders:Phase 1 - Lot 5","Acid Verde, 10x21x10, 2-60 watt cand.","Accounts Receivable",NA,104.4,-221050.05
"3509","Revenue","Invoice","2018-08-17","71075","Cole Home Builders:Phase 1 - Lot 5","BrassGuard Lanterns, Polished Brass, 1-light Wall, (100 watt max)","Accounts Receivable",NA,216,-221266.05
"3510","Revenue","Invoice","2018-08-17","71075","Cole Home Builders:Phase 1 - Lot 5","Black Finish, Solid Brass, Clear Glass, Hanging, 2-60 watt max.","Accounts Receivable",NA,75.6,-221341.65
"3511","Revenue","Invoice","2018-08-17","71075","Cole Home Builders:Phase 1 - Lot 5","Specialty, Stage & Studio Bulbs  60 watt","Accounts Receivable",NA,35.1,-221376.75
"3512","Revenue","Invoice","2018-08-17","71075","Cole Home Builders:Phase 1 - Lot 5","Specialty Bulbs, 100 watt (6 pack)","Accounts Receivable",NA,99,-221475.75
"3513","Revenue","Invoice","2018-08-17","71075","Cole Home Builders:Phase 1 - Lot 5","Cand. Light, 20 watts (8 pack)","Accounts Receivable",NA,50.4,-221526.15
"3514","Revenue","Invoice","2018-08-22","71109","Dan A. North Builders:Turner Suites","Tapestry, (2-60 watt Med), Etched Cracked Glass, Finish 10","Accounts Receivable",NA,4500,-226026.15
"3515","Revenue","Invoice","2018-08-22","71109","Dan A. North Builders:Turner Suites","Vianne Lanterns, Satin Antiqued Solid Brass, 3-light wall latern, Candelabra base (60 watt max)","Accounts Receivable",NA,5000,-231026.15
"3516","Revenue","Invoice","2018-08-22","71109","Dan A. North Builders:Turner Suites","Black Finish, Solid Brass, Clear Glass, Hanging, 2-60 watt max.","Accounts Receivable",NA,3150,-234176.15
"3517","Revenue","Invoice","2018-08-22","71109","Dan A. North Builders:Turner Suites","Specialty, Stage & Studio Bulbs  60 watt","Accounts Receivable",NA,650,-234826.15
"3518","Revenue","Invoice","2018-08-24","71074","Cole Home Builders:Phase 1 - Lot 5","Golden Umber (100 watt)  Six Light Chandelier","Accounts Receivable",NA,283.5,-235109.65
"3519","Revenue","Invoice","2018-08-24","71074","Cole Home Builders:Phase 1 - Lot 5","Tapestry (8/60 watt)  Faux Alabaster Glass","Accounts Receivable",NA,270,-235379.65
"3520","Revenue","Invoice","2018-08-24","71074","Cole Home Builders:Phase 1 - Lot 5","Polished Brass Pendant, 1-100 watt Medium Base, Clear Ribbed Glass","Accounts Receivable",NA,261,-235640.65
"3521","Revenue","Invoice","2018-08-24","71074","Cole Home Builders:Phase 1 - Lot 5","Tapestry, (2-60 watt Med), Etched Cracked Glass, Finish 10","Accounts Receivable",NA,162,-235802.65
"3522","Revenue","Invoice","2018-08-24","71074","Cole Home Builders:Phase 1 - Lot 5","Verona Collection, Pendant, Cobblestone, Etched Alabaster Glass, 150 watt max","Accounts Receivable",NA,270,-236072.65
"3523","Revenue","Invoice","2018-08-24","71074","Cole Home Builders:Phase 1 - Lot 5","Pendant Bar, Cobblestone, 50lbs. max","Accounts Receivable",NA,45,-236117.65
"3524","Revenue","Invoice","2018-08-24","71074","Cole Home Builders:Phase 1 - Lot 5","Pearl Nickle, 5 Light, Medium Base (100 watt max)","Accounts Receivable",NA,171,-236288.65
"3525","Revenue","Invoice","2018-08-24","71074","Cole Home Builders:Phase 1 - Lot 5","White, 4.5x7.5, 1-100 watt Medium Base, Satin White Glass","Accounts Receivable",NA,57.6,-236346.25
"3526","Revenue","Invoice","2018-08-24","71074","Cole Home Builders:Phase 1 - Lot 5","Solid Brass, 4-light, 25x13x10.75, 4-60 watt, Medium Base, Satin Etched Glass","Accounts Receivable",NA,37.8,-236384.05
"3527","Revenue","Invoice","2018-08-24","71074","Cole Home Builders:Phase 1 - Lot 5","Acid Verde, 10x21x10, 2-60 watt cand.","Accounts Receivable",NA,104.4,-236488.45
"3528","Revenue","Invoice","2018-08-24","71074","Cole Home Builders:Phase 1 - Lot 5","BrassGuard Lanterns, Polished Brass, 1-light Wall, (100 watt max)","Accounts Receivable",NA,216,-236704.45
"3529","Revenue","Invoice","2018-08-24","71074","Cole Home Builders:Phase 1 - Lot 5","Black Finish, Solid Brass, Clear Glass, Hanging, 2-60 watt max.","Accounts Receivable",NA,75.6,-236780.05
"3530","Revenue","Invoice","2018-08-24","71074","Cole Home Builders:Phase 1 - Lot 5","Specialty, Stage & Studio Bulbs  60 watt","Accounts Receivable",NA,35.1,-236815.15
"3531","Revenue","Invoice","2018-08-24","71074","Cole Home Builders:Phase 1 - Lot 5","Specialty Bulbs, 100 watt (6 pack)","Accounts Receivable",NA,99,-236914.15
"3532","Revenue","Invoice","2018-08-24","71074","Cole Home Builders:Phase 1 - Lot 5","Cand. Light, 20 watts (8 pack)","Accounts Receivable",NA,50.4,-236964.55
"3533","Revenue","Invoice","2018-08-30","71130","Kern Lighting Warehouse:Store #45","Renaissance Collection, (100 watt max) Millstone Finish, One-light","Accounts Receivable",NA,1125,-238089.55
"3534","Revenue","Invoice","2018-08-30","71130","Kern Lighting Warehouse:Store #45","Pearl Nickle, 5 Light, Medium Base (100 watt max)","Accounts Receivable",NA,3800,-241889.55
"3535","Revenue","Invoice","2018-08-30","71130","Kern Lighting Warehouse:Store #45","Specialty Bulbs, 100 watt (6 pack)","Accounts Receivable",NA,275,-242164.55
"3536","Revenue","Invoice","2018-08-30","71130","Kern Lighting Warehouse:Store #45","Cand. Light, 20 watts (8 pack)","Accounts Receivable",NA,2800,-244964.55
"3537","Revenue","Invoice","2018-08-31","71073","Cole Home Builders:Phase 1 - Lot 5","Golden Umber (100 watt)  Six Light Chandelier","Accounts Receivable",NA,283.5,-245248.05
"3538","Revenue","Invoice","2018-08-31","71073","Cole Home Builders:Phase 1 - Lot 5","Tapestry (8/60 watt)  Faux Alabaster Glass","Accounts Receivable",NA,270,-245518.05
"3539","Revenue","Invoice","2018-08-31","71073","Cole Home Builders:Phase 1 - Lot 5","Polished Brass Pendant, 1-100 watt Medium Base, Clear Ribbed Glass","Accounts Receivable",NA,261,-245779.05
"3540","Revenue","Invoice","2018-08-31","71073","Cole Home Builders:Phase 1 - Lot 5","Tapestry, (2-60 watt Med), Etched Cracked Glass, Finish 10","Accounts Receivable",NA,162,-245941.05
"3541","Revenue","Invoice","2018-08-31","71073","Cole Home Builders:Phase 1 - Lot 5","Verona Collection, Pendant, Cobblestone, Etched Alabaster Glass, 150 watt max","Accounts Receivable",NA,270,-246211.05
"3542","Revenue","Invoice","2018-08-31","71073","Cole Home Builders:Phase 1 - Lot 5","Pendant Bar, Cobblestone, 50lbs. max","Accounts Receivable",NA,45,-246256.05
"3543","Revenue","Invoice","2018-08-31","71073","Cole Home Builders:Phase 1 - Lot 5","Pearl Nickle, 5 Light, Medium Base (100 watt max)","Accounts Receivable",NA,171,-246427.05
"3544","Revenue","Invoice","2018-08-31","71073","Cole Home Builders:Phase 1 - Lot 5","White, 4.5x7.5, 1-100 watt Medium Base, Satin White Glass","Accounts Receivable",NA,57.6,-246484.65
"3545","Revenue","Invoice","2018-08-31","71073","Cole Home Builders:Phase 1 - Lot 5","Solid Brass, 4-light, 25x13x10.75, 4-60 watt, Medium Base, Satin Etched Glass","Accounts Receivable",NA,37.8,-246522.45
"3546","Revenue","Invoice","2018-08-31","71073","Cole Home Builders:Phase 1 - Lot 5","Acid Verde, 10x21x10, 2-60 watt cand.","Accounts Receivable",NA,104.4,-246626.85
"3547","Revenue","Invoice","2018-08-31","71073","Cole Home Builders:Phase 1 - Lot 5","BrassGuard Lanterns, Polished Brass, 1-light Wall, (100 watt max)","Accounts Receivable",NA,216,-246842.85
"3548","Revenue","Invoice","2018-08-31","71073","Cole Home Builders:Phase 1 - Lot 5","Black Finish, Solid Brass, Clear Glass, Hanging, 2-60 watt max.","Accounts Receivable",NA,75.6,-246918.45
"3549","Revenue","Invoice","2018-08-31","71073","Cole Home Builders:Phase 1 - Lot 5","Specialty, Stage & Studio Bulbs  60 watt","Accounts Receivable",NA,35.1,-246953.55
"3550","Revenue","Invoice","2018-08-31","71073","Cole Home Builders:Phase 1 - Lot 5","Specialty Bulbs, 100 watt (6 pack)","Accounts Receivable",NA,99,-247052.55
"3551","Revenue","Invoice","2018-08-31","71073","Cole Home Builders:Phase 1 - Lot 5","Cand. Light, 20 watts (8 pack)","Accounts Receivable",NA,50.4,-247102.95
"3552","Revenue","Invoice","2018-09-11","71099","Miscellaneous - Retail:Jason Helper","Sunset, Clear Glass, 1-100 watt max.","Accounts Receivable",NA,700,-247802.95
"3553","Revenue","Invoice","2018-09-11","71099","Miscellaneous - Retail:Jason Helper","Black Finish, Solid Brass, Clear Glass, Hanging, 2-60 watt max.","Accounts Receivable",NA,84,-247886.95
"3554","Revenue","Invoice","2018-09-11","71099","Miscellaneous - Retail:Jason Helper","White, 4.5x7.5, 1-100 watt Medium Base, Satin White Glass","Accounts Receivable",NA,128,-248014.95
"3555","Revenue","Invoice","2018-09-11","71099","Miscellaneous - Retail:Jason Helper","Golden Umber (100 watt)  Six Light Chandelier","Accounts Receivable",NA,630,-248644.95
"3556","Revenue","Invoice","2018-09-11","71099","Miscellaneous - Retail:Jason Helper","Brushed Nickel, Pendant, 1-100 watt Medium Base, Satin Etched Glass","Accounts Receivable",NA,220,-248864.95
"3557","Revenue","Invoice","2018-09-11","71099","Miscellaneous - Retail:Jason Helper","Pendant Bar, Textured White, 50lbs max","Accounts Receivable",NA,50,-248914.95
"3558","Revenue","Invoice","2018-09-14","71091","Cole Home Builders:Phase 2 - Lot 5","Golden Umber (100 watt)  Six Light Chandelier","Accounts Receivable",NA,283.5,-249198.45
"3559","Revenue","Invoice","2018-09-14","71091","Cole Home Builders:Phase 2 - Lot 5","Tapestry (8/60 watt)  Faux Alabaster Glass","Accounts Receivable",NA,270,-249468.45
"3560","Revenue","Invoice","2018-09-14","71091","Cole Home Builders:Phase 2 - Lot 5","Polished Brass Pendant, 1-100 watt Medium Base, Clear Ribbed Glass","Accounts Receivable",NA,261,-249729.45
"3561","Revenue","Invoice","2018-09-14","71091","Cole Home Builders:Phase 2 - Lot 5","Tapestry, (2-60 watt Med), Etched Cracked Glass, Finish 10","Accounts Receivable",NA,162,-249891.45
"3562","Revenue","Invoice","2018-09-14","71091","Cole Home Builders:Phase 2 - Lot 5","Verona Collection, Pendant, Cobblestone, Etched Alabaster Glass, 150 watt max","Accounts Receivable",NA,270,-250161.45
"3563","Revenue","Invoice","2018-09-14","71091","Cole Home Builders:Phase 2 - Lot 5","Pendant Bar, Cobblestone, 50lbs. max","Accounts Receivable",NA,45,-250206.45
"3564","Revenue","Invoice","2018-09-14","71091","Cole Home Builders:Phase 2 - Lot 5","Pearl Nickle, 5 Light, Medium Base (100 watt max)","Accounts Receivable",NA,171,-250377.45
"3565","Revenue","Invoice","2018-09-14","71091","Cole Home Builders:Phase 2 - Lot 5","White, 4.5x7.5, 1-100 watt Medium Base, Satin White Glass","Accounts Receivable",NA,57.6,-250435.05
"3566","Revenue","Invoice","2018-09-14","71091","Cole Home Builders:Phase 2 - Lot 5","Solid Brass, 4-light, 25x13x10.75, 4-60 watt, Medium Base, Satin Etched Glass","Accounts Receivable",NA,37.8,-250472.85
"3567","Revenue","Invoice","2018-09-14","71091","Cole Home Builders:Phase 2 - Lot 5","Acid Verde, 10x21x10, 2-60 watt cand.","Accounts Receivable",NA,104.4,-250577.25
"3568","Revenue","Invoice","2018-09-14","71091","Cole Home Builders:Phase 2 - Lot 5","BrassGuard Lanterns, Polished Brass, 1-light Wall, (100 watt max)","Accounts Receivable",NA,216,-250793.25
"3569","Revenue","Invoice","2018-09-14","71091","Cole Home Builders:Phase 2 - Lot 5","Black Finish, Solid Brass, Clear Glass, Hanging, 2-60 watt max.","Accounts Receivable",NA,75.6,-250868.85
"3570","Revenue","Invoice","2018-09-14","71091","Cole Home Builders:Phase 2 - Lot 5","Specialty, Stage & Studio Bulbs  60 watt","Accounts Receivable",NA,35.1,-250903.95
"3571","Revenue","Invoice","2018-09-14","71091","Cole Home Builders:Phase 2 - Lot 5","Specialty Bulbs, 100 watt (6 pack)","Accounts Receivable",NA,99,-251002.95
"3572","Revenue","Invoice","2018-09-14","71091","Cole Home Builders:Phase 2 - Lot 5","Cand. Light, 20 watts (8 pack)","Accounts Receivable",NA,50.4,-251053.35
"3573","Revenue","Invoice","2018-09-19","71131","Kern Lighting Warehouse:Store #13","White, 4.5x7.5, 1-100 watt Medium Base, Satin White Glass","Accounts Receivable",NA,512,-251565.35
"3574","Revenue","Invoice","2018-09-19","71131","Kern Lighting Warehouse:Store #13","Solid Brass, 4-light, 25x13x10.75, 4-60 watt, Medium Base, Satin Etched Glass","Accounts Receivable",NA,672,-252237.35
"3575","Revenue","Invoice","2018-09-19","71131","Kern Lighting Warehouse:Store #13","Brushed Nickel, 18x7.75x6, 3-60 watt Medium Base, Satin Opal Glass","Accounts Receivable",NA,625,-252862.35
"3576","Revenue","Invoice","2018-09-19","71131","Kern Lighting Warehouse:Store #13","River Rock (8/60 watt)  Faux Alabaster Glass","Accounts Receivable",NA,2400,-255262.35
"3577","Revenue","Invoice","2018-09-19","71131","Kern Lighting Warehouse:Store #13","Die Cast Lanterns, Black, 1-100 watt, Medium Base, Clear Cracked Glass","Accounts Receivable",NA,1360,-256622.35
"3578","Revenue","Invoice","2018-09-25","71100","Miscellaneous - Retail:John Huhn","Roman Bronze, 1-light Lantern, w/tail, (100 watt max)","Accounts Receivable",NA,1275,-257897.35
"3579","Revenue","Invoice","2018-09-25","71100","Miscellaneous - Retail:John Huhn","18x8x10, Solid Brass, 3-60watt Medium Base, Satin Etched Glass","Accounts Receivable",NA,264,-258161.35
"3580","Revenue","Invoice","2018-09-25","71100","Miscellaneous - Retail:John Huhn","Verona Collection, Pendant, Cobblestone, Etched Alabaster Glass, 150 watt max","Accounts Receivable",NA,600,-258761.35
"3581","Revenue","Invoice","2018-09-25","71100","Miscellaneous - Retail:John Huhn","Pendant Bar, Cobblestone, 50lbs. max","Accounts Receivable",NA,100,-258861.35
"3582","Revenue","Invoice","2018-09-25","71107","Stern Commercial Contractor's:Tittle Properties","White, 4.5x7.5, 1-100 watt Medium Base, Satin White Glass","Accounts Receivable",NA,5760,-264621.35
"3583","Revenue","Invoice","2018-09-25","71107","Stern Commercial Contractor's:Tittle Properties","Colonial, Brushed Steel Finish, Opal White Glass (60 watt)","Accounts Receivable",NA,1890,-266511.35
"3584","Revenue","Invoice","2018-09-25","71107","Stern Commercial Contractor's:Tittle Properties","Colonial, Finished in Gold (60 watt)  ","Accounts Receivable",NA,1935,-268446.35
"3585","Revenue","Invoice","2018-09-25","71107","Stern Commercial Contractor's:Tittle Properties","Sunset, Clear Glass, 1-100 watt max.","Accounts Receivable",NA,6300,-274746.35
"3586","Revenue","Invoice","2018-09-25","71107","Stern Commercial Contractor's:Tittle Properties","Specialty Bulbs, 100 watt (6 pack)","Accounts Receivable",NA,198,-274944.35
"3587","Revenue","Invoice","2018-09-25","71107","Stern Commercial Contractor's:Tittle Properties","Fluorescent Lamp, T-12, Medium Bipin  (30pack)","Accounts Receivable",NA,1350,-276294.35
"3588","Revenue","Invoice","2018-10-09","71101","Miscellaneous - Retail:Doug Jacobsen","Die Cast Lanterns, Black, 1-100 watt, Medium Base, Clear Cracked Glass","Accounts Receivable",NA,544,-276838.35
"3589","Revenue","Invoice","2018-10-09","71101","Miscellaneous - Retail:Doug Jacobsen","Black Finish, Solid Brass, Clear Glass, Hanging, 2-60 watt max.","Accounts Receivable",NA,84,-276922.35
"3590","Revenue","Invoice","2018-10-09","71101","Miscellaneous - Retail:Doug Jacobsen","Tapestry (8/60 watt)  Faux Alabaster Glass","Accounts Receivable",NA,900,-277822.35
"3591","Revenue","Invoice","2018-10-09","71101","Miscellaneous - Retail:Doug Jacobsen","Broadway Collection, Polished Chrome, 4 Light (60 watt max)","Accounts Receivable",NA,141,-277963.35
"3592","Revenue","Invoice","2018-10-09","71101","Miscellaneous - Retail:Doug Jacobsen","Flat Glass, (25 watt max) Polished Brass, 4 light","Accounts Receivable",NA,50,-278013.35
"3593","Revenue","Invoice","2018-10-15","71132","Kern Lighting Warehouse:Store #34","Acid Verde, 10x21x10, 2-60 watt cand.","Accounts Receivable",NA,2030,-280043.35
"3594","Revenue","Invoice","2018-10-15","71132","Kern Lighting Warehouse:Store #34","Die Cast Lanterns, Black, 1-100 watt, Medium Base, Clear Cracked Glass","Accounts Receivable",NA,1360,-281403.35
"3595","Revenue","Invoice","2018-10-15","71132","Kern Lighting Warehouse:Store #34","Polished Brass Pendant, 1-100 watt Medium Base, Clear Ribbed Glass","Accounts Receivable",NA,58,-281461.35
"3596","Revenue","Invoice","2018-10-15","71132","Kern Lighting Warehouse:Store #34","Brushed Nickel, 18x7.75x6, 3-60 watt Medium Base, Satin Opal Glass","Accounts Receivable",NA,250,-281711.35
"3597","Revenue","Invoice","2018-10-15","71132","Kern Lighting Warehouse:Store #34","Brushed Nickel, (3-60 watt, Med) Ribbed Glass","Accounts Receivable",NA,400,-282111.35
"3598","Revenue","Invoice","2018-10-15","71132","Kern Lighting Warehouse:Store #34","Fluorescent Lamp, T-12, Medium Bipin  (30pack)","Accounts Receivable",NA,750,-282861.35
"3599","Revenue","Invoice","2018-10-15","71132","Kern Lighting Warehouse:Store #34","Halogen Lamp, 20 watts, Luminous Intensity","Accounts Receivable",NA,69.6,-282930.95
"3600","Revenue","Invoice","2018-10-15","71132","Kern Lighting Warehouse:Store #34","Halogen Lamp, Volts:3.5  Tubular","Accounts Receivable",NA,110,-283040.95
"3601","Revenue","Invoice","2018-10-15","71132","Kern Lighting Warehouse:Store #34","Cand. Light, 20 watts (8 pack)","Accounts Receivable",NA,196,-283236.95
"3602","Revenue","Invoice","2018-10-15","71132","Kern Lighting Warehouse:Store #34","Broadway Collection, Polished Chrome, 4 Light (60 watt max)","Accounts Receivable",NA,2350,-285586.95
"3603","Revenue","Invoice","2018-10-15","71132","Kern Lighting Warehouse:Store #34","Golden Umber (100 watt)  Six Light Chandelier","Accounts Receivable",NA,3150,-288736.95
"3604","Revenue","Invoice","2018-10-25","71102","Miscellaneous - Retail:Peter Karpas","Roman Bronze, 1-light Lantern, w/tail, (100 watt max)","Accounts Receivable",NA,680,-289416.95
"3605","Revenue","Invoice","2018-10-25","71102","Miscellaneous - Retail:Peter Karpas","Black Finish, Solid Brass, Clear Glass, Hanging, 2-60 watt max.","Accounts Receivable",NA,126,-289542.95
"3606","Revenue","Invoice","2018-10-25","71102","Miscellaneous - Retail:Peter Karpas","Broadway Collection, Polished Brass, 6 Light (60 watt max)","Accounts Receivable",NA,288,-289830.95
"3607","Revenue","Invoice","2018-10-25","71102","Miscellaneous - Retail:Peter Karpas","Frosted Taupe (3/60 watt)  Marble Glass  ","Accounts Receivable",NA,620,-290450.95
"3608","Revenue","Invoice","2018-10-26","71108","Stern Commercial Contractor's:Wilson Suites","Flush Mount, Polished Brass (2, 13 watt)  White acrylic diffuser","Accounts Receivable",NA,2295,-292745.95
"3609","Revenue","Invoice","2018-10-26","71108","Stern Commercial Contractor's:Wilson Suites","Sunset, Clear Glass, 1-100 watt max.","Accounts Receivable",NA,6300,-299045.95
"3610","Revenue","Invoice","2018-10-26","71108","Stern Commercial Contractor's:Wilson Suites","White, 4.5x7.5, 1-100 watt Medium Base, Satin White Glass","Accounts Receivable",NA,5760,-304805.95
"3611","Revenue","Invoice","2018-11-01","71120","Kern Lighting Warehouse:Store #13","18x8x10, Solid Brass, 3-60watt Medium Base, Satin Etched Glass","Accounts Receivable",NA,3300,-308105.95
"3612","Revenue","Invoice","2018-11-01","71120","Kern Lighting Warehouse:Store #13","Burnished Brass (60 watt)  w/Golden Umber Accents","Accounts Receivable",NA,3000,-311105.95
"3613","Revenue","Invoice","2018-11-01","71120","Kern Lighting Warehouse:Store #13","2032 Series, (3-60 watt, Med) Desert Stone Finish","Accounts Receivable",NA,990,-312095.95
"3614","Revenue","Invoice","2018-11-01","71120","Kern Lighting Warehouse:Store #13","Tapestry, (2-60 watt Med), Etched Cracked Glass, Finish 10","Accounts Receivable",NA,900,-312995.95
"3615","Revenue","Invoice","2018-11-05","71103","Miscellaneous - Retail:Valesha Jones","Acid Verde, 10x21x10, 2-60 watt cand.","Accounts Receivable",NA,870,-313865.95
"3616","Revenue","Invoice","2018-11-05","71103","Miscellaneous - Retail:Valesha Jones","Black Finish, Solid Brass, Clear Glass, Hanging, 2-60 watt max.","Accounts Receivable",NA,84,-313949.95
"3617","Revenue","Invoice","2018-11-05","71103","Miscellaneous - Retail:Valesha Jones","Golden Umber (100 watt)  Six Light Chandelier","Accounts Receivable",NA,945,-314894.95
"3618","Revenue","Invoice","2018-11-05","71103","Miscellaneous - Retail:Valesha Jones","18x8x10, Solid Brass, 3-60watt Medium Base, Satin Etched Glass","Accounts Receivable",NA,264,-315158.95
"3619","Revenue","Invoice","2018-11-05","71103","Miscellaneous - Retail:Valesha Jones","Polished Brass Pendant, 1-100 watt Medium Base, Clear Ribbed Glass","Accounts Receivable",NA,232,-315390.95
"3620","Revenue","Invoice","2018-11-05","71117","Lavery Lighting & Design:Store #JL-01","Chestnut (3/60 watt)  Marble Glass","Accounts Receivable",NA,650,-316040.95
"3621","Revenue","Invoice","2018-11-05","71117","Lavery Lighting & Design:Store #JL-01","Tiffany Collection,Golden Baroque, 1-light lantern, medium base (100 watt max)","Accounts Receivable",NA,714,-316754.95
"3622","Revenue","Invoice","2018-11-05","71117","Lavery Lighting & Design:Store #JL-01","Die Cast Lanterns, Black, 1-100 watt, Medium Base, Clear Cracked Glass","Accounts Receivable",NA,1020,-317774.95
"3623","Revenue","Invoice","2018-11-05","71117","Lavery Lighting & Design:Store #JL-01","Golden Umber (100 watt)  Six Light Chandelier","Accounts Receivable",NA,630,-318404.95
"3624","Revenue","Invoice","2018-11-05","71117","Lavery Lighting & Design:Store #JL-01","Beveled Mirror, Etched Ribbed Glass (75 watt max)","Accounts Receivable",NA,480,-318884.95
"3625","Revenue","Invoice","2018-11-05","71117","Lavery Lighting & Design:Store #JL-01","Pearl Nickle, 5 Light, Medium Base (100 watt max)","Accounts Receivable",NA,475,-319359.95
"3626","Revenue","Invoice","2018-11-05","71117","Lavery Lighting & Design:Store #JL-01","Polished Brass Pendant, 1-100 watt Medium Base, Clear Ribbed Glass","Accounts Receivable",NA,116,-319475.95
"3627","Revenue","Invoice","2018-11-05","71117","Lavery Lighting & Design:Store #JL-01","Athena Collection, Pendant, Textured White, Med. Base, 100 watt max.","Accounts Receivable",NA,260,-319735.95
"3628","Revenue","Invoice","2018-11-05","71117","Lavery Lighting & Design:Store #JL-01","Verona Collection, Pendant, Cobblestone, Etched Alabaster Glass, 150 watt max","Accounts Receivable",NA,300,-320035.95
"3629","Revenue","Invoice","2018-11-05","71117","Lavery Lighting & Design:Store #JL-01","Black Finish, Solid Brass, Clear Glass, Hanging, 2-60 watt max.","Accounts Receivable",NA,84,-320119.95
"3630","Revenue","Invoice","2018-11-05","71117","Lavery Lighting & Design:Store #JL-01","Fluorescent Lamp, T-12, Medium Bipin  (30pack)","Accounts Receivable",NA,30,-320149.95
"3631","Revenue","Invoice","2018-11-05","71117","Lavery Lighting & Design:Store #JL-01","Cand. Light, 20 watts (8 pack)","Accounts Receivable",NA,280,-320429.95
"3632","Revenue","Invoice","2018-11-05","71117","Lavery Lighting & Design:Store #JL-01","Specialty Bulbs, 100 watt (6 pack)","Accounts Receivable",NA,110,-320539.95
"3633","Revenue","Invoice","2018-11-05","71117","Lavery Lighting & Design:Store #JL-01","Specialty, Stage & Studio Bulbs  60 watt","Accounts Receivable",NA,130,-320669.95
"3634","Revenue","Invoice","2018-11-16","71118","Lavery Lighting & Design:Store #JL-04","Acid Verde, 10x21x10, 2-60 watt cand.","Accounts Receivable",NA,1740,-322409.95
"3635","Revenue","Invoice","2018-11-16","71118","Lavery Lighting & Design:Store #JL-04","Die Cast Lanterns, Black, 1-100 watt, Medium Base, Clear Cracked Glass","Accounts Receivable",NA,1020,-323429.95
"3636","Revenue","Invoice","2018-11-16","71118","Lavery Lighting & Design:Store #JL-04","Vianne Lanterns, Satin Antiqued Solid Brass, 3-light wall latern, Candelabra base (60 watt max)","Accounts Receivable",NA,2500,-325929.95
"3637","Revenue","Invoice","2018-11-16","71118","Lavery Lighting & Design:Store #JL-04","Tapestry (8/60 watt)  Faux Alabaster Glass","Accounts Receivable",NA,1500,-327429.95
"3638","Revenue","Invoice","2018-11-16","71118","Lavery Lighting & Design:Store #JL-04","Frosted Taupe (3/60 watt)  Marble Glass  ","Accounts Receivable",NA,930,-328359.95
"3639","Revenue","Invoice","2018-11-16","71118","Lavery Lighting & Design:Store #JL-04","Chestnut (3/60 watt)  Marble Glass","Accounts Receivable",NA,975,-329334.95
"3640","Revenue","Invoice","2018-11-16","71118","Lavery Lighting & Design:Store #JL-04","Black Finish, Solid Brass, Clear Glass, Hanging, 2-60 watt max.","Accounts Receivable",NA,840,-330174.95
"3641","Revenue","Invoice","2018-11-16","71118","Lavery Lighting & Design:Store #JL-04","Tiffany Collection,Golden Baroque, 1-light lantern, medium base (100 watt max)","Accounts Receivable",NA,1020,-331194.95
"3642","Revenue","Invoice","2018-11-16","71118","Lavery Lighting & Design:Store #JL-04","Beveled Mirror, Etched Ribbed Glass (75 watt max)","Accounts Receivable",NA,960,-332154.95
"3643","Revenue","Invoice","2018-11-16","71118","Lavery Lighting & Design:Store #JL-04","Specialty Bulbs, 100 watt (6 pack)","Accounts Receivable",NA,165,-332319.95
"3644","Revenue","Invoice","2018-11-16","71118","Lavery Lighting & Design:Store #JL-04","Specialty, Stage & Studio Bulbs  60 watt","Accounts Receivable",NA,65,-332384.95
"3645","Revenue","Invoice","2018-11-20","71104","Miscellaneous - Retail:Melanie Hall","Vianne Lanterns, Satin Antiqued Solid Brass, 3-light wall latern, Candelabra base (60 watt max)","Accounts Receivable",NA,500,-332884.95
"3646","Revenue","Invoice","2018-11-20","71104","Miscellaneous - Retail:Melanie Hall","Broadway Collection, Polished Chrome, 4 Light (60 watt max)","Accounts Receivable",NA,235,-333119.95
"3647","Revenue","Invoice","2018-11-20","71104","Miscellaneous - Retail:Melanie Hall","Brushed Nickel, Pendant, 1-100 watt Medium Base, Satin Etched Glass","Accounts Receivable",NA,440,-333559.95
"3648","Revenue","Invoice","2018-11-20","71104","Miscellaneous - Retail:Melanie Hall","Pendant Bar, Textured White, 50lbs max","Accounts Receivable",NA,100,-333659.95
"3649","Revenue","Invoice","2018-11-20","71104","Miscellaneous - Retail:Melanie Hall","Chestnut (3/60 watt)  Marble Glass","Accounts Receivable",NA,325,-333984.95
"3650","Revenue","Invoice","2018-11-22","71133","Kern Lighting Warehouse:Store #01","Sunset, Clear Glass, 1-100 watt max.","Accounts Receivable",NA,175,-334159.95
"3651","Revenue","Invoice","2018-11-22","71133","Kern Lighting Warehouse:Store #01","Beveled Mirror, Etched Ribbed Glass (75 watt max)","Accounts Receivable",NA,1680,-335839.95
"3652","Revenue","Invoice","2018-11-22","71133","Kern Lighting Warehouse:Store #01","Pendant Bar, Textured White, 50lbs max","Accounts Receivable",NA,475,-336314.95
"3653","Revenue","Invoice","2018-11-22","71133","Kern Lighting Warehouse:Store #01","Pendant Bar, Cobblestone, 50lbs. max","Accounts Receivable",NA,150,-336464.95
"3654","Revenue","Invoice","2018-11-22","71133","Kern Lighting Warehouse:Store #01","Domes, White, 59x21x6 5/8 ht, 120v HPF","Accounts Receivable",NA,450,-336914.95
"3655","Revenue","Invoice","2018-11-22","71133","Kern Lighting Warehouse:Store #01","Flat Glass, (25 watt max) Polished Brass, 4 light","Accounts Receivable",NA,75,-336989.95
"3656","Revenue","Invoice","2018-11-22","71133","Kern Lighting Warehouse:Store #01","Verona Collection, Pendant, Cobblestone, Etched Alabaster Glass, 150 watt max","Accounts Receivable",NA,1275,-338264.95
"3657","Revenue","Invoice","2018-11-22","71133","Kern Lighting Warehouse:Store #01","Burnished Brass (60 watt)  w/Golden Umber Accents","Accounts Receivable",NA,4700,-342964.95
"3658","Revenue","Invoice","2018-11-22","71133","Kern Lighting Warehouse:Store #01","Renaissance Collection, (100 watt max) Millstone Finish, One-light","Accounts Receivable",NA,765,-343729.95
"3659","Revenue","Invoice","2018-11-22","71133","Kern Lighting Warehouse:Store #01","Broadway Collection, Polished Chrome, 4 Light (60 watt max)","Accounts Receivable",NA,94,-343823.95
"3660","Revenue","Invoice","2018-11-29","71123","Kern Lighting Warehouse:Store #13","18x8x10, Solid Brass, 3-60watt Medium Base, Satin Etched Glass","Accounts Receivable",0,NA,-343823.95
"3661","Revenue","Invoice","2018-11-29","71123","Kern Lighting Warehouse:Store #13","Burnished Brass (60 watt)  w/Golden Umber Accents","Accounts Receivable",0,NA,-343823.95
"3662","Revenue","Invoice","2018-11-29","71123","Kern Lighting Warehouse:Store #13","2032 Series, (3-60 watt, Med) Desert Stone Finish","Accounts Receivable",NA,110,-343933.95
"3663","Revenue","Invoice","2018-11-29","71123","Kern Lighting Warehouse:Store #13","Tapestry, (2-60 watt Med), Etched Cracked Glass, Finish 10","Accounts Receivable",0,NA,-343933.95
"3664","Revenue","Invoice","2018-12-03","71139","Lavery Lighting & Design:Store #JL-08","Acid Verde, 10x21x10, 2-60 watt cand.","Accounts Receivable",NA,493,-344426.95
"3665","Revenue","Invoice","2018-12-03","71139","Lavery Lighting & Design:Store #JL-08","Brushed Nickel, Pendant, 1-100 watt Medium Base, Satin Etched Glass","Accounts Receivable",NA,467.5,-344894.45
"3666","Revenue","Invoice","2018-12-03","71139","Lavery Lighting & Design:Store #JL-08","White, 4.5x7.5, 1-100 watt Medium Base, Satin White Glass","Accounts Receivable",NA,408,-345302.45
"3667","Revenue","Invoice","2018-12-03","71139","Lavery Lighting & Design:Store #JL-08","River Rock (8/60 watt)  Faux Alabaster Glass","Accounts Receivable",NA,1275,-346577.45
"3668","Revenue","Invoice","2018-12-03","71139","Lavery Lighting & Design:Store #JL-08","Specialty, Stage & Studio Bulbs  60 watt","Accounts Receivable",NA,55.25,-346632.7
"3669","Revenue","Invoice","2018-12-03","71139","Lavery Lighting & Design:Store #JL-08","Halogen Lamp, Volts:3.5  Tubular","Accounts Receivable",NA,9.35,-346642.05
"3670","Revenue","Invoice","2018-12-03","71139","Lavery Lighting & Design:Store #JL-08","Cand. Light, 20 watts (8 pack)","Accounts Receivable",0,NA,-346642.05
"3671","Revenue","Invoice","2018-12-07","71138","Baker's Professional Lighting:Store #10","Fluorescent Lamp, Medium Bipin (30pack)","Accounts Receivable",NA,3242.4,-349884.45
"3672","Revenue","Invoice","2018-12-07","71138","Baker's Professional Lighting:Store #10","Fluorescent Lamp, Large Bipin (30 pack)","Accounts Receivable",NA,432,-350316.45
"3673","Revenue","Invoice","2018-12-07","71138","Baker's Professional Lighting:Store #10","Halogen Lamp, 3.5 Volts, Tubular","Accounts Receivable",NA,582,-350898.45
"3674","Revenue","Invoice","2018-12-07","71138","Baker's Professional Lighting:Store #10","Cand. Light, 20 watts (8 pack)","Accounts Receivable",NA,910.08,-351808.53
"3675","Revenue","Invoice","2018-12-07","71138","Baker's Professional Lighting:Store #10","100 watt (6 pack)","Accounts Receivable",NA,3432,-355240.53
"3676","Revenue","Invoice","2018-12-07","71138","Baker's Professional Lighting:Store #10","Stage & Studio, 60 watt (set of 4)","Accounts Receivable",NA,2082,-357322.53
"3677","Revenue","Invoice","2018-12-10","71105","Miscellaneous - Retail:Lara Gussman","Die Cast Lanterns, Black, 1-100 watt, Medium Base, Clear Cracked Glass","Accounts Receivable",NA,748,-358070.53
"3678","Revenue","Invoice","2018-12-10","71105","Miscellaneous - Retail:Lara Gussman","Black Finish, Solid Brass, Clear Glass, Hanging, 2-60 watt max.","Accounts Receivable",NA,84,-358154.53
"3679","Revenue","Invoice","2018-12-10","71105","Miscellaneous - Retail:Lara Gussman","Beveled Mirror, Etched Ribbed Glass (75 watt max)","Accounts Receivable",NA,192,-358346.53
"3680","Revenue","Invoice","2018-12-10","71105","Miscellaneous - Retail:Lara Gussman","Chestnut (3/60 watt)  Marble Glass","Accounts Receivable",NA,325,-358671.53
"3681","Revenue","Invoice","2018-12-10","71105","Miscellaneous - Retail:Lara Gussman","Brushed Nickel, (3-60 watt, Med) Ribbed Glass","Accounts Receivable",NA,200,-358871.53
"3682","Revenue","Invoice","2018-12-10","71105","Miscellaneous - Retail:Lara Gussman","2032 Series, (3-60 watt, Med) Desert Stone Finish","Accounts Receivable",NA,88,-358959.53
"3683","Revenue","Invoice","2018-12-10","71105","Miscellaneous - Retail:Lara Gussman","Colonial, Brushed Steel Finish, Opal White Glass (60 watt)","Accounts Receivable",NA,42,-359001.53
"3684","Revenue","Invoice","2018-12-12","71106","Stern Commercial Contractor's:Walker Properties","Renaissance Collection, (100 watt max) Millstone Finish, One-light","Accounts Receivable",NA,4050,-363051.53
"3685","Revenue","Invoice","2018-12-12","71106","Stern Commercial Contractor's:Walker Properties","Sunset, Clear Glass, 1-100 watt max.","Accounts Receivable",NA,6300,-369351.53
"3686","Revenue","Invoice","2018-12-12","71106","Stern Commercial Contractor's:Walker Properties","Domes, White, 59x21x6 5/8 ht, 120v HPF","Accounts Receivable",NA,8100,-377451.53
"3687","Revenue","Invoice","2018-12-12","71106","Stern Commercial Contractor's:Walker Properties","Flush Mount, Polished Brass (2, 13 watt)  White acrylic diffuser","Accounts Receivable",NA,1530,-378981.53
"3688","Revenue","Invoice","2018-12-12","71106","Stern Commercial Contractor's:Walker Properties","Fluorescent Lamp, T-12, Medium Bipin  (30pack)","Accounts Receivable",NA,1350,-380331.53
"3689","Revenue","Invoice","2018-12-15","71137","Dan A. North Builders:Custom Order - Suite 100A","Custom made dome lighting with purple trim, extra voltage","Accounts Receivable",NA,7000,-387331.53
"3690","Revenue","Invoice","2018-12-15","71140","Thompson Lighting Stores:Store #15","Die Cast Lanterns, Black, 1-100 watt, Medium Base, Clear Cracked Glass","Accounts Receivable",NA,1020,-388351.53
"3691","Revenue","Invoice","2018-12-15","71140","Thompson Lighting Stores:Store #15","Tapestry, (2-60 watt Med), Etched Cracked Glass, Finish 10","Accounts Receivable",NA,675,-389026.53
"3692","Revenue","Invoice","2018-12-15","71140","Thompson Lighting Stores:Store #15","18x8x10, Solid Brass, 3-60watt Medium Base, Satin Etched Glass","Accounts Receivable",NA,726,-389752.53
"3693","Revenue","Invoice","2018-12-15","71140","Thompson Lighting Stores:Store #15","Fluorescent Lamp, T-12, Medium Bipin  (30pack)","Accounts Receivable",0,NA,-389752.53
"3694","Revenue","Invoice","2018-12-15","71140","Thompson Lighting Stores:Store #15","Specialty Bulbs, 100 watt (6 pack)","Accounts Receivable",NA,110,-389862.53
"3695","Revenue","Invoice","2018-12-15","71140","Thompson Lighting Stores:Store #15","Golden Umber (100 watt)  Six Light Chandelier","Accounts Receivable",NA,1575,-391437.53
"3696","Revenue","Invoice","2018-12-15","71140","Thompson Lighting Stores:Store #15","Golden Umber, 6 Light","Accounts Receivable",NA,1575,-393012.53
"3697","Revenue","Invoice","2018-12-15","71140","Thompson Lighting Stores:Store #15","Frosted Taupe with Marble Glass","Accounts Receivable",NA,2170,-395182.53
"3698","Revenue","Invoice","2018-12-15","71140","Thompson Lighting Stores:Store #15","Tapestry with Faux Alabaster Glass","Accounts Receivable",NA,2100,-397282.53
"3699","Revenue","Invoice","2018-12-15","71140","Thompson Lighting Stores:Store #15","Beveled Mirror with Etched Ribbed Glass","Accounts Receivable",NA,480,-397762.53
"3700","Revenue","Invoice","2018-12-15","71140","Thompson Lighting Stores:Store #15","Polished Brass, 6 Light","Accounts Receivable",NA,360,-398122.53
"3701","Revenue","Invoice","2018-12-15","71140","Thompson Lighting Stores:Store #15","White with Satin White Glass","Accounts Receivable",NA,224,-398346.53
"3702","Revenue","Invoice","2018-12-15","71140","Thompson Lighting Stores:Store #15","Steel Colonial with Opal White Glass","Accounts Receivable",NA,210,-398556.53
"3703","Revenue","Invoice","2018-12-15","71140","Thompson Lighting Stores:Store #15","Gold Colonial","Accounts Receivable",NA,215,-398771.53
"3704","Revenue","Invoice","2018-12-15","71140","Thompson Lighting Stores:Store #15","Copper Verde, Seeded Glass","Accounts Receivable",NA,360,-399131.53
"3705","Revenue","Invoice","2018-12-15","71134","Kern Lighting Warehouse:Store #13","Acid Verde","Accounts Receivable",NA,1334,-400465.53
"3706","Revenue","Invoice","2018-12-15","71134","Kern Lighting Warehouse:Store #13","Brushed Nickel Pendant with Etched Glass","Accounts Receivable",NA,385,-400850.53
"3707","Revenue","Invoice","2018-12-15","71134","Kern Lighting Warehouse:Store #13","Tapestry with Etched Glass","Accounts Receivable",NA,135,-400985.53
"3708","Revenue","Invoice","2018-12-15","71134","Kern Lighting Warehouse:Store #13","Brushed Nickel with Ribbed Glass","Accounts Receivable",NA,600,-401585.53
"3709","Revenue","Invoice","2018-12-15","71134","Kern Lighting Warehouse:Store #13","Fluorescent Lamp, Medium Bipin (30pack)","Accounts Receivable",NA,750,-402335.53
"3710","Revenue","Invoice","2018-12-15","71134","Kern Lighting Warehouse:Store #13","Halogen Lamp, 3.5 Volts, Tubular","Accounts Receivable",NA,110,-402445.53
"3711","Revenue","Invoice","2018-12-15","71134","Kern Lighting Warehouse:Store #13","Stage & Studio, 60 watt (set of 4)","Accounts Receivable",NA,149.5,-402595.03
"3712","Revenue","Invoice","2018-12-15","71134","Kern Lighting Warehouse:Store #13","Copper Verde, Seeded Glass","Accounts Receivable",NA,1800,-404395.03
"3713","Revenue","Invoice","2018-12-15","71134","Kern Lighting Warehouse:Store #13","Bronze Lantern with Tail","Accounts Receivable",NA,2720,-407115.03
"3714","Revenue","Invoice","2018-12-15","71134","Kern Lighting Warehouse:Store #13","Hanging Brass and Black Finish with Clear Glass","Accounts Receivable",NA,1050,-408165.03
"3715","Revenue","Invoice","2018-12-15","71136","Kern Lighting Warehouse:Store #13","Black Die Cast Lanterns with Clear Glass","Accounts Receivable",NA,340,-408505.03
"3716","Revenue","Invoice","2018-12-15","71136","Kern Lighting Warehouse:Store #13","Solid Brass with Etched Glass, 2 Light","Accounts Receivable",NA,330,-408835.03
"3717","Revenue","Invoice","2018-12-15","71136","Kern Lighting Warehouse:Store #13","Textured White Pendant","Accounts Receivable",NA,325,-409160.03
"3718","Revenue","Invoice","2018-12-15","71136","Kern Lighting Warehouse:Store #13","Steel Colonial with Opal White Glass","Accounts Receivable",NA,107.5,-409267.53
"3719","Revenue","Invoice","2018-12-15","71136","Kern Lighting Warehouse:Store #13","Brass with Black Finish and Clear Glass","Accounts Receivable",NA,375,-409642.53
"3720","Revenue","Invoice","2018-12-15","71136","Kern Lighting Warehouse:Store #13","Hanging Brass and Black Finish with Clear Glass","Accounts Receivable",NA,210,-409852.53
"3721","Revenue","Invoice","2018-12-15","71136","Kern Lighting Warehouse:Store #13","Drop Opal with Solid Oak Frame","Accounts Receivable",NA,210,-410062.53
"3722","Revenue","Invoice","2018-12-15","71136","Kern Lighting Warehouse:Store #13","Textured White Pendant","Accounts Receivable",NA,325,-410387.53
"3723","Revenue","Invoice","2018-12-15","71135","Baker's Professional Lighting:Store #15","Gold Colonial","Accounts Receivable",NA,43,-410430.53
"3724","Revenue","Invoice","2018-12-15","71135","Baker's Professional Lighting:Store #15","Steel Colonial with Opal White Glass","Accounts Receivable",NA,84,-410514.53
"3725","Revenue","Invoice","2018-12-15","71135","Baker's Professional Lighting:Store #15","Brushed Nickel with Opal Glass","Accounts Receivable",NA,100,-410614.53
"3726","Revenue","Invoice","2018-12-15","71135","Baker's Professional Lighting:Store #15","Textured White Pendant","Accounts Receivable",NA,325,-410939.53
"3727","Revenue","Invoice","2018-12-15","71135","Baker's Professional Lighting:Store #15","Brass Guard Lanterns, 1 Light","Accounts Receivable",NA,320,-411259.53
"3728","Revenue","Invoice","2018-12-15","71135","Baker's Professional Lighting:Store #15","Drop Opal with Solid Oak Frame","Accounts Receivable",NA,210,-411469.53
"3729","Revenue","Invoice","2018-12-15","71135","Baker's Professional Lighting:Store #15","Black Die Cast Lanterns with Clear Glass","Accounts Receivable",NA,340,-411809.53
"3735","Direct Labor","Paycheck","2018-12-15","5361","Graham, Jonathan",NA,"Company Checking Account",2500,NA,2500
"3738","Direct Labor","Paycheck","2018-01-15","3003","Bolinski, Rafal",NA,"Company Checking Account",460,NA,460
"3739","Direct Labor","Paycheck","2018-01-15","3004","Deen, Jeannette",NA,"Company Checking Account",350,NA,810
"3740","Direct Labor","Paycheck","2018-02-01","3005","Bolinski, Rafal",NA,"Company Checking Account",460,NA,1270
"3741","Direct Labor","Paycheck","2018-02-01","3006","Deen, Jeannette",NA,"Company Checking Account",350,NA,1620
"3742","Direct Labor","Paycheck","2018-02-15","3007","Bolinski, Rafal",NA,"Company Checking Account",460,NA,2080
"3743","Direct Labor","Paycheck","2018-02-15","3008","Deen, Jeannette",NA,"Company Checking Account",350,NA,2430
"3744","Direct Labor","Paycheck","2018-03-01","3009","Bolinski, Rafal",NA,"Company Checking Account",460,NA,2890
"3745","Direct Labor","Paycheck","2018-03-01","3010","Deen, Jeannette",NA,"Company Checking Account",350,NA,3240
"3746","Direct Labor","Paycheck","2018-03-15","3011","Bolinski, Rafal",NA,"Company Checking Account",460,NA,3700
"3747","Direct Labor","Paycheck","2018-03-15","3012","Deen, Jeannette",NA,"Company Checking Account",350,NA,4050
"3748","Direct Labor","Paycheck","2018-04-02","3013","Bolinski, Rafal",NA,"Company Checking Account",460,NA,4510
"3749","Direct Labor","Paycheck","2018-04-02","3014","Deen, Jeannette",NA,"Company Checking Account",350,NA,4860
"3750","Direct Labor","Paycheck","2018-04-15","3015","Bolinski, Rafal",NA,"Company Checking Account",460,NA,5320
"3751","Direct Labor","Paycheck","2018-04-15","3016","Deen, Jeannette",NA,"Company Checking Account",350,NA,5670
"3752","Direct Labor","Paycheck","2018-05-01","3017","Bolinski, Rafal",NA,"Company Checking Account",460,NA,6130
"3753","Direct Labor","Paycheck","2018-05-01","3018","Deen, Jeannette",NA,"Company Checking Account",350,NA,6480
"3754","Direct Labor","Paycheck","2018-05-15","3019","Bolinski, Rafal",NA,"Company Checking Account",460,NA,6940
"3755","Direct Labor","Paycheck","2018-05-15","3020","Deen, Jeannette",NA,"Company Checking Account",350,NA,7290
"3756","Direct Labor","Paycheck","2018-06-01","3021","Bolinski, Rafal",NA,"Company Checking Account",460,NA,7750
"3757","Direct Labor","Paycheck","2018-06-01","3022","Deen, Jeannette",NA,"Company Checking Account",350,NA,8100
"3758","Direct Labor","Paycheck","2018-06-15","3023","Bolinski, Rafal",NA,"Company Checking Account",460,NA,8560
"3759","Direct Labor","Paycheck","2018-06-15","3024","Deen, Jeannette",NA,"Company Checking Account",350,NA,8910
"3760","Direct Labor","Paycheck","2018-07-01","3025","Bolinski, Rafal",NA,"Company Checking Account",460,NA,9370
"3761","Direct Labor","Paycheck","2018-07-01","3026","Deen, Jeannette",NA,"Company Checking Account",350,NA,9720
"3762","Direct Labor","Paycheck","2018-07-15","3027","Bolinski, Rafal",NA,"Company Checking Account",460,NA,10180
"3763","Direct Labor","Paycheck","2018-07-15","3028","Deen, Jeannette",NA,"Company Checking Account",350,NA,10530
"3764","Direct Labor","Paycheck","2018-08-01","3029","Bolinski, Rafal",NA,"Company Checking Account",460,NA,10990
"3765","Direct Labor","Paycheck","2018-08-01","3030","Deen, Jeannette",NA,"Company Checking Account",350,NA,11340
"3766","Direct Labor","Paycheck","2018-08-15","3031","Bolinski, Rafal",NA,"Company Checking Account",460,NA,11800
"3767","Direct Labor","Paycheck","2018-08-15","3032","Deen, Jeannette",NA,"Company Checking Account",350,NA,12150
"3768","Direct Labor","Paycheck","2018-09-01","3033","Bolinski, Rafal",NA,"Company Checking Account",460,NA,12610
"3769","Direct Labor","Paycheck","2018-09-01","3034","Deen, Jeannette",NA,"Company Checking Account",350,NA,12960
"3770","Direct Labor","Paycheck","2018-09-15","3035","Bolinski, Rafal",NA,"Company Checking Account",460,NA,13420
"3771","Direct Labor","Paycheck","2018-09-15","3036","Deen, Jeannette",NA,"Company Checking Account",350,NA,13770
"3772","Direct Labor","Paycheck","2018-10-01","3037","Bolinski, Rafal",NA,"Company Checking Account",460,NA,14230
"3773","Direct Labor","Paycheck","2018-10-01","3038","Deen, Jeannette",NA,"Company Checking Account",350,NA,14580
"3774","Direct Labor","Paycheck","2018-10-15","3039","Bolinski, Rafal",NA,"Company Checking Account",460,NA,15040
"3775","Direct Labor","Paycheck","2018-10-15","3040","Deen, Jeannette",NA,"Company Checking Account",350,NA,15390
"3776","Direct Labor","Paycheck","2018-11-01","3041","Bolinski, Rafal",NA,"Company Checking Account",460,NA,15850
"3777","Direct Labor","Paycheck","2018-11-01","3042","Deen, Jeannette",NA,"Company Checking Account",350,NA,16200
"3778","Direct Labor","Paycheck","2018-11-15","3043","Bolinski, Rafal",NA,"Company Checking Account",460,NA,16660
"3779","Direct Labor","Paycheck","2018-11-15","3044","Deen, Jeannette",NA,"Company Checking Account",350,NA,17010
"3780","Direct Labor","Paycheck","2018-12-01","3045","Bolinski, Rafal",NA,"Company Checking Account",460,NA,17470
"3781","Direct Labor","Paycheck","2018-12-01","3046","Deen, Jeannette",NA,"Company Checking Account",350,NA,17820
"3782","Direct Labor","Paycheck","2018-12-15","3047","Bolinski, Rafal",NA,"Company Checking Account",460,NA,18280
"3783","Direct Labor","Paycheck","2018-12-15","3048","Deen, Jeannette",NA,"Company Checking Account",350,NA,18630
"3784","Direct Labor","Paycheck","2018-12-15","5364","Bolinski, Rafal",NA,"Company Checking Account",575,NA,19205
"3785","Direct Labor","Paycheck","2018-12-15","5365","Deen, Jeannette",NA,"Company Checking Account",500,NA,19705
"3791","Freight Costs","Bill","2018-01-31","124-80056","Fisse Fast Package Delivery",NA,"Accounts Payable",134,NA,134
"3792","Freight Costs","Bill","2018-02-05","124-89056","Fisse Fast Package Delivery",NA,"Accounts Payable",197,NA,331
"3793","Freight Costs","Bill","2018-03-05","124-85001","Fisse Fast Package Delivery",NA,"Accounts Payable",164,NA,495
"3794","Freight Costs","Bill","2018-04-15","124-90002","Fisse Fast Package Delivery",NA,"Accounts Payable",164,NA,659
"3795","Freight Costs","Bill","2018-05-05","124-87002","Fisse Fast Package Delivery",NA,"Accounts Payable",164,NA,823
"3796","Freight Costs","Bill","2018-06-05","124-87010","Fisse Fast Package Delivery",NA,"Accounts Payable",148,NA,971
"3797","Freight Costs","Bill","2018-07-05","124-89012","Fisse Fast Package Delivery",NA,"Accounts Payable",152,NA,1123
"3798","Freight Costs","Bill","2018-08-15","124-89199","Fisse Fast Package Delivery",NA,"Accounts Payable",148,NA,1271
"3799","Freight Costs","Bill","2018-09-30","124-90610","Fisse Fast Package Delivery",NA,"Accounts Payable",181,NA,1452
"3800","Freight Costs","Bill","2018-10-30","124-90712","Fisse Fast Package Delivery",NA,"Accounts Payable",196,NA,1648
"3801","Freight Costs","Bill","2018-12-15","124-90874","Fisse Fast Package Delivery",NA,"Accounts Payable",162,NA,1810
"3804","Packaging Materials","Bill","2018-05-31","45087","Printing Shop","Packaging materials","Accounts Payable",1000,NA,1000
"3805","Packaging Materials","Bill","2018-08-15","160987","Printing Shop","Packaging tape with company logo and name on it.","Accounts Payable",325,NA,1325
"3806","Packaging Materials","Bill","2018-10-01","15908","Printing Shop","Packaging materials with logo","Accounts Payable",427.5,NA,1752.5
"3809","Purchases  (Cost of Goods)","Invoice","2018-01-06","71047","Baker's Professional Lighting:Store #25","Pearl Nickle, 5 Light, Medium Base (100 watt max)","Accounts Receivable",240,NA,240
"3810","Purchases  (Cost of Goods)","Invoice","2018-01-06","71047","Baker's Professional Lighting:Store #25","Black Finish, Solid Brass, Clear Glass, Hanging, 2-60 watt max.","Accounts Receivable",36,NA,276
"3811","Purchases  (Cost of Goods)","Invoice","2018-01-06","71047","Baker's Professional Lighting:Store #25","Beveled Mirror, Etched Ribbed Glass (75 watt max)","Accounts Receivable",66,NA,342
"3812","Purchases  (Cost of Goods)","Invoice","2018-01-06","71047","Baker's Professional Lighting:Store #25","Tiffany Collection,Golden Baroque, 1-light lantern, medium base (100 watt max)","Accounts Receivable",240,NA,582
"3813","Purchases  (Cost of Goods)","Invoice","2018-01-06","71047","Baker's Professional Lighting:Store #25","Burnished Brass (60 watt)  w/Golden Umber Accents","Accounts Receivable",150,NA,732
"3814","Purchases  (Cost of Goods)","Invoice","2018-01-06","71047","Baker's Professional Lighting:Store #25","Specialty Bulbs, 100 watt (6 pack)","Accounts Receivable",23.75,NA,755.75
"3815","Purchases  (Cost of Goods)","Invoice","2018-01-06","71047","Baker's Professional Lighting:Store #25","Pendant Bar, Cobblestone, 50lbs. max","Accounts Receivable",20,NA,775.75
"3816","Purchases  (Cost of Goods)","Invoice","2018-01-06","71047","Baker's Professional Lighting:Store #25","Verona Collection, Pendant, Cobblestone, Etched Alabaster Glass, 150 watt max","Accounts Receivable",140,NA,915.75
"3817","Purchases  (Cost of Goods)","Invoice","2018-01-06","71047","Baker's Professional Lighting:Store #25","Halogen Lamp, 20 watts, Luminous Intensity","Accounts Receivable",6,NA,921.75
"3818","Purchases  (Cost of Goods)","Invoice","2018-01-06","71047","Baker's Professional Lighting:Store #25","Cand. Light, 20 watts (8 pack)","Accounts Receivable",24,NA,945.75
"3819","Purchases  (Cost of Goods)","Bill","2018-01-06","87865","Paulsen's Lighting","In bound shipments","Accounts Payable",120,NA,1065.75
"3820","Purchases  (Cost of Goods)","Invoice","2018-01-14","71050","Godwin Lighting Depot:Store #202","Pearl Nickle, 5 Light, Medium Base (100 watt max)","Accounts Receivable",1000,NA,2065.75
"3821","Purchases  (Cost of Goods)","Invoice","2018-01-14","71050","Godwin Lighting Depot:Store #202","Roman Bronze, 1-light Lantern, w/tail, (100 watt max)","Accounts Receivable",380,NA,2445.75
"3822","Purchases  (Cost of Goods)","Invoice","2018-01-14","71050","Godwin Lighting Depot:Store #202","Flush Mount, Polished Brass (2, 13 watt)  White acrylic diffuser","Accounts Receivable",256,NA,2701.75
"3823","Purchases  (Cost of Goods)","Invoice","2018-01-14","71050","Godwin Lighting Depot:Store #202","Brushed Nickel, Pendant, 1-100 watt Medium Base, Satin Etched Glass","Accounts Receivable",300,NA,3001.75
"3824","Purchases  (Cost of Goods)","Invoice","2018-01-14","71050","Godwin Lighting Depot:Store #202","Tiffany Collection,Golden Baroque, 1-light lantern, medium base (100 watt max)","Accounts Receivable",480,NA,3481.75
"3825","Purchases  (Cost of Goods)","Invoice","2018-01-14","71050","Godwin Lighting Depot:Store #202","River Rock (8/60 watt)  Faux Alabaster Glass","Accounts Receivable",450,NA,3931.75
"3826","Purchases  (Cost of Goods)","Invoice","2018-01-14","71050","Godwin Lighting Depot:Store #202","Specialty, Stage & Studio Bulbs  60 watt","Accounts Receivable",125,NA,4056.75
"3827","Purchases  (Cost of Goods)","Invoice","2018-01-14","71050","Godwin Lighting Depot:Store #202","Specialty Bulbs, 100 watt (6 pack)","Accounts Receivable",47.5,NA,4104.25
"3828","Purchases  (Cost of Goods)","Invoice","2018-01-14","71050","Godwin Lighting Depot:Store #202","Halogen Lamp, 20 watts, Luminous Intensity","Accounts Receivable",19.2,NA,4123.45
"3829","Purchases  (Cost of Goods)","Invoice","2018-01-17","71055","Miscellaneous - Retail:Ms. Jann Minor","Polished Brass Pendant, 1-100 watt Medium Base, Clear Ribbed Glass","Accounts Receivable",160,NA,4283.45
"3830","Purchases  (Cost of Goods)","Invoice","2018-01-17","71055","Miscellaneous - Retail:Ms. Jann Minor","Pendant Bar, Textured White, 50lbs max","Accounts Receivable",20,NA,4303.45
"3831","Purchases  (Cost of Goods)","Invoice","2018-01-17","71055","Miscellaneous - Retail:Ms. Jann Minor","Golden Umber (100 watt)  Six Light Chandelier","Accounts Receivable",85,NA,4388.45
"3832","Purchases  (Cost of Goods)","Invoice","2018-01-17","71055","Miscellaneous - Retail:Ms. Jann Minor","Beveled Mirror, Etched Ribbed Glass (75 watt max)","Accounts Receivable",66,NA,4454.45
"3833","Purchases  (Cost of Goods)","Invoice","2018-01-17","71055","Miscellaneous - Retail:Ms. Jann Minor","Sunset, Clear Glass, 1-100 watt max.","Accounts Receivable",60,NA,4514.45
"3834","Purchases  (Cost of Goods)","Invoice","2018-01-17","71055","Miscellaneous - Retail:Ms. Jann Minor","Black Finish, Solid Brass, Hanging w/Clear Glass (2x60watt max)","Accounts Receivable",40,NA,4554.45
"3835","Purchases  (Cost of Goods)","Invoice","2018-01-18","71092","Miscellaneous - Retail:Brian Stern","Sunset, Clear Glass, 1-100 watt max.","Accounts Receivable",75,NA,4629.45
"3836","Purchases  (Cost of Goods)","Invoice","2018-01-18","71092","Miscellaneous - Retail:Brian Stern","Beveled Mirror, Etched Ribbed Glass (75 watt max)","Accounts Receivable",66,NA,4695.45
"3837","Purchases  (Cost of Goods)","Invoice","2018-01-18","71092","Miscellaneous - Retail:Brian Stern","Athena Collection, (100 watt max) Copper Verde, Seeded Glass","Accounts Receivable",75,NA,4770.45
"3838","Purchases  (Cost of Goods)","Invoice","2018-01-18","71092","Miscellaneous - Retail:Brian Stern","Burnished Brass (60 watt)  w/Golden Umber Accents","Accounts Receivable",75,NA,4845.45
"3839","Purchases  (Cost of Goods)","Invoice","2018-01-18","71092","Miscellaneous - Retail:Brian Stern","Polished Brass Pendant, 1-100 watt Medium Base, Clear Ribbed Glass","Accounts Receivable",128,NA,4973.45
"3840","Purchases  (Cost of Goods)","Invoice","2018-01-18","71092","Miscellaneous - Retail:Brian Stern","Pendant Bar, Textured White, 50lbs max","Accounts Receivable",20,NA,4993.45
"3841","Purchases  (Cost of Goods)","Bill","2018-01-24","U7890","Paulsen's Lighting","In bound shipments","Accounts Payable",200,NA,5193.45
"3842","Purchases  (Cost of Goods)","Invoice","2018-01-28","71053","Miscellaneous - Retail:Alison Johnson","Tapestry, (2-60 watt Med), Etched Cracked Glass, Finish 10","Accounts Receivable",30,NA,5223.45
"3843","Purchases  (Cost of Goods)","Invoice","2018-01-28","71053","Miscellaneous - Retail:Alison Johnson","Tapestry (8/60 watt)  Faux Alabaster Glass","Accounts Receivable",75,NA,5298.45
"3844","Purchases  (Cost of Goods)","Invoice","2018-01-28","71053","Miscellaneous - Retail:Alison Johnson","Vianne Lanterns, Satin Antiqued Solid Brass, 3-light wall latern, Candelabra base (60 watt max)","Accounts Receivable",193.79,NA,5492.24
"3845","Purchases  (Cost of Goods)","Invoice","2018-01-28","71053","Miscellaneous - Retail:Alison Johnson","White, 4.5x7.5, 1-100 watt Medium Base, Satin White Glass","Accounts Receivable",30,NA,5522.24
"3846","Purchases  (Cost of Goods)","Invoice","2018-01-28","71072","Cole Home Builders:Phase 2 - Lot 5","Die Cast Lanterns, Black, 1-100 watt, Medium Base, Clear Cracked Glass","Accounts Receivable",228,NA,5750.24
"3847","Purchases  (Cost of Goods)","Invoice","2018-01-28","71072","Cole Home Builders:Phase 2 - Lot 5","Tapestry, (2-60 watt Med), Etched Cracked Glass, Finish 10","Accounts Receivable",90,NA,5840.24
"3848","Purchases  (Cost of Goods)","Invoice","2018-01-28","71072","Cole Home Builders:Phase 2 - Lot 5","Pearl Nickle, 5 Light, Medium Base (100 watt max)","Accounts Receivable",160,NA,6000.24
"3849","Purchases  (Cost of Goods)","Invoice","2018-01-28","71072","Cole Home Builders:Phase 2 - Lot 5","Sunset, Clear Glass, 1-100 watt max.","Accounts Receivable",60,NA,6060.24
"3850","Purchases  (Cost of Goods)","Invoice","2018-01-28","71072","Cole Home Builders:Phase 2 - Lot 5","Black Finish, Solid Brass, Clear Glass, Hanging, 2-60 watt max.","Accounts Receivable",54,NA,6114.24
"3851","Purchases  (Cost of Goods)","Invoice","2018-01-28","71072","Cole Home Builders:Phase 2 - Lot 5","Burnished Brass (60 watt)  w/Golden Umber Accents","Accounts Receivable",75,NA,6189.24
"3852","Purchases  (Cost of Goods)","Invoice","2018-01-28","71072","Cole Home Builders:Phase 2 - Lot 5","Chestnut (3/60 watt)  Marble Glass","Accounts Receivable",95,NA,6284.24
"3853","Purchases  (Cost of Goods)","Invoice","2018-01-28","71072","Cole Home Builders:Phase 2 - Lot 5","Pendant Bar, Textured White, 50lbs max","Accounts Receivable",10,NA,6294.24
"3854","Purchases  (Cost of Goods)","Invoice","2018-01-28","71072","Cole Home Builders:Phase 2 - Lot 5","Athena Collection, (100 watt max) Copper Verde, Seeded Glass","Accounts Receivable",32.14,NA,6326.38
"3855","Purchases  (Cost of Goods)","Invoice","2018-01-28","71072","Cole Home Builders:Phase 2 - Lot 5","Cand. Light, 20 watts (8 pack)","Accounts Receivable",24,NA,6350.38
"3856","Purchases  (Cost of Goods)","Invoice","2018-01-28","71072","Cole Home Builders:Phase 2 - Lot 5","Fluorescent Lamp, T-12, Medium Bipin  (30pack)","Accounts Receivable",6.34,NA,6356.72
"3857","Purchases  (Cost of Goods)","Invoice","2018-01-28","71072","Cole Home Builders:Phase 2 - Lot 5","Fluorescent Lamp, T-5, Bipin","Accounts Receivable",6,NA,6362.72
"3858","Purchases  (Cost of Goods)","Invoice","2018-01-28","71072","Cole Home Builders:Phase 2 - Lot 5","Halogen Lamp, Volts:3.5  Tubular","Accounts Receivable",2.5,NA,6365.22
"3859","Purchases  (Cost of Goods)","Invoice","2018-01-28","71072","Cole Home Builders:Phase 2 - Lot 5","Specialty Bulbs, 100 watt (6 pack)","Accounts Receivable",9.5,NA,6374.72
"3860","Purchases  (Cost of Goods)","Invoice","2018-01-28","71072","Cole Home Builders:Phase 2 - Lot 5","Specialty, Stage & Studio Bulbs  60 watt","Accounts Receivable",20,NA,6394.72
"3861","Purchases  (Cost of Goods)","Invoice","2018-01-28","71072","Cole Home Builders:Phase 2 - Lot 5","Flat Glass, (25 watt max) Polished Brass, 4 light","Accounts Receivable",40,NA,6434.72
"3862","Purchases  (Cost of Goods)","Invoice","2018-01-28","71072","Cole Home Builders:Phase 2 - Lot 5","Beveled Mirror, Etched Ribbed Glass (75 watt max)","Accounts Receivable",44,NA,6478.72
"3863","Purchases  (Cost of Goods)","Invoice","2018-01-29","71124","Kern Lighting Warehouse:Store #34","Burnished Brass (60 watt)  w/Golden Umber Accents","Accounts Receivable",2100,NA,8578.72
"3864","Purchases  (Cost of Goods)","Bill","2018-01-30","98760AR","Hall Lighting & Accessories","Sunset, Clear Glass, 1-100 watt max.","Accounts Payable",5,NA,8583.72
"3865","Purchases  (Cost of Goods)","Invoice","2018-01-31","71059","Godwin Lighting Depot:Store #303","Black Finish, Solid Brass, Clear Glass, Hanging, 2-60 watt max.","Accounts Receivable",57.57,NA,8641.29
"3866","Purchases  (Cost of Goods)","Invoice","2018-01-31","71059","Godwin Lighting Depot:Store #303","Black Finish, Solid Brass,Wall Mount w/Clear Glass (2x60watt max)","Accounts Receivable",200,NA,8841.29
"3867","Purchases  (Cost of Goods)","Invoice","2018-01-31","71059","Godwin Lighting Depot:Store #303","Tapestry (8/60 watt)  Faux Alabaster Glass","Accounts Receivable",150,NA,8991.29
"3868","Purchases  (Cost of Goods)","Invoice","2018-01-31","71059","Godwin Lighting Depot:Store #303","Athena Collection, (100 watt max) Copper Verde, Seeded Glass","Accounts Receivable",160.71,NA,9152
"3869","Purchases  (Cost of Goods)","Invoice","2018-01-31","71059","Godwin Lighting Depot:Store #303","Broadway Collection, Polished Chrome, 4 Light (60 watt max)","Accounts Receivable",126,NA,9278
"3870","Purchases  (Cost of Goods)","Invoice","2018-01-31","71059","Godwin Lighting Depot:Store #303","Halogen Lamp, Volts:3.5  Tubular","Accounts Receivable",5,NA,9283
"3871","Purchases  (Cost of Goods)","Invoice","2018-01-31","71059","Godwin Lighting Depot:Store #303","Specialty Bulbs, 100 watt (6 pack)","Accounts Receivable",9.5,NA,9292.5
"3872","Purchases  (Cost of Goods)","Invoice","2018-01-31","71059","Godwin Lighting Depot:Store #303","Specialty, Stage & Studio Bulbs  60 watt","Accounts Receivable",17.5,NA,9310
"3873","Purchases  (Cost of Goods)","Invoice","2018-01-31","71059","Godwin Lighting Depot:Store #303","Fluorescent Lamp, T-12, Medium Bipin  (30pack)","Accounts Receivable",6.34,NA,9316.34
"3874","Purchases  (Cost of Goods)","Invoice","2018-01-31","71059","Godwin Lighting Depot:Store #303","Domes, White, 59x21x6 5/8 ht, 120v HPF","Accounts Receivable",36,NA,9352.34
"3875","Purchases  (Cost of Goods)","Invoice","2018-02-01","71121","Kern Lighting Warehouse:Store #34","Brushed Nickel, Pendant, 1-100 watt Medium Base, Satin Etched Glass","Accounts Receivable",250,NA,9602.34
"3876","Purchases  (Cost of Goods)","Invoice","2018-02-01","71121","Kern Lighting Warehouse:Store #34","Tapestry, (2-60 watt Med), Etched Cracked Glass, Finish 10","Accounts Receivable",225,NA,9827.34
"3877","Purchases  (Cost of Goods)","Invoice","2018-02-01","71121","Kern Lighting Warehouse:Store #34","18x8x10, Solid Brass, 3-60watt Medium Base, Satin Etched Glass","Accounts Receivable",640,NA,10467.34
"3878","Purchases  (Cost of Goods)","Invoice","2018-02-01","71121","Kern Lighting Warehouse:Store #34","18x8x10, Solid Brass, 3-60watt Medium Base, Satin Etched Glass","Accounts Receivable",960,NA,11427.34
"3879","Purchases  (Cost of Goods)","Invoice","2018-02-01","71121","Kern Lighting Warehouse:Store #34","Solid Brass, 4-light, 25x13x10.75, 4-60 watt, Medium Base, Satin Etched Glass","Accounts Receivable",570,NA,11997.34
"3880","Purchases  (Cost of Goods)","Invoice","2018-02-01","71121","Kern Lighting Warehouse:Store #34","White, 4.5x7.5, 1-100 watt Medium Base, Satin White Glass","Accounts Receivable",450,NA,12447.34
"3881","Purchases  (Cost of Goods)","Bill","2018-02-01","15657","Printing Shop","Product literature with company name","Accounts Payable",255,NA,12702.34
"3882","Purchases  (Cost of Goods)","Invoice","2018-02-10","71051","Cole Home Builders:Phase 2 - Lot 5","Specialty Bulbs, 100 watt (6 pack)","Accounts Receivable",57,NA,12759.34
"3883","Purchases  (Cost of Goods)","Invoice","2018-02-10","71051","Cole Home Builders:Phase 2 - Lot 5","Cand. Light, 20 watts (8 pack)","Accounts Receivable",48,NA,12807.34
"3884","Purchases  (Cost of Goods)","Invoice","2018-02-10","71051","Cole Home Builders:Phase 2 - Lot 5","Golden Umber (100 watt)  Six Light Chandelier","Accounts Receivable",510,NA,13317.34
"3885","Purchases  (Cost of Goods)","Invoice","2018-02-10","71051","Cole Home Builders:Phase 2 - Lot 5","Acid Verde, 10x21x10, 2-60 watt cand.","Accounts Receivable",150,NA,13467.34
"3886","Purchases  (Cost of Goods)","Invoice","2018-02-10","71051","Cole Home Builders:Phase 2 - Lot 5","18x8x10, Solid Brass, 3-60watt Medium Base, Satin Etched Glass","Accounts Receivable",480,NA,13947.34
"3887","Purchases  (Cost of Goods)","Invoice","2018-02-10","71051","Cole Home Builders:Phase 2 - Lot 5","Athena Collection, (100 watt max) Copper Verde, Seeded Glass","Accounts Receivable",321.43,NA,14268.77
"3888","Purchases  (Cost of Goods)","Invoice","2018-02-11","71112","Thompson Lighting Stores:Store #15","Acid Verde, 10x21x10, 2-60 watt cand.","Accounts Receivable",180,NA,14448.77
"3889","Purchases  (Cost of Goods)","Invoice","2018-02-11","71112","Thompson Lighting Stores:Store #15","Die Cast Lanterns, Black, 1-100 watt, Medium Base, Clear Cracked Glass","Accounts Receivable",152,NA,14600.77
"3890","Purchases  (Cost of Goods)","Invoice","2018-02-11","71112","Thompson Lighting Stores:Store #15","Polished Brass Pendant, 1-100 watt Medium Base, Clear Ribbed Glass","Accounts Receivable",128,NA,14728.77
"3891","Purchases  (Cost of Goods)","Invoice","2018-02-11","71112","Thompson Lighting Stores:Store #15","2032 Series, (3-60 watt, Med) Desert Stone Finish","Accounts Receivable",48,NA,14776.77
"3892","Purchases  (Cost of Goods)","Invoice","2018-02-11","71112","Thompson Lighting Stores:Store #15","Brushed Nickel, 18x7.75x6, 3-60 watt Medium Base, Satin Opal Glass","Accounts Receivable",74,NA,14850.77
"3893","Purchases  (Cost of Goods)","Invoice","2018-02-11","71112","Thompson Lighting Stores:Store #15","Tapestry (8/60 watt)  Faux Alabaster Glass","Accounts Receivable",75,NA,14925.77
"3894","Purchases  (Cost of Goods)","Invoice","2018-02-11","71112","Thompson Lighting Stores:Store #15","Frosted Taupe (3/60 watt)  Marble Glass  ","Accounts Receivable",89.88,NA,15015.65
"3895","Purchases  (Cost of Goods)","Invoice","2018-02-11","71112","Thompson Lighting Stores:Store #15","Roman Bronze, 1-light Lantern, w/tail, (100 watt max)","Accounts Receivable",152,NA,15167.65
"3896","Purchases  (Cost of Goods)","Invoice","2018-02-11","71112","Thompson Lighting Stores:Store #15","Domes, White, 59x21x6 5/8 ht, 120v HPF","Accounts Receivable",54,NA,15221.65
"3897","Purchases  (Cost of Goods)","Invoice","2018-02-11","71112","Thompson Lighting Stores:Store #15","Flat Glass, (25 watt max) Polished Brass, 4 light","Accounts Receivable",50,NA,15271.65
"3898","Purchases  (Cost of Goods)","Invoice","2018-02-11","71112","Thompson Lighting Stores:Store #15","Burnished Brass (60 watt)  w/Golden Umber Accents","Accounts Receivable",75,NA,15346.65
"3899","Purchases  (Cost of Goods)","Invoice","2018-02-11","71112","Thompson Lighting Stores:Store #15","Pearl Nickle, 5 Light, Medium Base (100 watt max)","Accounts Receivable",200,NA,15546.65
"3900","Purchases  (Cost of Goods)","Invoice","2018-02-12","71088","Cole Home Builders:Phase 1 - Lot 2","Die Cast Lanterns, Black, 1-100 watt, Medium Base, Clear Cracked Glass","Accounts Receivable",228,NA,15774.65
"3901","Purchases  (Cost of Goods)","Invoice","2018-02-12","71088","Cole Home Builders:Phase 1 - Lot 2","Tapestry, (2-60 watt Med), Etched Cracked Glass, Finish 10","Accounts Receivable",90,NA,15864.65
"3902","Purchases  (Cost of Goods)","Invoice","2018-02-12","71088","Cole Home Builders:Phase 1 - Lot 2","Pearl Nickle, 5 Light, Medium Base (100 watt max)","Accounts Receivable",160,NA,16024.65
"3903","Purchases  (Cost of Goods)","Invoice","2018-02-12","71088","Cole Home Builders:Phase 1 - Lot 2","Sunset, Clear Glass, 1-100 watt max.","Accounts Receivable",70,NA,16094.65
"3904","Purchases  (Cost of Goods)","Invoice","2018-02-12","71088","Cole Home Builders:Phase 1 - Lot 2","Black Finish, Solid Brass, Clear Glass, Hanging, 2-60 watt max.","Accounts Receivable",57.57,NA,16152.22
"3905","Purchases  (Cost of Goods)","Invoice","2018-02-12","71088","Cole Home Builders:Phase 1 - Lot 2","Burnished Brass (60 watt)  w/Golden Umber Accents","Accounts Receivable",75,NA,16227.22
"3906","Purchases  (Cost of Goods)","Invoice","2018-02-12","71088","Cole Home Builders:Phase 1 - Lot 2","Chestnut (3/60 watt)  Marble Glass","Accounts Receivable",97.78,NA,16325
"3907","Purchases  (Cost of Goods)","Invoice","2018-02-12","71088","Cole Home Builders:Phase 1 - Lot 2","Pendant Bar, Textured White, 50lbs max","Accounts Receivable",10,NA,16335
"3908","Purchases  (Cost of Goods)","Invoice","2018-02-12","71088","Cole Home Builders:Phase 1 - Lot 2","Athena Collection, (100 watt max) Copper Verde, Seeded Glass","Accounts Receivable",32.14,NA,16367.14
"3909","Purchases  (Cost of Goods)","Invoice","2018-02-12","71088","Cole Home Builders:Phase 1 - Lot 2","Cand. Light, 20 watts (8 pack)","Accounts Receivable",24,NA,16391.14
"3910","Purchases  (Cost of Goods)","Invoice","2018-02-12","71088","Cole Home Builders:Phase 1 - Lot 2","Fluorescent Lamp, T-12, Medium Bipin  (30pack)","Accounts Receivable",6.34,NA,16397.48
"3911","Purchases  (Cost of Goods)","Invoice","2018-02-12","71088","Cole Home Builders:Phase 1 - Lot 2","Fluorescent Lamp, T-5, Bipin","Accounts Receivable",6,NA,16403.48
"3912","Purchases  (Cost of Goods)","Invoice","2018-02-12","71088","Cole Home Builders:Phase 1 - Lot 2","Halogen Lamp, Volts:3.5  Tubular","Accounts Receivable",2.5,NA,16405.98
"3913","Purchases  (Cost of Goods)","Invoice","2018-02-12","71088","Cole Home Builders:Phase 1 - Lot 2","Specialty Bulbs, 100 watt (6 pack)","Accounts Receivable",9.5,NA,16415.48
"3914","Purchases  (Cost of Goods)","Invoice","2018-02-12","71088","Cole Home Builders:Phase 1 - Lot 2","Specialty, Stage & Studio Bulbs  60 watt","Accounts Receivable",20,NA,16435.48
"3915","Purchases  (Cost of Goods)","Invoice","2018-02-12","71088","Cole Home Builders:Phase 1 - Lot 2","Flat Glass, (25 watt max) Polished Brass, 4 light","Accounts Receivable",40,NA,16475.48
"3916","Purchases  (Cost of Goods)","Invoice","2018-02-12","71088","Cole Home Builders:Phase 1 - Lot 2","Beveled Mirror, Etched Ribbed Glass (75 watt max)","Accounts Receivable",48.25,NA,16523.73
"3917","Purchases  (Cost of Goods)","Invoice","2018-02-14","71110","Baker's Professional Lighting:Store #05","River Rock (8/60 watt)  Faux Alabaster Glass","Accounts Receivable",150,NA,16673.73
"3918","Purchases  (Cost of Goods)","Invoice","2018-02-14","71110","Baker's Professional Lighting:Store #05","Chestnut (3/60 watt)  Marble Glass","Accounts Receivable",97.78,NA,16771.51
"3919","Purchases  (Cost of Goods)","Invoice","2018-02-14","71110","Baker's Professional Lighting:Store #05","Roman Bronze, 1-light Lantern, w/tail, (100 watt max)","Accounts Receivable",380,NA,17151.51
"3920","Purchases  (Cost of Goods)","Invoice","2018-02-14","71110","Baker's Professional Lighting:Store #05","Broadway Collection, Polished Brass, 6 Light (60 watt max)","Accounts Receivable",60,NA,17211.51
"3921","Purchases  (Cost of Goods)","Invoice","2018-02-14","71110","Baker's Professional Lighting:Store #05","Pearl Nickle, 5 Light, Medium Base (100 watt max)","Accounts Receivable",80,NA,17291.51
"3922","Purchases  (Cost of Goods)","Invoice","2018-02-14","71110","Baker's Professional Lighting:Store #05","Polished Brass Pendant, 1-100 watt Medium Base, Clear Ribbed Glass","Accounts Receivable",128,NA,17419.51
"3923","Purchases  (Cost of Goods)","Invoice","2018-02-14","71110","Baker's Professional Lighting:Store #05","Pendant Bar, Cobblestone, 50lbs. max","Accounts Receivable",22.74,NA,17442.25
"3924","Purchases  (Cost of Goods)","Bill","2018-02-15","P8890-01","Paulsen's Lighting","In bound shipments","Accounts Payable",100,NA,17542.25
"3925","Purchases  (Cost of Goods)","Invoice","2018-02-18","71093","Miscellaneous - Retail:Ruth Kuver","Chestnut (3/60 watt)  Marble Glass","Accounts Receivable",195.56,NA,17737.81
"3926","Purchases  (Cost of Goods)","Invoice","2018-02-18","71093","Miscellaneous - Retail:Ruth Kuver","Verona Collection, Pendant, Cobblestone, Etched Alabaster Glass, 150 watt max","Accounts Receivable",210,NA,17947.81
"3927","Purchases  (Cost of Goods)","Invoice","2018-02-18","71093","Miscellaneous - Retail:Ruth Kuver","Pendant Bar, Cobblestone, 50lbs. max","Accounts Receivable",22.74,NA,17970.55
"3928","Purchases  (Cost of Goods)","Invoice","2018-02-18","71093","Miscellaneous - Retail:Ruth Kuver","Broadway Collection, Polished Brass, 6 Light (60 watt max)","Accounts Receivable",90,NA,18060.55
"3929","Purchases  (Cost of Goods)","Invoice","2018-02-20","71054","Miscellaneous - Retail:Mrs. Chris Holly","Vianne Lanterns, Satin Antiqued Solid Brass, 3-light wall latern, Candelabra base (60 watt max)","Accounts Receivable",242.23,NA,18302.78
"3930","Purchases  (Cost of Goods)","Invoice","2018-02-20","71054","Miscellaneous - Retail:Mrs. Chris Holly","White, 4.5x7.5, 1-100 watt Medium Base, Satin White Glass","Accounts Receivable",45,NA,18347.78
"3931","Purchases  (Cost of Goods)","Invoice","2018-02-20","71054","Miscellaneous - Retail:Mrs. Chris Holly","Frosted Taupe (3/60 watt)  Marble Glass  ","Accounts Receivable",89.88,NA,18437.66
"3932","Purchases  (Cost of Goods)","Invoice","2018-02-20","71054","Miscellaneous - Retail:Mrs. Chris Holly","Athena Collection, Pendant, Textured White, Med. Base, 100 watt max.","Accounts Receivable",120,NA,18557.66
"3933","Purchases  (Cost of Goods)","Invoice","2018-02-20","71054","Miscellaneous - Retail:Mrs. Chris Holly","Pendant Bar, Cobblestone, 50lbs. max","Accounts Receivable",22.74,NA,18580.4
"3934","Purchases  (Cost of Goods)","Invoice","2018-02-20","71054","Miscellaneous - Retail:Mrs. Chris Holly","Drop Opal w/Solid Oak Frame, 49 1/2 x 17, 120v HPF","Accounts Receivable",40,NA,18620.4
"3935","Purchases  (Cost of Goods)","Invoice","2018-02-23","71094","Miscellaneous - Retail:David Lo","Domes, White, 59x21x6 5/8 ht, 120v HPF","Accounts Receivable",180,NA,18800.4
"3936","Purchases  (Cost of Goods)","Invoice","2018-02-23","71094","Miscellaneous - Retail:David Lo","Tiffany Collection,Golden Baroque, 1-light lantern, medium base (100 watt max)","Accounts Receivable",240,NA,19040.4
"3937","Purchases  (Cost of Goods)","Invoice","2018-02-23","71094","Miscellaneous - Retail:David Lo","Chestnut (3/60 watt)  Marble Glass","Accounts Receivable",195.56,NA,19235.96
"3938","Purchases  (Cost of Goods)","Invoice","2018-02-23","71094","Miscellaneous - Retail:David Lo","Pearl Nickle, 5 Light, Medium Base (100 watt max)","Accounts Receivable",80,NA,19315.96
"3939","Purchases  (Cost of Goods)","Invoice","2018-02-23","71094","Miscellaneous - Retail:David Lo","18x8x10, Solid Brass, 3-60watt Medium Base, Satin Etched Glass","Accounts Receivable",64,NA,19379.96
"3940","Purchases  (Cost of Goods)","Invoice","2018-02-27","71052","Baker's Professional Lighting:Store #15","Acid Verde, 10x21x10, 2-60 watt cand.","Accounts Receivable",120,NA,19499.96
"3941","Purchases  (Cost of Goods)","Invoice","2018-02-27","71052","Baker's Professional Lighting:Store #15","Polished Brass Pendant, 1-100 watt Medium Base, Clear Ribbed Glass","Accounts Receivable",96,NA,19595.96
"3942","Purchases  (Cost of Goods)","Invoice","2018-02-27","71052","Baker's Professional Lighting:Store #15","River Rock (8/60 watt)  Faux Alabaster Glass","Accounts Receivable",150,NA,19745.96
"3943","Purchases  (Cost of Goods)","Invoice","2018-02-27","71052","Baker's Professional Lighting:Store #15","Brushed Nickel, 18x7.75x6, 3-60 watt Medium Base, Satin Opal Glass","Accounts Receivable",55.5,NA,19801.46
"3944","Purchases  (Cost of Goods)","Invoice","2018-02-27","71052","Baker's Professional Lighting:Store #15","Halogen Lamp, 20 watts, Luminous Intensity","Accounts Receivable",6,NA,19807.46
"3945","Purchases  (Cost of Goods)","Invoice","2018-02-27","71052","Baker's Professional Lighting:Store #15","Specialty, Stage & Studio Bulbs  60 watt","Accounts Receivable",10,NA,19817.46
"3946","Purchases  (Cost of Goods)","Invoice","2018-02-27","71052","Baker's Professional Lighting:Store #15","2032 Series, (3-60 watt, Med) Desert Stone Finish","Accounts Receivable",72,NA,19889.46
"3947","Purchases  (Cost of Goods)","Invoice","2018-02-27","71052","Baker's Professional Lighting:Store #15","Tapestry (8/60 watt)  Faux Alabaster Glass","Accounts Receivable",75,NA,19964.46
"3948","Purchases  (Cost of Goods)","Invoice","2018-02-27","71052","Baker's Professional Lighting:Store #15","Drop Opal w/Solid Oak Frame, 49 1/2 x 17, 120v HPF","Accounts Receivable",60,NA,20024.46
"3949","Purchases  (Cost of Goods)","Invoice","2018-02-27","71052","Baker's Professional Lighting:Store #15","Fluorescent Lamp, T-5, Bipin","Accounts Receivable",2.7,NA,20027.16
"3950","Purchases  (Cost of Goods)","Bill","2018-03-09","R909878","Paulsen's Lighting","In bound shipments","Accounts Payable",150,NA,20177.16
"3951","Purchases  (Cost of Goods)","Invoice","2018-03-11","71048","Baker's Professional Lighting:Store #20","Die Cast Lanterns, Black, 1-100 watt, Medium Base, Clear Cracked Glass","Accounts Receivable",190,NA,20367.16
"3952","Purchases  (Cost of Goods)","Invoice","2018-03-11","71048","Baker's Professional Lighting:Store #20","Polished Brass Pendant, 1-100 watt Medium Base, Clear Ribbed Glass","Accounts Receivable",224,NA,20591.16
"3953","Purchases  (Cost of Goods)","Invoice","2018-03-11","71048","Baker's Professional Lighting:Store #20","Golden Umber (100 watt)  Six Light Chandelier","Accounts Receivable",170,NA,20761.16
"3954","Purchases  (Cost of Goods)","Invoice","2018-03-11","71048","Baker's Professional Lighting:Store #20","Pendant Bar, Cobblestone, 50lbs. max","Accounts Receivable",11.37,NA,20772.53
"3955","Purchases  (Cost of Goods)","Invoice","2018-03-11","71048","Baker's Professional Lighting:Store #20","Broadway Collection, Polished Brass, 6 Light (60 watt max)","Accounts Receivable",90,NA,20862.53
"3956","Purchases  (Cost of Goods)","Invoice","2018-03-11","71048","Baker's Professional Lighting:Store #20","Black Finish, Solid Brass, Clear Glass, Hanging, 2-60 watt max.","Accounts Receivable",19.19,NA,20881.72
"3957","Purchases  (Cost of Goods)","Invoice","2018-03-11","71048","Baker's Professional Lighting:Store #20","Cand. Light, 20 watts (8 pack)","Accounts Receivable",12,NA,20893.72
"3958","Purchases  (Cost of Goods)","Invoice","2018-03-11","71048","Baker's Professional Lighting:Store #20","Specialty Bulbs, 100 watt (6 pack)","Accounts Receivable",4.75,NA,20898.47
"3959","Purchases  (Cost of Goods)","Invoice","2018-03-12","71049","Lavery Lighting & Design:Store #JL-06","Tapestry, (2-60 watt Med), Etched Cracked Glass, Finish 10","Accounts Receivable",75,NA,20973.47
"3960","Purchases  (Cost of Goods)","Invoice","2018-03-12","71049","Lavery Lighting & Design:Store #JL-06","Frosted Taupe (3/60 watt)  Marble Glass  ","Accounts Receivable",535.26,NA,21508.73
"3961","Purchases  (Cost of Goods)","Invoice","2018-03-12","71049","Lavery Lighting & Design:Store #JL-06","Brushed Nickel, (3-60 watt, Med) Ribbed Glass","Accounts Receivable",120,NA,21628.73
"3962","Purchases  (Cost of Goods)","Invoice","2018-03-12","71049","Lavery Lighting & Design:Store #JL-06","Vianne Lanterns, Satin Antiqued Solid Brass, 3-light wall latern, Candelabra base (60 watt max)","Accounts Receivable",481.43,NA,22110.16
"3963","Purchases  (Cost of Goods)","Invoice","2018-03-12","71049","Lavery Lighting & Design:Store #JL-06","Athena Collection, Pendant, Textured White, Med. Base, 100 watt max.","Accounts Receivable",360,NA,22470.16
"3964","Purchases  (Cost of Goods)","Invoice","2018-03-12","71049","Lavery Lighting & Design:Store #JL-06","Pendant Bar, Textured White, 50lbs max","Accounts Receivable",40,NA,22510.16
"3965","Purchases  (Cost of Goods)","Invoice","2018-03-12","71049","Lavery Lighting & Design:Store #JL-06","Sunset, Clear Glass, 1-100 watt max.","Accounts Receivable",105,NA,22615.16
"3966","Purchases  (Cost of Goods)","Invoice","2018-03-12","71049","Lavery Lighting & Design:Store #JL-06","Specialty, Stage & Studio Bulbs  60 watt","Accounts Receivable",37.5,NA,22652.66
"3967","Purchases  (Cost of Goods)","Invoice","2018-03-12","71049","Lavery Lighting & Design:Store #JL-06","Specialty Bulbs, 100 watt (6 pack)","Accounts Receivable",9.5,NA,22662.16
"3968","Purchases  (Cost of Goods)","Invoice","2018-03-15","71056","Miscellaneous - Retail:Mr. Fred Kaseman","Die Cast Lanterns, Black, 1-100 watt, Medium Base, Clear Cracked Glass","Accounts Receivable",190,NA,22852.16
"3969","Purchases  (Cost of Goods)","Invoice","2018-03-15","71056","Miscellaneous - Retail:Mr. Fred Kaseman","Black Finish, Solid Brass, Hanging w/Clear Glass (2x60watt max)","Accounts Receivable",120,NA,22972.16
"3970","Purchases  (Cost of Goods)","Invoice","2018-03-15","71056","Miscellaneous - Retail:Mr. Fred Kaseman","Verona Collection, Pendant, Cobblestone, Etched Alabaster Glass, 150 watt max","Accounts Receivable",280,NA,23252.16
"3971","Purchases  (Cost of Goods)","Invoice","2018-03-15","71056","Miscellaneous - Retail:Mr. Fred Kaseman","Pendant Bar, Cobblestone, 50lbs. max","Accounts Receivable",45.48,NA,23297.64
"3972","Purchases  (Cost of Goods)","Invoice","2018-03-15","71056","Miscellaneous - Retail:Mr. Fred Kaseman","Frosted Taupe (3/60 watt)  Marble Glass  ","Accounts Receivable",178.42,NA,23476.06
"3973","Purchases  (Cost of Goods)","Invoice","2018-03-15","71056","Miscellaneous - Retail:Mr. Fred Kaseman","Broadway Collection, Polished Brass, 6 Light (60 watt max)","Accounts Receivable",90,NA,23566.06
"3974","Purchases  (Cost of Goods)","Invoice","2018-03-26","71065","Godwin Lighting Depot:Store #303","Vianne Lanterns, Satin Antiqued Solid Brass, 3-light wall latern, Candelabra base (60 watt max)","Accounts Receivable",192.57,NA,23758.63
"3975","Purchases  (Cost of Goods)","Invoice","2018-03-26","71065","Godwin Lighting Depot:Store #303","Renaissance Collection, (100 watt max) Millstone Finish, One-light","Accounts Receivable",131.82,NA,23890.45
"3976","Purchases  (Cost of Goods)","Invoice","2018-03-26","71065","Godwin Lighting Depot:Store #303","Drop Opal w/Solid Oak Frame, 49 1/2 x 17, 120v HPF","Accounts Receivable",40,NA,23930.45
"3977","Purchases  (Cost of Goods)","Invoice","2018-03-26","71065","Godwin Lighting Depot:Store #303","Beveled Mirror, Etched Ribbed Glass (75 watt max)","Accounts Receivable",72.38,NA,24002.83
"3978","Purchases  (Cost of Goods)","Invoice","2018-03-26","71065","Godwin Lighting Depot:Store #303","Chestnut (3/60 watt)  Marble Glass","Accounts Receivable",195.56,NA,24198.39
"3979","Purchases  (Cost of Goods)","Invoice","2018-03-26","71065","Godwin Lighting Depot:Store #303","2032 Series, (3-60 watt, Med) Desert Stone Finish","Accounts Receivable",60,NA,24258.39
"3980","Purchases  (Cost of Goods)","Invoice","2018-03-26","71065","Godwin Lighting Depot:Store #303","Pearl Nickle, 5 Light, Medium Base (100 watt max)","Accounts Receivable",80,NA,24338.39
"3981","Purchases  (Cost of Goods)","Invoice","2018-03-26","71065","Godwin Lighting Depot:Store #303","Verona Collection, Pendant, Cobblestone, Etched Alabaster Glass, 150 watt max","Accounts Receivable",280,NA,24618.39
"3982","Purchases  (Cost of Goods)","Invoice","2018-03-26","71065","Godwin Lighting Depot:Store #303","Pendant Bar, Cobblestone, 50lbs. max","Accounts Receivable",45.48,NA,24663.87
"3983","Purchases  (Cost of Goods)","Invoice","2018-03-26","71065","Godwin Lighting Depot:Store #303","Cand. Light, 20 watts (8 pack)","Accounts Receivable",36,NA,24699.87
"3984","Purchases  (Cost of Goods)","Invoice","2018-03-26","71065","Godwin Lighting Depot:Store #303","Fluorescent Lamp, T-12, Medium Bipin  (30pack)","Accounts Receivable",6.34,NA,24706.21
"3985","Purchases  (Cost of Goods)","Invoice","2018-03-26","71065","Godwin Lighting Depot:Store #303","Halogen Lamp, 20 watts, Luminous Intensity","Accounts Receivable",24,NA,24730.21
"3986","Purchases  (Cost of Goods)","Invoice","2018-03-26","71065","Godwin Lighting Depot:Store #303","Specialty Bulbs, 100 watt (6 pack)","Accounts Receivable",9.5,NA,24739.71
"3987","Purchases  (Cost of Goods)","Invoice","2018-03-26","71065","Godwin Lighting Depot:Store #303","Specialty, Stage & Studio Bulbs  60 watt","Accounts Receivable",22.5,NA,24762.21
"3988","Purchases  (Cost of Goods)","Invoice","2018-03-27","71060","Godwin Lighting Depot:Store #404","Black Finish, Solid Brass, Clear Glass, Hanging, 2-60 watt max.","Accounts Receivable",57.57,NA,24819.78
"3989","Purchases  (Cost of Goods)","Invoice","2018-03-27","71060","Godwin Lighting Depot:Store #404","Black Finish, Solid Brass,Wall Mount w/Clear Glass (2x60watt max)","Accounts Receivable",200,NA,25019.78
"3990","Purchases  (Cost of Goods)","Invoice","2018-03-27","71060","Godwin Lighting Depot:Store #404","Tapestry (8/60 watt)  Faux Alabaster Glass","Accounts Receivable",150,NA,25169.78
"3991","Purchases  (Cost of Goods)","Invoice","2018-03-27","71060","Godwin Lighting Depot:Store #404","Athena Collection, (100 watt max) Copper Verde, Seeded Glass","Accounts Receivable",160.71,NA,25330.49
"3992","Purchases  (Cost of Goods)","Invoice","2018-03-27","71060","Godwin Lighting Depot:Store #404","Broadway Collection, Polished Chrome, 4 Light (60 watt max)","Accounts Receivable",126,NA,25456.49
"3993","Purchases  (Cost of Goods)","Invoice","2018-03-27","71060","Godwin Lighting Depot:Store #404","Halogen Lamp, Volts:3.5  Tubular","Accounts Receivable",5,NA,25461.49
"3994","Purchases  (Cost of Goods)","Invoice","2018-03-27","71060","Godwin Lighting Depot:Store #404","Specialty Bulbs, 100 watt (6 pack)","Accounts Receivable",9.5,NA,25470.99
"3995","Purchases  (Cost of Goods)","Invoice","2018-03-27","71060","Godwin Lighting Depot:Store #404","Specialty, Stage & Studio Bulbs  60 watt","Accounts Receivable",17.5,NA,25488.49
"3996","Purchases  (Cost of Goods)","Invoice","2018-03-27","71060","Godwin Lighting Depot:Store #404","Fluorescent Lamp, T-12, Medium Bipin  (30pack)","Accounts Receivable",6.34,NA,25494.83
"3997","Purchases  (Cost of Goods)","Invoice","2018-03-27","71060","Godwin Lighting Depot:Store #404","Domes, White, 59x21x6 5/8 ht, 120v HPF","Accounts Receivable",36,NA,25530.83
"3998","Purchases  (Cost of Goods)","Invoice","2018-03-28","71071","Dan A. North Builders:McCarthy Properties","Flat Glass, (25 watt max) Polished Brass, 4 light","Accounts Receivable",750,NA,26280.83
"3999","Purchases  (Cost of Goods)","Invoice","2018-03-28","71071","Dan A. North Builders:McCarthy Properties","Domes, White, 59x21x6 5/8 ht, 120v HPF","Accounts Receivable",1800,NA,28080.83
"4000","Purchases  (Cost of Goods)","Invoice","2018-03-28","71071","Dan A. North Builders:McCarthy Properties","Flush Mount, Polished Brass (2, 13 watt)  White acrylic diffuser","Accounts Receivable",400,NA,28480.83
"4001","Purchases  (Cost of Goods)","Invoice","2018-03-28","71071","Dan A. North Builders:McCarthy Properties","Halogen Lamp, Volts:3.5  Tubular","Accounts Receivable",50,NA,28530.83
"4002","Purchases  (Cost of Goods)","Invoice","2018-03-28","71071","Dan A. North Builders:McCarthy Properties","Fluorescent Lamp, T-5, Bipin","Accounts Receivable",30,NA,28560.83
"4003","Purchases  (Cost of Goods)","Invoice","2018-03-28","71071","Dan A. North Builders:McCarthy Properties","Fluorescent Lamp, T-12, Medium Bipin  (30pack)","Accounts Receivable",63.43,NA,28624.26
"4004","Purchases  (Cost of Goods)","Invoice","2018-03-28","71071","Dan A. North Builders:McCarthy Properties","Drop Opal w/Solid Oak Frame, 49 1/2 x 17, 120v HPF","Accounts Receivable",640,NA,29264.26
"4005","Purchases  (Cost of Goods)","Invoice","2018-03-28","71125","Kern Lighting Warehouse:Store #45","Vianne Lanterns, Satin Antiqued Solid Brass, 3-light wall latern, Candelabra base (60 watt max)","Accounts Receivable",1396.14,NA,30660.4
"4006","Purchases  (Cost of Goods)","Invoice","2018-03-28","71125","Kern Lighting Warehouse:Store #45","Cand. Light, 20 watts (8 pack)","Accounts Receivable",2400,NA,33060.4
"4007","Purchases  (Cost of Goods)","Invoice","2018-04-10","71057","Miscellaneous - Retail:Mr. Jay Jessen","Chestnut (3/60 watt)  Marble Glass","Accounts Receivable",293.33,NA,33353.73
"4008","Purchases  (Cost of Goods)","Invoice","2018-04-10","71057","Miscellaneous - Retail:Mr. Jay Jessen","Domes, White, 59x21x6 5/8 ht, 120v HPF","Accounts Receivable",72,NA,33425.73
"4009","Purchases  (Cost of Goods)","Invoice","2018-04-10","71057","Miscellaneous - Retail:Mr. Jay Jessen","Drop Opal w/Solid Oak Frame, 49 1/2 x 17, 120v HPF","Accounts Receivable",40,NA,33465.73
"4010","Purchases  (Cost of Goods)","Invoice","2018-04-13","71126","Kern Lighting Warehouse:Store #13","Golden Umber (100 watt)  Six Light Chandelier","Accounts Receivable",3400,NA,36865.73
"4011","Purchases  (Cost of Goods)","Invoice","2018-04-16","71087","Cole Home Builders:Phase 1 - Lot 5","Die Cast Lanterns, Black, 1-100 watt, Medium Base, Clear Cracked Glass","Accounts Receivable",231.19,NA,37096.92
"4012","Purchases  (Cost of Goods)","Invoice","2018-04-16","71087","Cole Home Builders:Phase 1 - Lot 5","Tapestry, (2-60 watt Med), Etched Cracked Glass, Finish 10","Accounts Receivable",90,NA,37186.92
"4013","Purchases  (Cost of Goods)","Invoice","2018-04-16","71087","Cole Home Builders:Phase 1 - Lot 5","Pearl Nickle, 5 Light, Medium Base (100 watt max)","Accounts Receivable",160,NA,37346.92
"4014","Purchases  (Cost of Goods)","Invoice","2018-04-16","71087","Cole Home Builders:Phase 1 - Lot 5","Sunset, Clear Glass, 1-100 watt max.","Accounts Receivable",70,NA,37416.92
"4015","Purchases  (Cost of Goods)","Invoice","2018-04-16","71087","Cole Home Builders:Phase 1 - Lot 5","Black Finish, Solid Brass, Clear Glass, Hanging, 2-60 watt max.","Accounts Receivable",57.66,NA,37474.58
"4016","Purchases  (Cost of Goods)","Invoice","2018-04-16","71087","Cole Home Builders:Phase 1 - Lot 5","Burnished Brass (60 watt)  w/Golden Umber Accents","Accounts Receivable",75,NA,37549.58
"4017","Purchases  (Cost of Goods)","Invoice","2018-04-16","71087","Cole Home Builders:Phase 1 - Lot 5","Chestnut (3/60 watt)  Marble Glass","Accounts Receivable",97.78,NA,37647.36
"4018","Purchases  (Cost of Goods)","Invoice","2018-04-16","71087","Cole Home Builders:Phase 1 - Lot 5","Pendant Bar, Textured White, 50lbs max","Accounts Receivable",10.77,NA,37658.13
"4019","Purchases  (Cost of Goods)","Invoice","2018-04-16","71087","Cole Home Builders:Phase 1 - Lot 5","Athena Collection, (100 watt max) Copper Verde, Seeded Glass","Accounts Receivable",32.14,NA,37690.27
"4020","Purchases  (Cost of Goods)","Invoice","2018-04-16","71087","Cole Home Builders:Phase 1 - Lot 5","Cand. Light, 20 watts (8 pack)","Accounts Receivable",24,NA,37714.27
"4021","Purchases  (Cost of Goods)","Invoice","2018-04-16","71087","Cole Home Builders:Phase 1 - Lot 5","Fluorescent Lamp, T-12, Medium Bipin  (30pack)","Accounts Receivable",6.34,NA,37720.61
"4022","Purchases  (Cost of Goods)","Invoice","2018-04-16","71087","Cole Home Builders:Phase 1 - Lot 5","Fluorescent Lamp, T-5, Bipin","Accounts Receivable",6,NA,37726.61
"4023","Purchases  (Cost of Goods)","Invoice","2018-04-16","71087","Cole Home Builders:Phase 1 - Lot 5","Halogen Lamp, Volts:3.5  Tubular","Accounts Receivable",2.5,NA,37729.11
"4024","Purchases  (Cost of Goods)","Invoice","2018-04-16","71087","Cole Home Builders:Phase 1 - Lot 5","Specialty Bulbs, 100 watt (6 pack)","Accounts Receivable",9.5,NA,37738.61
"4025","Purchases  (Cost of Goods)","Invoice","2018-04-16","71087","Cole Home Builders:Phase 1 - Lot 5","Specialty, Stage & Studio Bulbs  60 watt","Accounts Receivable",20,NA,37758.61
"4026","Purchases  (Cost of Goods)","Invoice","2018-04-16","71087","Cole Home Builders:Phase 1 - Lot 5","Flat Glass, (25 watt max) Polished Brass, 4 light","Accounts Receivable",48.49,NA,37807.1
"4027","Purchases  (Cost of Goods)","Invoice","2018-04-16","71087","Cole Home Builders:Phase 1 - Lot 5","Beveled Mirror, Etched Ribbed Glass (75 watt max)","Accounts Receivable",48.99,NA,37856.09
"4028","Purchases  (Cost of Goods)","Bill","2018-04-16","0987","Paulsen's Lighting","In bound shipments","Accounts Payable",100,NA,37956.09
"4029","Purchases  (Cost of Goods)","Invoice","2018-04-17","71061","Godwin Lighting Depot:Store #202","Black Finish, Solid Brass, Clear Glass, Hanging, 2-60 watt max.","Accounts Receivable",57.66,NA,38013.75
"4030","Purchases  (Cost of Goods)","Invoice","2018-04-17","71061","Godwin Lighting Depot:Store #202","Black Finish, Solid Brass,Wall Mount w/Clear Glass (2x60watt max)","Accounts Receivable",200,NA,38213.75
"4031","Purchases  (Cost of Goods)","Invoice","2018-04-17","71061","Godwin Lighting Depot:Store #202","Tapestry (8/60 watt)  Faux Alabaster Glass","Accounts Receivable",150,NA,38363.75
"4032","Purchases  (Cost of Goods)","Invoice","2018-04-17","71061","Godwin Lighting Depot:Store #202","Athena Collection, (100 watt max) Copper Verde, Seeded Glass","Accounts Receivable",160.71,NA,38524.46
"4033","Purchases  (Cost of Goods)","Invoice","2018-04-17","71061","Godwin Lighting Depot:Store #202","Broadway Collection, Polished Chrome, 4 Light (60 watt max)","Accounts Receivable",126,NA,38650.46
"4034","Purchases  (Cost of Goods)","Invoice","2018-04-17","71061","Godwin Lighting Depot:Store #202","Halogen Lamp, Volts:3.5  Tubular","Accounts Receivable",5,NA,38655.46
"4035","Purchases  (Cost of Goods)","Invoice","2018-04-17","71061","Godwin Lighting Depot:Store #202","Specialty Bulbs, 100 watt (6 pack)","Accounts Receivable",9.5,NA,38664.96
"4036","Purchases  (Cost of Goods)","Invoice","2018-04-17","71061","Godwin Lighting Depot:Store #202","Specialty, Stage & Studio Bulbs  60 watt","Accounts Receivable",17.5,NA,38682.46
"4037","Purchases  (Cost of Goods)","Invoice","2018-04-17","71061","Godwin Lighting Depot:Store #202","Fluorescent Lamp, T-12, Medium Bipin  (30pack)","Accounts Receivable",6.34,NA,38688.8
"4038","Purchases  (Cost of Goods)","Invoice","2018-04-17","71061","Godwin Lighting Depot:Store #202","Domes, White, 59x21x6 5/8 ht, 120v HPF","Accounts Receivable",38,NA,38726.8
"4039","Purchases  (Cost of Goods)","Invoice","2018-04-22","71064","Godwin Lighting Depot:Store #404","Vianne Lanterns, Satin Antiqued Solid Brass, 3-light wall latern, Candelabra base (60 watt max)","Accounts Receivable",192.57,NA,38919.37
"4040","Purchases  (Cost of Goods)","Invoice","2018-04-22","71064","Godwin Lighting Depot:Store #404","Renaissance Collection, (100 watt max) Millstone Finish, One-light","Accounts Receivable",131.82,NA,39051.19
"4041","Purchases  (Cost of Goods)","Invoice","2018-04-22","71064","Godwin Lighting Depot:Store #404","Drop Opal w/Solid Oak Frame, 49 1/2 x 17, 120v HPF","Accounts Receivable",42.88,NA,39094.07
"4042","Purchases  (Cost of Goods)","Invoice","2018-04-22","71064","Godwin Lighting Depot:Store #404","Beveled Mirror, Etched Ribbed Glass (75 watt max)","Accounts Receivable",73.49,NA,39167.56
"4043","Purchases  (Cost of Goods)","Invoice","2018-04-22","71064","Godwin Lighting Depot:Store #404","Chestnut (3/60 watt)  Marble Glass","Accounts Receivable",195.56,NA,39363.12
"4044","Purchases  (Cost of Goods)","Invoice","2018-04-22","71064","Godwin Lighting Depot:Store #404","2032 Series, (3-60 watt, Med) Desert Stone Finish","Accounts Receivable",60,NA,39423.12
"4045","Purchases  (Cost of Goods)","Invoice","2018-04-22","71064","Godwin Lighting Depot:Store #404","Pearl Nickle, 5 Light, Medium Base (100 watt max)","Accounts Receivable",80,NA,39503.12
"4046","Purchases  (Cost of Goods)","Invoice","2018-04-22","71064","Godwin Lighting Depot:Store #404","Verona Collection, Pendant, Cobblestone, Etched Alabaster Glass, 150 watt max","Accounts Receivable",280,NA,39783.12
"4047","Purchases  (Cost of Goods)","Invoice","2018-04-22","71064","Godwin Lighting Depot:Store #404","Pendant Bar, Cobblestone, 50lbs. max","Accounts Receivable",45.48,NA,39828.6
"4048","Purchases  (Cost of Goods)","Invoice","2018-04-22","71064","Godwin Lighting Depot:Store #404","Cand. Light, 20 watts (8 pack)","Accounts Receivable",36,NA,39864.6
"4049","Purchases  (Cost of Goods)","Invoice","2018-04-22","71064","Godwin Lighting Depot:Store #404","Fluorescent Lamp, T-12, Medium Bipin  (30pack)","Accounts Receivable",6.34,NA,39870.94
"4050","Purchases  (Cost of Goods)","Invoice","2018-04-22","71064","Godwin Lighting Depot:Store #404","Halogen Lamp, 20 watts, Luminous Intensity","Accounts Receivable",24,NA,39894.94
"4051","Purchases  (Cost of Goods)","Invoice","2018-04-22","71064","Godwin Lighting Depot:Store #404","Specialty Bulbs, 100 watt (6 pack)","Accounts Receivable",9.5,NA,39904.44
"4052","Purchases  (Cost of Goods)","Invoice","2018-04-22","71064","Godwin Lighting Depot:Store #404","Specialty, Stage & Studio Bulbs  60 watt","Accounts Receivable",22.5,NA,39926.94
"4053","Purchases  (Cost of Goods)","Invoice","2018-04-25","71058","Miscellaneous - Retail:Mrs. Anne Hemp","River Rock (8/60 watt)  Faux Alabaster Glass","Accounts Receivable",150,NA,40076.94
"4054","Purchases  (Cost of Goods)","Invoice","2018-04-25","71058","Miscellaneous - Retail:Mrs. Anne Hemp","Tiffany Collection,Golden Baroque, 1-light lantern, medium base (100 watt max)","Accounts Receivable",192,NA,40268.94
"4055","Purchases  (Cost of Goods)","Invoice","2018-04-25","71058","Miscellaneous - Retail:Mrs. Anne Hemp","Brushed Nickel, Pendant, 1-100 watt Medium Base, Satin Etched Glass","Accounts Receivable",100,NA,40368.94
"4056","Purchases  (Cost of Goods)","Invoice","2018-04-25","71058","Miscellaneous - Retail:Mrs. Anne Hemp","Pendant Bar, Textured White, 50lbs max","Accounts Receivable",21.54,NA,40390.48
"4057","Purchases  (Cost of Goods)","Invoice","2018-04-25","71058","Miscellaneous - Retail:Mrs. Anne Hemp","Pearl Nickle, 5 Light, Medium Base (100 watt max)","Accounts Receivable",120,NA,40510.48
"4058","Purchases  (Cost of Goods)","Invoice","2018-04-28","71066","Godwin Lighting Depot:Store #909","Vianne Lanterns, Satin Antiqued Solid Brass, 3-light wall latern, Candelabra base (60 watt max)","Accounts Receivable",192.57,NA,40703.05
"4059","Purchases  (Cost of Goods)","Invoice","2018-04-28","71066","Godwin Lighting Depot:Store #909","Renaissance Collection, (100 watt max) Millstone Finish, One-light","Accounts Receivable",131.82,NA,40834.87
"4060","Purchases  (Cost of Goods)","Invoice","2018-04-28","71066","Godwin Lighting Depot:Store #909","Drop Opal w/Solid Oak Frame, 49 1/2 x 17, 120v HPF","Accounts Receivable",42.88,NA,40877.75
"4061","Purchases  (Cost of Goods)","Invoice","2018-04-28","71066","Godwin Lighting Depot:Store #909","Beveled Mirror, Etched Ribbed Glass (75 watt max)","Accounts Receivable",73.49,NA,40951.24
"4062","Purchases  (Cost of Goods)","Invoice","2018-04-28","71066","Godwin Lighting Depot:Store #909","Chestnut (3/60 watt)  Marble Glass","Accounts Receivable",195.56,NA,41146.8
"4063","Purchases  (Cost of Goods)","Invoice","2018-04-28","71066","Godwin Lighting Depot:Store #909","2032 Series, (3-60 watt, Med) Desert Stone Finish","Accounts Receivable",60,NA,41206.8
"4064","Purchases  (Cost of Goods)","Invoice","2018-04-28","71066","Godwin Lighting Depot:Store #909","Pearl Nickle, 5 Light, Medium Base (100 watt max)","Accounts Receivable",80,NA,41286.8
"4065","Purchases  (Cost of Goods)","Invoice","2018-04-28","71066","Godwin Lighting Depot:Store #909","Verona Collection, Pendant, Cobblestone, Etched Alabaster Glass, 150 watt max","Accounts Receivable",280,NA,41566.8
"4066","Purchases  (Cost of Goods)","Invoice","2018-04-28","71066","Godwin Lighting Depot:Store #909","Pendant Bar, Cobblestone, 50lbs. max","Accounts Receivable",45.48,NA,41612.28
"4067","Purchases  (Cost of Goods)","Invoice","2018-04-28","71066","Godwin Lighting Depot:Store #909","Cand. Light, 20 watts (8 pack)","Accounts Receivable",36,NA,41648.28
"4068","Purchases  (Cost of Goods)","Invoice","2018-04-28","71066","Godwin Lighting Depot:Store #909","Fluorescent Lamp, T-12, Medium Bipin  (30pack)","Accounts Receivable",6.34,NA,41654.62
"4069","Purchases  (Cost of Goods)","Invoice","2018-04-28","71066","Godwin Lighting Depot:Store #909","Halogen Lamp, 20 watts, Luminous Intensity","Accounts Receivable",24,NA,41678.62
"4070","Purchases  (Cost of Goods)","Invoice","2018-04-28","71066","Godwin Lighting Depot:Store #909","Specialty Bulbs, 100 watt (6 pack)","Accounts Receivable",9.5,NA,41688.12
"4071","Purchases  (Cost of Goods)","Invoice","2018-04-28","71066","Godwin Lighting Depot:Store #909","Specialty, Stage & Studio Bulbs  60 watt","Accounts Receivable",22.5,NA,41710.62
"4072","Purchases  (Cost of Goods)","Invoice","2018-04-28","71067","Dan A. North Builders:Wagner Suites","Colonial, Brushed Steel Finish, Opal White Glass (60 watt)","Accounts Receivable",1000,NA,42710.62
"4073","Purchases  (Cost of Goods)","Invoice","2018-04-28","71067","Dan A. North Builders:Wagner Suites","Beveled Mirror, Etched Ribbed Glass (75 watt max)","Accounts Receivable",1224.85,NA,43935.47
"4074","Purchases  (Cost of Goods)","Invoice","2018-04-28","71067","Dan A. North Builders:Wagner Suites","Specialty, Stage & Studio Bulbs  60 watt","Accounts Receivable",25,NA,43960.47
"4075","Purchases  (Cost of Goods)","Invoice","2018-04-28","71067","Dan A. North Builders:Wagner Suites","Specialty Bulbs, 100 watt (6 pack)","Accounts Receivable",118.75,NA,44079.22
"4076","Purchases  (Cost of Goods)","Invoice","2018-04-28","71067","Dan A. North Builders:Wagner Suites","Flush Mount, Polished Brass (2, 13 watt)  White acrylic diffuser","Accounts Receivable",1602.9,NA,45682.12
"4077","Purchases  (Cost of Goods)","Invoice","2018-04-28","71067","Dan A. North Builders:Wagner Suites","Fluorescent Lamp, T-12, Medium Bipin  (30pack)","Accounts Receivable",31.71,NA,45713.83
"4078","Purchases  (Cost of Goods)","Invoice","2018-05-02","71062","Godwin Lighting Depot:Store #404","Black Finish, Solid Brass, Clear Glass, Hanging, 2-60 watt max.","Accounts Receivable",57.66,NA,45771.49
"4079","Purchases  (Cost of Goods)","Invoice","2018-05-02","71062","Godwin Lighting Depot:Store #404","Black Finish, Solid Brass,Wall Mount w/Clear Glass (2x60watt max)","Accounts Receivable",200,NA,45971.49
"4080","Purchases  (Cost of Goods)","Invoice","2018-05-02","71062","Godwin Lighting Depot:Store #404","Tapestry (8/60 watt)  Faux Alabaster Glass","Accounts Receivable",150,NA,46121.49
"4081","Purchases  (Cost of Goods)","Invoice","2018-05-02","71062","Godwin Lighting Depot:Store #404","Athena Collection, (100 watt max) Copper Verde, Seeded Glass","Accounts Receivable",160.71,NA,46282.2
"4082","Purchases  (Cost of Goods)","Invoice","2018-05-02","71062","Godwin Lighting Depot:Store #404","Broadway Collection, Polished Chrome, 4 Light (60 watt max)","Accounts Receivable",126,NA,46408.2
"4083","Purchases  (Cost of Goods)","Invoice","2018-05-02","71062","Godwin Lighting Depot:Store #404","Halogen Lamp, Volts:3.5  Tubular","Accounts Receivable",5,NA,46413.2
"4084","Purchases  (Cost of Goods)","Invoice","2018-05-02","71062","Godwin Lighting Depot:Store #404","Specialty Bulbs, 100 watt (6 pack)","Accounts Receivable",9.5,NA,46422.7
"4085","Purchases  (Cost of Goods)","Invoice","2018-05-02","71062","Godwin Lighting Depot:Store #404","Specialty, Stage & Studio Bulbs  60 watt","Accounts Receivable",17.5,NA,46440.2
"4086","Purchases  (Cost of Goods)","Invoice","2018-05-02","71062","Godwin Lighting Depot:Store #404","Fluorescent Lamp, T-12, Medium Bipin  (30pack)","Accounts Receivable",6.34,NA,46446.54
"4087","Purchases  (Cost of Goods)","Invoice","2018-05-02","71062","Godwin Lighting Depot:Store #404","Domes, White, 59x21x6 5/8 ht, 120v HPF","Accounts Receivable",38,NA,46484.54
"4088","Purchases  (Cost of Goods)","Invoice","2018-05-09","71111","Baker's Professional Lighting:Store #10","Acid Verde, 10x21x10, 2-60 watt cand.","Accounts Receivable",240,NA,46724.54
"4089","Purchases  (Cost of Goods)","Invoice","2018-05-09","71111","Baker's Professional Lighting:Store #10","Beveled Mirror, Etched Ribbed Glass (75 watt max)","Accounts Receivable",122.49,NA,46847.03
"4090","Purchases  (Cost of Goods)","Invoice","2018-05-09","71111","Baker's Professional Lighting:Store #10","Golden Umber (100 watt)  Six Light Chandelier","Accounts Receivable",170,NA,47017.03
"4091","Purchases  (Cost of Goods)","Invoice","2018-05-09","71111","Baker's Professional Lighting:Store #10","Burnished Brass (60 watt)  w/Golden Umber Accents","Accounts Receivable",150,NA,47167.03
"4092","Purchases  (Cost of Goods)","Invoice","2018-05-09","71111","Baker's Professional Lighting:Store #10","Specialty Bulbs, 100 watt (6 pack)","Accounts Receivable",9.5,NA,47176.53
"4093","Purchases  (Cost of Goods)","Invoice","2018-05-09","71111","Baker's Professional Lighting:Store #10","Specialty, Stage & Studio Bulbs  60 watt","Accounts Receivable",10,NA,47186.53
"4094","Purchases  (Cost of Goods)","Invoice","2018-05-09","71111","Baker's Professional Lighting:Store #10","Cand. Light, 20 watts (8 pack)","Accounts Receivable",24,NA,47210.53
"4095","Purchases  (Cost of Goods)","Invoice","2018-05-10","71068","Godwin Lighting Depot:Store #909","Vianne Lanterns, Satin Antiqued Solid Brass, 3-light wall latern, Candelabra base (60 watt max)","Accounts Receivable",192.57,NA,47403.1
"4096","Purchases  (Cost of Goods)","Invoice","2018-05-10","71068","Godwin Lighting Depot:Store #909","Renaissance Collection, (100 watt max) Millstone Finish, One-light","Accounts Receivable",131.82,NA,47534.92
"4097","Purchases  (Cost of Goods)","Invoice","2018-05-10","71068","Godwin Lighting Depot:Store #909","Drop Opal w/Solid Oak Frame, 49 1/2 x 17, 120v HPF","Accounts Receivable",42.88,NA,47577.8
"4098","Purchases  (Cost of Goods)","Invoice","2018-05-10","71068","Godwin Lighting Depot:Store #909","Beveled Mirror, Etched Ribbed Glass (75 watt max)","Accounts Receivable",73.49,NA,47651.29
"4099","Purchases  (Cost of Goods)","Invoice","2018-05-10","71068","Godwin Lighting Depot:Store #909","Chestnut (3/60 watt)  Marble Glass","Accounts Receivable",194.4,NA,47845.69
"4100","Purchases  (Cost of Goods)","Invoice","2018-05-10","71068","Godwin Lighting Depot:Store #909","2032 Series, (3-60 watt, Med) Desert Stone Finish","Accounts Receivable",60,NA,47905.69
"4101","Purchases  (Cost of Goods)","Invoice","2018-05-10","71068","Godwin Lighting Depot:Store #909","Pearl Nickle, 5 Light, Medium Base (100 watt max)","Accounts Receivable",80,NA,47985.69
"4102","Purchases  (Cost of Goods)","Invoice","2018-05-10","71068","Godwin Lighting Depot:Store #909","Verona Collection, Pendant, Cobblestone, Etched Alabaster Glass, 150 watt max","Accounts Receivable",280,NA,48265.69
"4103","Purchases  (Cost of Goods)","Invoice","2018-05-10","71068","Godwin Lighting Depot:Store #909","Pendant Bar, Cobblestone, 50lbs. max","Accounts Receivable",45.48,NA,48311.17
"4104","Purchases  (Cost of Goods)","Invoice","2018-05-10","71068","Godwin Lighting Depot:Store #909","Cand. Light, 20 watts (8 pack)","Accounts Receivable",36,NA,48347.17
"4105","Purchases  (Cost of Goods)","Invoice","2018-05-10","71068","Godwin Lighting Depot:Store #909","Fluorescent Lamp, T-12, Medium Bipin  (30pack)","Accounts Receivable",6.34,NA,48353.51
"4106","Purchases  (Cost of Goods)","Invoice","2018-05-10","71068","Godwin Lighting Depot:Store #909","Halogen Lamp, 20 watts, Luminous Intensity","Accounts Receivable",24,NA,48377.51
"4107","Purchases  (Cost of Goods)","Invoice","2018-05-10","71068","Godwin Lighting Depot:Store #909","Specialty Bulbs, 100 watt (6 pack)","Accounts Receivable",9.5,NA,48387.01
"4108","Purchases  (Cost of Goods)","Invoice","2018-05-10","71068","Godwin Lighting Depot:Store #909","Specialty, Stage & Studio Bulbs  60 watt","Accounts Receivable",22.5,NA,48409.51
"4109","Purchases  (Cost of Goods)","Invoice","2018-05-16","71095","Miscellaneous - Retail:Carlos Nazar","Acid Verde, 10x21x10, 2-60 watt cand.","Accounts Receivable",300,NA,48709.51
"4110","Purchases  (Cost of Goods)","Invoice","2018-05-16","71095","Miscellaneous - Retail:Carlos Nazar","Frosted Taupe (3/60 watt)  Marble Glass  ","Accounts Receivable",178.42,NA,48887.93
"4111","Purchases  (Cost of Goods)","Invoice","2018-05-16","71095","Miscellaneous - Retail:Carlos Nazar","Black Finish, Solid Brass, Clear Glass, Hanging, 2-60 watt max.","Accounts Receivable",76.88,NA,48964.81
"4112","Purchases  (Cost of Goods)","Invoice","2018-05-16","71095","Miscellaneous - Retail:Carlos Nazar","Beveled Mirror, Etched Ribbed Glass (75 watt max)","Accounts Receivable",97.99,NA,49062.8
"4113","Purchases  (Cost of Goods)","Invoice","2018-05-16","71095","Miscellaneous - Retail:Carlos Nazar","Athena Collection, Pendant, Textured White, Med. Base, 100 watt max.","Accounts Receivable",180,NA,49242.8
"4114","Purchases  (Cost of Goods)","Invoice","2018-05-16","71095","Miscellaneous - Retail:Carlos Nazar","Pendant Bar, Cobblestone, 50lbs. max","Accounts Receivable",34.11,NA,49276.91
"4115","Purchases  (Cost of Goods)","Invoice","2018-05-16","71113","Thompson Lighting Stores:Store #20","Acid Verde, 10x21x10, 2-60 watt cand.","Accounts Receivable",180,NA,49456.91
"4116","Purchases  (Cost of Goods)","Invoice","2018-05-16","71113","Thompson Lighting Stores:Store #20","Die Cast Lanterns, Black, 1-100 watt, Medium Base, Clear Cracked Glass","Accounts Receivable",154.13,NA,49611.04
"4117","Purchases  (Cost of Goods)","Invoice","2018-05-16","71113","Thompson Lighting Stores:Store #20","Polished Brass Pendant, 1-100 watt Medium Base, Clear Ribbed Glass","Accounts Receivable",128,NA,49739.04
"4118","Purchases  (Cost of Goods)","Invoice","2018-05-16","71113","Thompson Lighting Stores:Store #20","2032 Series, (3-60 watt, Med) Desert Stone Finish","Accounts Receivable",48,NA,49787.04
"4119","Purchases  (Cost of Goods)","Invoice","2018-05-16","71113","Thompson Lighting Stores:Store #20","Brushed Nickel, 18x7.75x6, 3-60 watt Medium Base, Satin Opal Glass","Accounts Receivable",74,NA,49861.04
"4120","Purchases  (Cost of Goods)","Invoice","2018-05-16","71113","Thompson Lighting Stores:Store #20","Tapestry (8/60 watt)  Faux Alabaster Glass","Accounts Receivable",75,NA,49936.04
"4121","Purchases  (Cost of Goods)","Invoice","2018-05-16","71113","Thompson Lighting Stores:Store #20","Frosted Taupe (3/60 watt)  Marble Glass  ","Accounts Receivable",89.21,NA,50025.25
"4122","Purchases  (Cost of Goods)","Invoice","2018-05-16","71113","Thompson Lighting Stores:Store #20","Roman Bronze, 1-light Lantern, w/tail, (100 watt max)","Accounts Receivable",152,NA,50177.25
"4123","Purchases  (Cost of Goods)","Invoice","2018-05-16","71113","Thompson Lighting Stores:Store #20","Domes, White, 59x21x6 5/8 ht, 120v HPF","Accounts Receivable",57,NA,50234.25
"4124","Purchases  (Cost of Goods)","Invoice","2018-05-16","71113","Thompson Lighting Stores:Store #20","Flat Glass, (25 watt max) Polished Brass, 4 light","Accounts Receivable",60.61,NA,50294.86
"4125","Purchases  (Cost of Goods)","Invoice","2018-05-16","71113","Thompson Lighting Stores:Store #20","Burnished Brass (60 watt)  w/Golden Umber Accents","Accounts Receivable",75,NA,50369.86
"4126","Purchases  (Cost of Goods)","Invoice","2018-05-16","71113","Thompson Lighting Stores:Store #20","Pearl Nickle, 5 Light, Medium Base (100 watt max)","Accounts Receivable",200,NA,50569.86
"4127","Purchases  (Cost of Goods)","Invoice","2018-05-18","71084","Cole Home Builders:Phase 1 - Lot 5","Acid Verde, 10x21x10, 2-60 watt cand.","Accounts Receivable",60,NA,50629.86
"4128","Purchases  (Cost of Goods)","Invoice","2018-05-18","71084","Cole Home Builders:Phase 1 - Lot 5","Sunset, Clear Glass, 1-100 watt max.","Accounts Receivable",52.5,NA,50682.36
"4129","Purchases  (Cost of Goods)","Invoice","2018-05-18","71084","Cole Home Builders:Phase 1 - Lot 5","Tapestry (8/60 watt)  Faux Alabaster Glass","Accounts Receivable",75,NA,50757.36
"4130","Purchases  (Cost of Goods)","Invoice","2018-05-18","71084","Cole Home Builders:Phase 1 - Lot 5","Chestnut (3/60 watt)  Marble Glass","Accounts Receivable",97.2,NA,50854.56
"4131","Purchases  (Cost of Goods)","Invoice","2018-05-18","71084","Cole Home Builders:Phase 1 - Lot 5","Tiffany Collection,Golden Baroque, 1-light lantern, medium base (100 watt max)","Accounts Receivable",96,NA,50950.56
"4132","Purchases  (Cost of Goods)","Invoice","2018-05-18","71084","Cole Home Builders:Phase 1 - Lot 5","2032 Series, (3-60 watt, Med) Desert Stone Finish","Accounts Receivable",36,NA,50986.56
"4133","Purchases  (Cost of Goods)","Invoice","2018-05-18","71084","Cole Home Builders:Phase 1 - Lot 5","Tapestry, (2-60 watt Med), Etched Cracked Glass, Finish 10","Accounts Receivable",30,NA,51016.56
"4134","Purchases  (Cost of Goods)","Invoice","2018-05-18","71084","Cole Home Builders:Phase 1 - Lot 5","18x8x10, Solid Brass, 3-60watt Medium Base, Satin Etched Glass","Accounts Receivable",65.19,NA,51081.75
"4135","Purchases  (Cost of Goods)","Invoice","2018-05-18","71084","Cole Home Builders:Phase 1 - Lot 5","White, 4.5x7.5, 1-100 watt Medium Base, Satin White Glass","Accounts Receivable",45,NA,51126.75
"4136","Purchases  (Cost of Goods)","Invoice","2018-05-18","71084","Cole Home Builders:Phase 1 - Lot 5","Drop Opal w/Solid Oak Frame, 49 1/2 x 17, 120v HPF","Accounts Receivable",64.33,NA,51191.08
"4137","Purchases  (Cost of Goods)","Invoice","2018-05-18","71084","Cole Home Builders:Phase 1 - Lot 5","Verona Collection, Pendant, Cobblestone, Etched Alabaster Glass, 150 watt max","Accounts Receivable",70,NA,51261.08
"4138","Purchases  (Cost of Goods)","Invoice","2018-05-18","71084","Cole Home Builders:Phase 1 - Lot 5","Fluorescent Lamp, T-12, Medium Bipin  (30pack)","Accounts Receivable",6.34,NA,51267.42
"4139","Purchases  (Cost of Goods)","Invoice","2018-05-18","71084","Cole Home Builders:Phase 1 - Lot 5","Specialty Bulbs, 100 watt (6 pack)","Accounts Receivable",23.75,NA,51291.17
"4140","Purchases  (Cost of Goods)","Invoice","2018-05-18","71084","Cole Home Builders:Phase 1 - Lot 5","Specialty, Stage & Studio Bulbs  60 watt","Accounts Receivable",15,NA,51306.17
"4141","Purchases  (Cost of Goods)","Invoice","2018-05-19","71063","Godwin Lighting Depot:Store #404","Black Finish, Solid Brass, Clear Glass, Hanging, 2-60 watt max.","Accounts Receivable",57.66,NA,51363.83
"4142","Purchases  (Cost of Goods)","Invoice","2018-05-19","71063","Godwin Lighting Depot:Store #404","Black Finish, Solid Brass,Wall Mount w/Clear Glass (2x60watt max)","Accounts Receivable",200,NA,51563.83
"4143","Purchases  (Cost of Goods)","Invoice","2018-05-19","71063","Godwin Lighting Depot:Store #404","Tapestry (8/60 watt)  Faux Alabaster Glass","Accounts Receivable",150,NA,51713.83
"4144","Purchases  (Cost of Goods)","Invoice","2018-05-19","71063","Godwin Lighting Depot:Store #404","Athena Collection, (100 watt max) Copper Verde, Seeded Glass","Accounts Receivable",160.71,NA,51874.54
"4145","Purchases  (Cost of Goods)","Invoice","2018-05-19","71063","Godwin Lighting Depot:Store #404","Broadway Collection, Polished Chrome, 4 Light (60 watt max)","Accounts Receivable",126,NA,52000.54
"4146","Purchases  (Cost of Goods)","Invoice","2018-05-19","71063","Godwin Lighting Depot:Store #404","Halogen Lamp, Volts:3.5  Tubular","Accounts Receivable",5,NA,52005.54
"4147","Purchases  (Cost of Goods)","Invoice","2018-05-19","71063","Godwin Lighting Depot:Store #404","Specialty Bulbs, 100 watt (6 pack)","Accounts Receivable",9.5,NA,52015.04
"4148","Purchases  (Cost of Goods)","Invoice","2018-05-19","71063","Godwin Lighting Depot:Store #404","Specialty, Stage & Studio Bulbs  60 watt","Accounts Receivable",17.5,NA,52032.54
"4149","Purchases  (Cost of Goods)","Invoice","2018-05-19","71063","Godwin Lighting Depot:Store #404","Fluorescent Lamp, T-12, Medium Bipin  (30pack)","Accounts Receivable",6.34,NA,52038.88
"4150","Purchases  (Cost of Goods)","Invoice","2018-05-19","71063","Godwin Lighting Depot:Store #404","Domes, White, 59x21x6 5/8 ht, 120v HPF","Accounts Receivable",38,NA,52076.88
"4151","Purchases  (Cost of Goods)","Invoice","2018-05-22","71127","Kern Lighting Warehouse:Store #34","Domes, White, 59x21x6 5/8 ht, 120v HPF","Accounts Receivable",2850,NA,54926.88
"4152","Purchases  (Cost of Goods)","Invoice","2018-05-22","71127","Kern Lighting Warehouse:Store #34","Flush Mount, Polished Brass (2, 13 watt)  White acrylic diffuser","Accounts Receivable",915.94,NA,55842.82
"4153","Purchases  (Cost of Goods)","Invoice","2018-05-22","71127","Kern Lighting Warehouse:Store #34","Tiffany Collection,Golden Baroque, 1-light lantern, medium base (100 watt max)","Accounts Receivable",144,NA,55986.82
"4154","Purchases  (Cost of Goods)","Invoice","2018-05-24","71086","Cole Home Builders:Phase 1 - Lot 4","Die Cast Lanterns, Black, 1-100 watt, Medium Base, Clear Cracked Glass","Accounts Receivable",231.19,NA,56218.01
"4155","Purchases  (Cost of Goods)","Invoice","2018-05-24","71086","Cole Home Builders:Phase 1 - Lot 4","Tapestry, (2-60 watt Med), Etched Cracked Glass, Finish 10","Accounts Receivable",90,NA,56308.01
"4156","Purchases  (Cost of Goods)","Invoice","2018-05-24","71086","Cole Home Builders:Phase 1 - Lot 4","Pearl Nickle, 5 Light, Medium Base (100 watt max)","Accounts Receivable",160,NA,56468.01
"4157","Purchases  (Cost of Goods)","Invoice","2018-05-24","71086","Cole Home Builders:Phase 1 - Lot 4","Sunset, Clear Glass, 1-100 watt max.","Accounts Receivable",70,NA,56538.01
"4158","Purchases  (Cost of Goods)","Invoice","2018-05-24","71086","Cole Home Builders:Phase 1 - Lot 4","Black Finish, Solid Brass, Clear Glass, Hanging, 2-60 watt max.","Accounts Receivable",57.66,NA,56595.67
"4159","Purchases  (Cost of Goods)","Invoice","2018-05-24","71086","Cole Home Builders:Phase 1 - Lot 4","Burnished Brass (60 watt)  w/Golden Umber Accents","Accounts Receivable",75,NA,56670.67
"4160","Purchases  (Cost of Goods)","Invoice","2018-05-24","71086","Cole Home Builders:Phase 1 - Lot 4","Chestnut (3/60 watt)  Marble Glass","Accounts Receivable",97.2,NA,56767.87
"4161","Purchases  (Cost of Goods)","Invoice","2018-05-24","71086","Cole Home Builders:Phase 1 - Lot 4","Pendant Bar, Textured White, 50lbs max","Accounts Receivable",10.77,NA,56778.64
"4162","Purchases  (Cost of Goods)","Invoice","2018-05-24","71086","Cole Home Builders:Phase 1 - Lot 4","Athena Collection, (100 watt max) Copper Verde, Seeded Glass","Accounts Receivable",32.14,NA,56810.78
"4163","Purchases  (Cost of Goods)","Invoice","2018-05-24","71086","Cole Home Builders:Phase 1 - Lot 4","Cand. Light, 20 watts (8 pack)","Accounts Receivable",24,NA,56834.78
"4164","Purchases  (Cost of Goods)","Invoice","2018-05-24","71086","Cole Home Builders:Phase 1 - Lot 4","Fluorescent Lamp, T-12, Medium Bipin  (30pack)","Accounts Receivable",6.34,NA,56841.12
"4165","Purchases  (Cost of Goods)","Invoice","2018-05-24","71086","Cole Home Builders:Phase 1 - Lot 4","Fluorescent Lamp, T-5, Bipin","Accounts Receivable",6,NA,56847.12
"4166","Purchases  (Cost of Goods)","Invoice","2018-05-24","71086","Cole Home Builders:Phase 1 - Lot 4","Halogen Lamp, Volts:3.5  Tubular","Accounts Receivable",2.5,NA,56849.62
"4167","Purchases  (Cost of Goods)","Invoice","2018-05-24","71086","Cole Home Builders:Phase 1 - Lot 4","Specialty Bulbs, 100 watt (6 pack)","Accounts Receivable",9.5,NA,56859.12
"4168","Purchases  (Cost of Goods)","Invoice","2018-05-24","71086","Cole Home Builders:Phase 1 - Lot 4","Specialty, Stage & Studio Bulbs  60 watt","Accounts Receivable",20,NA,56879.12
"4169","Purchases  (Cost of Goods)","Invoice","2018-05-24","71086","Cole Home Builders:Phase 1 - Lot 4","Flat Glass, (25 watt max) Polished Brass, 4 light","Accounts Receivable",48.49,NA,56927.61
"4170","Purchases  (Cost of Goods)","Invoice","2018-05-24","71086","Cole Home Builders:Phase 1 - Lot 4","Beveled Mirror, Etched Ribbed Glass (75 watt max)","Accounts Receivable",48.99,NA,56976.6
"4171","Purchases  (Cost of Goods)","Invoice","2018-05-30","71069","Godwin Lighting Depot:Store #1020","Vianne Lanterns, Satin Antiqued Solid Brass, 3-light wall latern, Candelabra base (60 watt max)","Accounts Receivable",192.57,NA,57169.17
"4172","Purchases  (Cost of Goods)","Invoice","2018-05-30","71069","Godwin Lighting Depot:Store #1020","Renaissance Collection, (100 watt max) Millstone Finish, One-light","Accounts Receivable",131.82,NA,57300.99
"4173","Purchases  (Cost of Goods)","Invoice","2018-05-30","71069","Godwin Lighting Depot:Store #1020","Drop Opal w/Solid Oak Frame, 49 1/2 x 17, 120v HPF","Accounts Receivable",42.88,NA,57343.87
"4174","Purchases  (Cost of Goods)","Invoice","2018-05-30","71069","Godwin Lighting Depot:Store #1020","Beveled Mirror, Etched Ribbed Glass (75 watt max)","Accounts Receivable",73.49,NA,57417.36
"4175","Purchases  (Cost of Goods)","Invoice","2018-05-30","71069","Godwin Lighting Depot:Store #1020","Chestnut (3/60 watt)  Marble Glass","Accounts Receivable",194.4,NA,57611.76
"4176","Purchases  (Cost of Goods)","Invoice","2018-05-30","71069","Godwin Lighting Depot:Store #1020","2032 Series, (3-60 watt, Med) Desert Stone Finish","Accounts Receivable",60,NA,57671.76
"4177","Purchases  (Cost of Goods)","Invoice","2018-05-30","71069","Godwin Lighting Depot:Store #1020","Pearl Nickle, 5 Light, Medium Base (100 watt max)","Accounts Receivable",80,NA,57751.76
"4178","Purchases  (Cost of Goods)","Invoice","2018-05-30","71069","Godwin Lighting Depot:Store #1020","Verona Collection, Pendant, Cobblestone, Etched Alabaster Glass, 150 watt max","Accounts Receivable",280,NA,58031.76
"4179","Purchases  (Cost of Goods)","Invoice","2018-05-30","71069","Godwin Lighting Depot:Store #1020","Pendant Bar, Cobblestone, 50lbs. max","Accounts Receivable",45.48,NA,58077.24
"4180","Purchases  (Cost of Goods)","Invoice","2018-05-30","71069","Godwin Lighting Depot:Store #1020","Cand. Light, 20 watts (8 pack)","Accounts Receivable",36,NA,58113.24
"4181","Purchases  (Cost of Goods)","Invoice","2018-05-30","71069","Godwin Lighting Depot:Store #1020","Fluorescent Lamp, T-12, Medium Bipin  (30pack)","Accounts Receivable",6.34,NA,58119.58
"4182","Purchases  (Cost of Goods)","Invoice","2018-05-30","71069","Godwin Lighting Depot:Store #1020","Halogen Lamp, 20 watts, Luminous Intensity","Accounts Receivable",24,NA,58143.58
"4183","Purchases  (Cost of Goods)","Invoice","2018-05-30","71069","Godwin Lighting Depot:Store #1020","Specialty Bulbs, 100 watt (6 pack)","Accounts Receivable",9.5,NA,58153.08
"4184","Purchases  (Cost of Goods)","Invoice","2018-05-30","71069","Godwin Lighting Depot:Store #1020","Specialty, Stage & Studio Bulbs  60 watt","Accounts Receivable",22.5,NA,58175.58
"4185","Purchases  (Cost of Goods)","Invoice","2018-05-31","71083","Cole Home Builders:Phase 2 - Lot 5","Acid Verde, 10x21x10, 2-60 watt cand.","Accounts Receivable",60,NA,58235.58
"4186","Purchases  (Cost of Goods)","Invoice","2018-05-31","71083","Cole Home Builders:Phase 2 - Lot 5","Sunset, Clear Glass, 1-100 watt max.","Accounts Receivable",52.5,NA,58288.08
"4187","Purchases  (Cost of Goods)","Invoice","2018-05-31","71083","Cole Home Builders:Phase 2 - Lot 5","Tapestry (8/60 watt)  Faux Alabaster Glass","Accounts Receivable",75,NA,58363.08
"4188","Purchases  (Cost of Goods)","Invoice","2018-05-31","71083","Cole Home Builders:Phase 2 - Lot 5","Chestnut (3/60 watt)  Marble Glass","Accounts Receivable",97.2,NA,58460.28
"4189","Purchases  (Cost of Goods)","Invoice","2018-05-31","71083","Cole Home Builders:Phase 2 - Lot 5","Tiffany Collection,Golden Baroque, 1-light lantern, medium base (100 watt max)","Accounts Receivable",96,NA,58556.28
"4190","Purchases  (Cost of Goods)","Invoice","2018-05-31","71083","Cole Home Builders:Phase 2 - Lot 5","2032 Series, (3-60 watt, Med) Desert Stone Finish","Accounts Receivable",36,NA,58592.28
"4191","Purchases  (Cost of Goods)","Invoice","2018-05-31","71083","Cole Home Builders:Phase 2 - Lot 5","Tapestry, (2-60 watt Med), Etched Cracked Glass, Finish 10","Accounts Receivable",30,NA,58622.28
"4192","Purchases  (Cost of Goods)","Invoice","2018-05-31","71083","Cole Home Builders:Phase 2 - Lot 5","18x8x10, Solid Brass, 3-60watt Medium Base, Satin Etched Glass","Accounts Receivable",65.19,NA,58687.47
"4193","Purchases  (Cost of Goods)","Invoice","2018-05-31","71083","Cole Home Builders:Phase 2 - Lot 5","White, 4.5x7.5, 1-100 watt Medium Base, Satin White Glass","Accounts Receivable",45,NA,58732.47
"4194","Purchases  (Cost of Goods)","Invoice","2018-05-31","71083","Cole Home Builders:Phase 2 - Lot 5","Drop Opal w/Solid Oak Frame, 49 1/2 x 17, 120v HPF","Accounts Receivable",64.33,NA,58796.8
"4195","Purchases  (Cost of Goods)","Invoice","2018-05-31","71083","Cole Home Builders:Phase 2 - Lot 5","Verona Collection, Pendant, Cobblestone, Etched Alabaster Glass, 150 watt max","Accounts Receivable",70,NA,58866.8
"4196","Purchases  (Cost of Goods)","Invoice","2018-05-31","71083","Cole Home Builders:Phase 2 - Lot 5","Fluorescent Lamp, T-12, Medium Bipin  (30pack)","Accounts Receivable",6.34,NA,58873.14
"4197","Purchases  (Cost of Goods)","Invoice","2018-05-31","71083","Cole Home Builders:Phase 2 - Lot 5","Specialty Bulbs, 100 watt (6 pack)","Accounts Receivable",23.75,NA,58896.89
"4198","Purchases  (Cost of Goods)","Invoice","2018-05-31","71083","Cole Home Builders:Phase 2 - Lot 5","Specialty, Stage & Studio Bulbs  60 watt","Accounts Receivable",15,NA,58911.89
"4199","Purchases  (Cost of Goods)","Invoice","2018-06-05","71096","Miscellaneous - Retail:Anne Loomis","Die Cast Lanterns, Black, 1-100 watt, Medium Base, Clear Cracked Glass","Accounts Receivable",385.32,NA,59297.21
"4200","Purchases  (Cost of Goods)","Invoice","2018-06-05","71096","Miscellaneous - Retail:Anne Loomis","Brushed Nickel, Pendant, 1-100 watt Medium Base, Satin Etched Glass","Accounts Receivable",250,NA,59547.21
"4201","Purchases  (Cost of Goods)","Invoice","2018-06-05","71096","Miscellaneous - Retail:Anne Loomis","Colonial, Brushed Steel Finish, Opal White Glass (60 watt)","Accounts Receivable",40,NA,59587.21
"4202","Purchases  (Cost of Goods)","Invoice","2018-06-05","71096","Miscellaneous - Retail:Anne Loomis","Solid Brass, 4-light, 25x13x10.75, 4-60 watt, Medium Base, Satin Etched Glass","Accounts Receivable",76,NA,59663.21
"4203","Purchases  (Cost of Goods)","Invoice","2018-06-05","71096","Miscellaneous - Retail:Anne Loomis","Drop Opal w/Solid Oak Frame, 49 1/2 x 17, 120v HPF","Accounts Receivable",64.33,NA,59727.54
"4204","Purchases  (Cost of Goods)","Invoice","2018-06-07","71085","Cole Home Builders:Phase 1 - Lot 5","Die Cast Lanterns, Black, 1-100 watt, Medium Base, Clear Cracked Glass","Accounts Receivable",231.19,NA,59958.73
"4205","Purchases  (Cost of Goods)","Invoice","2018-06-07","71085","Cole Home Builders:Phase 1 - Lot 5","Tapestry, (2-60 watt Med), Etched Cracked Glass, Finish 10","Accounts Receivable",90,NA,60048.73
"4206","Purchases  (Cost of Goods)","Invoice","2018-06-07","71085","Cole Home Builders:Phase 1 - Lot 5","Pearl Nickle, 5 Light, Medium Base (100 watt max)","Accounts Receivable",160,NA,60208.73
"4207","Purchases  (Cost of Goods)","Invoice","2018-06-07","71085","Cole Home Builders:Phase 1 - Lot 5","Sunset, Clear Glass, 1-100 watt max.","Accounts Receivable",70,NA,60278.73
"4208","Purchases  (Cost of Goods)","Invoice","2018-06-07","71085","Cole Home Builders:Phase 1 - Lot 5","Black Finish, Solid Brass, Clear Glass, Hanging, 2-60 watt max.","Accounts Receivable",57.66,NA,60336.39
"4209","Purchases  (Cost of Goods)","Invoice","2018-06-07","71085","Cole Home Builders:Phase 1 - Lot 5","Burnished Brass (60 watt)  w/Golden Umber Accents","Accounts Receivable",75,NA,60411.39
"4210","Purchases  (Cost of Goods)","Invoice","2018-06-07","71085","Cole Home Builders:Phase 1 - Lot 5","Chestnut (3/60 watt)  Marble Glass","Accounts Receivable",97.2,NA,60508.59
"4211","Purchases  (Cost of Goods)","Invoice","2018-06-07","71085","Cole Home Builders:Phase 1 - Lot 5","Pendant Bar, Textured White, 50lbs max","Accounts Receivable",10.77,NA,60519.36
"4212","Purchases  (Cost of Goods)","Invoice","2018-06-07","71085","Cole Home Builders:Phase 1 - Lot 5","Athena Collection, (100 watt max) Copper Verde, Seeded Glass","Accounts Receivable",32.14,NA,60551.5
"4213","Purchases  (Cost of Goods)","Invoice","2018-06-07","71085","Cole Home Builders:Phase 1 - Lot 5","Cand. Light, 20 watts (8 pack)","Accounts Receivable",24,NA,60575.5
"4214","Purchases  (Cost of Goods)","Invoice","2018-06-07","71085","Cole Home Builders:Phase 1 - Lot 5","Fluorescent Lamp, T-12, Medium Bipin  (30pack)","Accounts Receivable",6.34,NA,60581.84
"4215","Purchases  (Cost of Goods)","Invoice","2018-06-07","71085","Cole Home Builders:Phase 1 - Lot 5","Fluorescent Lamp, T-5, Bipin","Accounts Receivable",6,NA,60587.84
"4216","Purchases  (Cost of Goods)","Invoice","2018-06-07","71085","Cole Home Builders:Phase 1 - Lot 5","Halogen Lamp, Volts:3.5  Tubular","Accounts Receivable",2.5,NA,60590.34
"4217","Purchases  (Cost of Goods)","Invoice","2018-06-07","71085","Cole Home Builders:Phase 1 - Lot 5","Specialty Bulbs, 100 watt (6 pack)","Accounts Receivable",9.5,NA,60599.84
"4218","Purchases  (Cost of Goods)","Invoice","2018-06-07","71085","Cole Home Builders:Phase 1 - Lot 5","Specialty, Stage & Studio Bulbs  60 watt","Accounts Receivable",20,NA,60619.84
"4219","Purchases  (Cost of Goods)","Invoice","2018-06-07","71085","Cole Home Builders:Phase 1 - Lot 5","Flat Glass, (25 watt max) Polished Brass, 4 light","Accounts Receivable",48.49,NA,60668.33
"4220","Purchases  (Cost of Goods)","Invoice","2018-06-07","71085","Cole Home Builders:Phase 1 - Lot 5","Beveled Mirror, Etched Ribbed Glass (75 watt max)","Accounts Receivable",48.99,NA,60717.32
"4221","Purchases  (Cost of Goods)","Bill","2018-06-07","45674","Paulsen's Lighting","In bound shipments","Accounts Payable",125,NA,60842.32
"4222","Purchases  (Cost of Goods)","Invoice","2018-06-10","71128","Kern Lighting Warehouse:Store #45","Fluorescent Lamp, T-12, Medium Bipin  (30pack)","Accounts Receivable",1902.88,NA,62745.2
"4223","Purchases  (Cost of Goods)","Invoice","2018-06-10","71128","Kern Lighting Warehouse:Store #45","Specialty, Stage & Studio Bulbs  60 watt","Accounts Receivable",375,NA,63120.2
"4224","Purchases  (Cost of Goods)","Invoice","2018-06-10","71128","Kern Lighting Warehouse:Store #45","Drop Opal w/Solid Oak Frame, 49 1/2 x 17, 120v HPF","Accounts Receivable",643.27,NA,63763.47
"4225","Purchases  (Cost of Goods)","Invoice","2018-06-10","71128","Kern Lighting Warehouse:Store #45","Sunset, Clear Glass, 1-100 watt max.","Accounts Receivable",700,NA,64463.47
"4226","Purchases  (Cost of Goods)","Invoice","2018-06-10","71128","Kern Lighting Warehouse:Store #45","Black Finish, Solid Brass, Clear Glass, Hanging, 2-60 watt max.","Accounts Receivable",961.04,NA,65424.51
"4227","Purchases  (Cost of Goods)","Invoice","2018-06-10","71128","Kern Lighting Warehouse:Store #45","Solid Brass, 4-light, 25x13x10.75, 4-60 watt, Medium Base, Satin Etched Glass","Accounts Receivable",380,NA,65804.51
"4228","Purchases  (Cost of Goods)","Invoice","2018-06-10","71128","Kern Lighting Warehouse:Store #45","Brushed Nickel, (3-60 watt, Med) Ribbed Glass","Accounts Receivable",240,NA,66044.51
"4229","Purchases  (Cost of Goods)","Invoice","2018-06-10","71128","Kern Lighting Warehouse:Store #45","Halogen Lamp, 20 watts, Luminous Intensity","Accounts Receivable",60,NA,66104.51
"4230","Purchases  (Cost of Goods)","Invoice","2018-06-10","71128","Kern Lighting Warehouse:Store #45","Halogen Lamp, Volts:3.5  Tubular","Accounts Receivable",25,NA,66129.51
"4231","Purchases  (Cost of Goods)","Invoice","2018-06-10","71128","Kern Lighting Warehouse:Store #45","Roman Bronze, 1-light Lantern, w/tail, (100 watt max)","Accounts Receivable",950,NA,67079.51
"4232","Purchases  (Cost of Goods)","Invoice","2018-06-11","71070","Godwin Lighting Depot:Store #303","Vianne Lanterns, Satin Antiqued Solid Brass, 3-light wall latern, Candelabra base (60 watt max)","Accounts Receivable",192.57,NA,67272.08
"4233","Purchases  (Cost of Goods)","Invoice","2018-06-11","71070","Godwin Lighting Depot:Store #303","Renaissance Collection, (100 watt max) Millstone Finish, One-light","Accounts Receivable",131.82,NA,67403.9
"4234","Purchases  (Cost of Goods)","Invoice","2018-06-11","71070","Godwin Lighting Depot:Store #303","Drop Opal w/Solid Oak Frame, 49 1/2 x 17, 120v HPF","Accounts Receivable",42.88,NA,67446.78
"4235","Purchases  (Cost of Goods)","Invoice","2018-06-11","71070","Godwin Lighting Depot:Store #303","Beveled Mirror, Etched Ribbed Glass (75 watt max)","Accounts Receivable",73.49,NA,67520.27
"4236","Purchases  (Cost of Goods)","Invoice","2018-06-11","71070","Godwin Lighting Depot:Store #303","Chestnut (3/60 watt)  Marble Glass","Accounts Receivable",194.4,NA,67714.67
"4237","Purchases  (Cost of Goods)","Invoice","2018-06-11","71070","Godwin Lighting Depot:Store #303","2032 Series, (3-60 watt, Med) Desert Stone Finish","Accounts Receivable",60,NA,67774.67
"4238","Purchases  (Cost of Goods)","Invoice","2018-06-11","71070","Godwin Lighting Depot:Store #303","Pearl Nickle, 5 Light, Medium Base (100 watt max)","Accounts Receivable",80,NA,67854.67
"4239","Purchases  (Cost of Goods)","Invoice","2018-06-11","71070","Godwin Lighting Depot:Store #303","Verona Collection, Pendant, Cobblestone, Etched Alabaster Glass, 150 watt max","Accounts Receivable",280,NA,68134.67
"4240","Purchases  (Cost of Goods)","Invoice","2018-06-11","71070","Godwin Lighting Depot:Store #303","Pendant Bar, Cobblestone, 50lbs. max","Accounts Receivable",45.48,NA,68180.15
"4241","Purchases  (Cost of Goods)","Invoice","2018-06-11","71070","Godwin Lighting Depot:Store #303","Cand. Light, 20 watts (8 pack)","Accounts Receivable",36,NA,68216.15
"4242","Purchases  (Cost of Goods)","Invoice","2018-06-11","71070","Godwin Lighting Depot:Store #303","Fluorescent Lamp, T-12, Medium Bipin  (30pack)","Accounts Receivable",6.34,NA,68222.49
"4243","Purchases  (Cost of Goods)","Invoice","2018-06-11","71070","Godwin Lighting Depot:Store #303","Halogen Lamp, 20 watts, Luminous Intensity","Accounts Receivable",24,NA,68246.49
"4244","Purchases  (Cost of Goods)","Invoice","2018-06-11","71070","Godwin Lighting Depot:Store #303","Specialty Bulbs, 100 watt (6 pack)","Accounts Receivable",9.5,NA,68255.99
"4245","Purchases  (Cost of Goods)","Invoice","2018-06-11","71070","Godwin Lighting Depot:Store #303","Specialty, Stage & Studio Bulbs  60 watt","Accounts Receivable",22.5,NA,68278.49
"4246","Purchases  (Cost of Goods)","Invoice","2018-06-12","71080","Cole Home Builders:Phase 1 - Lot 5","BrassGuard Lanterns, Polished Brass, 1-light Wall, (100 watt max)","Accounts Receivable",140,NA,68418.49
"4247","Purchases  (Cost of Goods)","Invoice","2018-06-12","71080","Cole Home Builders:Phase 1 - Lot 5","Die Cast Lanterns, Black, 1-100 watt, Medium Base, Clear Cracked Glass","Accounts Receivable",77.06,NA,68495.55
"4248","Purchases  (Cost of Goods)","Invoice","2018-06-12","71080","Cole Home Builders:Phase 1 - Lot 5","Sunset, Clear Glass, 1-100 watt max.","Accounts Receivable",35,NA,68530.55
"4249","Purchases  (Cost of Goods)","Invoice","2018-06-12","71080","Cole Home Builders:Phase 1 - Lot 5","Beveled Mirror, Etched Ribbed Glass (75 watt max)","Accounts Receivable",73.49,NA,68604.04
"4250","Purchases  (Cost of Goods)","Invoice","2018-06-12","71080","Cole Home Builders:Phase 1 - Lot 5","Broadway Collection, Polished Brass, 6 Light (60 watt max)","Accounts Receivable",60,NA,68664.04
"4251","Purchases  (Cost of Goods)","Invoice","2018-06-12","71080","Cole Home Builders:Phase 1 - Lot 5","Brushed Nickel, 18x7.75x6, 3-60 watt Medium Base, Satin Opal Glass","Accounts Receivable",37,NA,68701.04
"4252","Purchases  (Cost of Goods)","Invoice","2018-06-12","71080","Cole Home Builders:Phase 1 - Lot 5","Brushed Nickel, (3-60 watt, Med) Ribbed Glass","Accounts Receivable",60,NA,68761.04
"4253","Purchases  (Cost of Goods)","Invoice","2018-06-12","71080","Cole Home Builders:Phase 1 - Lot 5","Brushed Nickel, Pendant, 1-100 watt Medium Base, Satin Etched Glass","Accounts Receivable",100,NA,68861.04
"4254","Purchases  (Cost of Goods)","Invoice","2018-06-12","71080","Cole Home Builders:Phase 1 - Lot 5","Pendant Bar, Cobblestone, 50lbs. max","Accounts Receivable",11.37,NA,68872.41
"4255","Purchases  (Cost of Goods)","Invoice","2018-06-12","71080","Cole Home Builders:Phase 1 - Lot 5","Verona Collection, Pendant, Cobblestone, Etched Alabaster Glass, 150 watt max","Accounts Receivable",70,NA,68942.41
"4256","Purchases  (Cost of Goods)","Invoice","2018-06-12","71080","Cole Home Builders:Phase 1 - Lot 5","Chestnut (3/60 watt)  Marble Glass","Accounts Receivable",97.2,NA,69039.61
"4257","Purchases  (Cost of Goods)","Invoice","2018-06-12","71080","Cole Home Builders:Phase 1 - Lot 5","Frosted Taupe (3/60 watt)  Marble Glass  ","Accounts Receivable",89.21,NA,69128.82
"4258","Purchases  (Cost of Goods)","Invoice","2018-06-12","71080","Cole Home Builders:Phase 1 - Lot 5","Cand. Light, 20 watts (8 pack)","Accounts Receivable",36,NA,69164.82
"4259","Purchases  (Cost of Goods)","Invoice","2018-06-12","71080","Cole Home Builders:Phase 1 - Lot 5","Specialty Bulbs, 100 watt (6 pack)","Accounts Receivable",9.5,NA,69174.32
"4260","Purchases  (Cost of Goods)","Invoice","2018-06-12","71080","Cole Home Builders:Phase 1 - Lot 5","Specialty, Stage & Studio Bulbs  60 watt","Accounts Receivable",12.5,NA,69186.82
"4261","Purchases  (Cost of Goods)","Invoice","2018-06-12","71081","Cole Home Builders:Phase 2 - Lot 5","Acid Verde, 10x21x10, 2-60 watt cand.","Accounts Receivable",60,NA,69246.82
"4262","Purchases  (Cost of Goods)","Invoice","2018-06-12","71081","Cole Home Builders:Phase 2 - Lot 5","Sunset, Clear Glass, 1-100 watt max.","Accounts Receivable",52.5,NA,69299.32
"4263","Purchases  (Cost of Goods)","Invoice","2018-06-12","71081","Cole Home Builders:Phase 2 - Lot 5","Tapestry (8/60 watt)  Faux Alabaster Glass","Accounts Receivable",75,NA,69374.32
"4264","Purchases  (Cost of Goods)","Invoice","2018-06-12","71081","Cole Home Builders:Phase 2 - Lot 5","Chestnut (3/60 watt)  Marble Glass","Accounts Receivable",97.2,NA,69471.52
"4265","Purchases  (Cost of Goods)","Invoice","2018-06-12","71081","Cole Home Builders:Phase 2 - Lot 5","Tiffany Collection,Golden Baroque, 1-light lantern, medium base (100 watt max)","Accounts Receivable",96,NA,69567.52
"4266","Purchases  (Cost of Goods)","Invoice","2018-06-12","71081","Cole Home Builders:Phase 2 - Lot 5","2032 Series, (3-60 watt, Med) Desert Stone Finish","Accounts Receivable",36,NA,69603.52
"4267","Purchases  (Cost of Goods)","Invoice","2018-06-12","71081","Cole Home Builders:Phase 2 - Lot 5","Tapestry, (2-60 watt Med), Etched Cracked Glass, Finish 10","Accounts Receivable",30,NA,69633.52
"4268","Purchases  (Cost of Goods)","Invoice","2018-06-12","71081","Cole Home Builders:Phase 2 - Lot 5","18x8x10, Solid Brass, 3-60watt Medium Base, Satin Etched Glass","Accounts Receivable",65.19,NA,69698.71
"4269","Purchases  (Cost of Goods)","Invoice","2018-06-12","71081","Cole Home Builders:Phase 2 - Lot 5","White, 4.5x7.5, 1-100 watt Medium Base, Satin White Glass","Accounts Receivable",45,NA,69743.71
"4270","Purchases  (Cost of Goods)","Invoice","2018-06-12","71081","Cole Home Builders:Phase 2 - Lot 5","Drop Opal w/Solid Oak Frame, 49 1/2 x 17, 120v HPF","Accounts Receivable",64.33,NA,69808.04
"4271","Purchases  (Cost of Goods)","Invoice","2018-06-12","71081","Cole Home Builders:Phase 2 - Lot 5","Verona Collection, Pendant, Cobblestone, Etched Alabaster Glass, 150 watt max","Accounts Receivable",70,NA,69878.04
"4272","Purchases  (Cost of Goods)","Invoice","2018-06-12","71081","Cole Home Builders:Phase 2 - Lot 5","Fluorescent Lamp, T-12, Medium Bipin  (30pack)","Accounts Receivable",6.34,NA,69884.38
"4273","Purchases  (Cost of Goods)","Invoice","2018-06-12","71081","Cole Home Builders:Phase 2 - Lot 5","Specialty Bulbs, 100 watt (6 pack)","Accounts Receivable",23.75,NA,69908.13
"4274","Purchases  (Cost of Goods)","Invoice","2018-06-12","71081","Cole Home Builders:Phase 2 - Lot 5","Specialty, Stage & Studio Bulbs  60 watt","Accounts Receivable",15,NA,69923.13
"4275","Purchases  (Cost of Goods)","Invoice","2018-06-12","71114","Thompson Lighting Stores:Store #30","Acid Verde, 10x21x10, 2-60 watt cand.","Accounts Receivable",180,NA,70103.13
"4276","Purchases  (Cost of Goods)","Invoice","2018-06-12","71114","Thompson Lighting Stores:Store #30","Die Cast Lanterns, Black, 1-100 watt, Medium Base, Clear Cracked Glass","Accounts Receivable",154.13,NA,70257.26
"4277","Purchases  (Cost of Goods)","Invoice","2018-06-12","71114","Thompson Lighting Stores:Store #30","Polished Brass Pendant, 1-100 watt Medium Base, Clear Ribbed Glass","Accounts Receivable",128,NA,70385.26
"4278","Purchases  (Cost of Goods)","Invoice","2018-06-12","71114","Thompson Lighting Stores:Store #30","2032 Series, (3-60 watt, Med) Desert Stone Finish","Accounts Receivable",48,NA,70433.26
"4279","Purchases  (Cost of Goods)","Invoice","2018-06-12","71114","Thompson Lighting Stores:Store #30","Brushed Nickel, 18x7.75x6, 3-60 watt Medium Base, Satin Opal Glass","Accounts Receivable",74,NA,70507.26
"4280","Purchases  (Cost of Goods)","Invoice","2018-06-12","71114","Thompson Lighting Stores:Store #30","Tapestry (8/60 watt)  Faux Alabaster Glass","Accounts Receivable",75,NA,70582.26
"4281","Purchases  (Cost of Goods)","Invoice","2018-06-12","71114","Thompson Lighting Stores:Store #30","Frosted Taupe (3/60 watt)  Marble Glass  ","Accounts Receivable",89.21,NA,70671.47
"4282","Purchases  (Cost of Goods)","Invoice","2018-06-12","71114","Thompson Lighting Stores:Store #30","Roman Bronze, 1-light Lantern, w/tail, (100 watt max)","Accounts Receivable",152,NA,70823.47
"4283","Purchases  (Cost of Goods)","Invoice","2018-06-12","71114","Thompson Lighting Stores:Store #30","Domes, White, 59x21x6 5/8 ht, 120v HPF","Accounts Receivable",57,NA,70880.47
"4284","Purchases  (Cost of Goods)","Invoice","2018-06-12","71114","Thompson Lighting Stores:Store #30","Flat Glass, (25 watt max) Polished Brass, 4 light","Accounts Receivable",60.61,NA,70941.08
"4285","Purchases  (Cost of Goods)","Invoice","2018-06-12","71114","Thompson Lighting Stores:Store #30","Burnished Brass (60 watt)  w/Golden Umber Accents","Accounts Receivable",75,NA,71016.08
"4286","Purchases  (Cost of Goods)","Invoice","2018-06-12","71114","Thompson Lighting Stores:Store #30","Pearl Nickle, 5 Light, Medium Base (100 watt max)","Accounts Receivable",200,NA,71216.08
"4287","Purchases  (Cost of Goods)","Invoice","2018-06-15","71082","Cole Home Builders:Phase 1 - Lot 5","Acid Verde, 10x21x10, 2-60 watt cand.","Accounts Receivable",60,NA,71276.08
"4288","Purchases  (Cost of Goods)","Invoice","2018-06-15","71082","Cole Home Builders:Phase 1 - Lot 5","Sunset, Clear Glass, 1-100 watt max.","Accounts Receivable",52.5,NA,71328.58
"4289","Purchases  (Cost of Goods)","Invoice","2018-06-15","71082","Cole Home Builders:Phase 1 - Lot 5","Tapestry (8/60 watt)  Faux Alabaster Glass","Accounts Receivable",75,NA,71403.58
"4290","Purchases  (Cost of Goods)","Invoice","2018-06-15","71082","Cole Home Builders:Phase 1 - Lot 5","Chestnut (3/60 watt)  Marble Glass","Accounts Receivable",97.2,NA,71500.78
"4291","Purchases  (Cost of Goods)","Invoice","2018-06-15","71082","Cole Home Builders:Phase 1 - Lot 5","Tiffany Collection,Golden Baroque, 1-light lantern, medium base (100 watt max)","Accounts Receivable",96,NA,71596.78
"4292","Purchases  (Cost of Goods)","Invoice","2018-06-15","71082","Cole Home Builders:Phase 1 - Lot 5","2032 Series, (3-60 watt, Med) Desert Stone Finish","Accounts Receivable",36,NA,71632.78
"4293","Purchases  (Cost of Goods)","Invoice","2018-06-15","71082","Cole Home Builders:Phase 1 - Lot 5","Tapestry, (2-60 watt Med), Etched Cracked Glass, Finish 10","Accounts Receivable",30,NA,71662.78
"4294","Purchases  (Cost of Goods)","Invoice","2018-06-15","71082","Cole Home Builders:Phase 1 - Lot 5","18x8x10, Solid Brass, 3-60watt Medium Base, Satin Etched Glass","Accounts Receivable",65.19,NA,71727.97
"4295","Purchases  (Cost of Goods)","Invoice","2018-06-15","71082","Cole Home Builders:Phase 1 - Lot 5","White, 4.5x7.5, 1-100 watt Medium Base, Satin White Glass","Accounts Receivable",45,NA,71772.97
"4296","Purchases  (Cost of Goods)","Invoice","2018-06-15","71082","Cole Home Builders:Phase 1 - Lot 5","Drop Opal w/Solid Oak Frame, 49 1/2 x 17, 120v HPF","Accounts Receivable",64.33,NA,71837.3
"4297","Purchases  (Cost of Goods)","Invoice","2018-06-15","71082","Cole Home Builders:Phase 1 - Lot 5","Verona Collection, Pendant, Cobblestone, Etched Alabaster Glass, 150 watt max","Accounts Receivable",70,NA,71907.3
"4298","Purchases  (Cost of Goods)","Invoice","2018-06-15","71082","Cole Home Builders:Phase 1 - Lot 5","Fluorescent Lamp, T-12, Medium Bipin  (30pack)","Accounts Receivable",6.34,NA,71913.64
"4299","Purchases  (Cost of Goods)","Invoice","2018-06-15","71082","Cole Home Builders:Phase 1 - Lot 5","Specialty Bulbs, 100 watt (6 pack)","Accounts Receivable",23.75,NA,71937.39
"4300","Purchases  (Cost of Goods)","Invoice","2018-06-15","71082","Cole Home Builders:Phase 1 - Lot 5","Specialty, Stage & Studio Bulbs  60 watt","Accounts Receivable",15,NA,71952.39
"4301","Purchases  (Cost of Goods)","Invoice","2018-06-28","71116","Thompson Lighting Stores:Store #50","Acid Verde, 10x21x10, 2-60 watt cand.","Accounts Receivable",180,NA,72132.39
"4302","Purchases  (Cost of Goods)","Invoice","2018-06-28","71116","Thompson Lighting Stores:Store #50","Die Cast Lanterns, Black, 1-100 watt, Medium Base, Clear Cracked Glass","Accounts Receivable",154.13,NA,72286.52
"4303","Purchases  (Cost of Goods)","Invoice","2018-06-28","71116","Thompson Lighting Stores:Store #50","Polished Brass Pendant, 1-100 watt Medium Base, Clear Ribbed Glass","Accounts Receivable",128,NA,72414.52
"4304","Purchases  (Cost of Goods)","Invoice","2018-06-28","71116","Thompson Lighting Stores:Store #50","2032 Series, (3-60 watt, Med) Desert Stone Finish","Accounts Receivable",48,NA,72462.52
"4305","Purchases  (Cost of Goods)","Invoice","2018-06-28","71116","Thompson Lighting Stores:Store #50","Brushed Nickel, 18x7.75x6, 3-60 watt Medium Base, Satin Opal Glass","Accounts Receivable",74,NA,72536.52
"4306","Purchases  (Cost of Goods)","Invoice","2018-06-28","71116","Thompson Lighting Stores:Store #50","Tapestry (8/60 watt)  Faux Alabaster Glass","Accounts Receivable",75,NA,72611.52
"4307","Purchases  (Cost of Goods)","Invoice","2018-06-28","71116","Thompson Lighting Stores:Store #50","Frosted Taupe (3/60 watt)  Marble Glass  ","Accounts Receivable",89.21,NA,72700.73
"4308","Purchases  (Cost of Goods)","Invoice","2018-06-28","71116","Thompson Lighting Stores:Store #50","Roman Bronze, 1-light Lantern, w/tail, (100 watt max)","Accounts Receivable",152,NA,72852.73
"4309","Purchases  (Cost of Goods)","Invoice","2018-06-28","71116","Thompson Lighting Stores:Store #50","Domes, White, 59x21x6 5/8 ht, 120v HPF","Accounts Receivable",57,NA,72909.73
"4310","Purchases  (Cost of Goods)","Invoice","2018-06-28","71116","Thompson Lighting Stores:Store #50","Flat Glass, (25 watt max) Polished Brass, 4 light","Accounts Receivable",60.61,NA,72970.34
"4311","Purchases  (Cost of Goods)","Invoice","2018-06-28","71116","Thompson Lighting Stores:Store #50","Burnished Brass (60 watt)  w/Golden Umber Accents","Accounts Receivable",75,NA,73045.34
"4312","Purchases  (Cost of Goods)","Invoice","2018-06-28","71116","Thompson Lighting Stores:Store #50","Pearl Nickle, 5 Light, Medium Base (100 watt max)","Accounts Receivable",200,NA,73245.34
"4313","Purchases  (Cost of Goods)","Invoice","2018-07-05","71089","Cole Home Builders:Phase 1 - Lot 5","Acid Verde, 10x21x10, 2-60 watt cand.","Accounts Receivable",60,NA,73305.34
"4314","Purchases  (Cost of Goods)","Invoice","2018-07-05","71089","Cole Home Builders:Phase 1 - Lot 5","Sunset, Clear Glass, 1-100 watt max.","Accounts Receivable",52.5,NA,73357.84
"4315","Purchases  (Cost of Goods)","Invoice","2018-07-05","71089","Cole Home Builders:Phase 1 - Lot 5","Tapestry (8/60 watt)  Faux Alabaster Glass","Accounts Receivable",75,NA,73432.84
"4316","Purchases  (Cost of Goods)","Invoice","2018-07-05","71089","Cole Home Builders:Phase 1 - Lot 5","Chestnut (3/60 watt)  Marble Glass","Accounts Receivable",97.2,NA,73530.04
"4317","Purchases  (Cost of Goods)","Invoice","2018-07-05","71089","Cole Home Builders:Phase 1 - Lot 5","Tiffany Collection,Golden Baroque, 1-light lantern, medium base (100 watt max)","Accounts Receivable",96,NA,73626.04
"4318","Purchases  (Cost of Goods)","Invoice","2018-07-05","71089","Cole Home Builders:Phase 1 - Lot 5","2032 Series, (3-60 watt, Med) Desert Stone Finish","Accounts Receivable",36,NA,73662.04
"4319","Purchases  (Cost of Goods)","Invoice","2018-07-05","71089","Cole Home Builders:Phase 1 - Lot 5","Tapestry, (2-60 watt Med), Etched Cracked Glass, Finish 10","Accounts Receivable",30,NA,73692.04
"4320","Purchases  (Cost of Goods)","Invoice","2018-07-05","71089","Cole Home Builders:Phase 1 - Lot 5","18x8x10, Solid Brass, 3-60watt Medium Base, Satin Etched Glass","Accounts Receivable",65.19,NA,73757.23
"4321","Purchases  (Cost of Goods)","Invoice","2018-07-05","71089","Cole Home Builders:Phase 1 - Lot 5","White, 4.5x7.5, 1-100 watt Medium Base, Satin White Glass","Accounts Receivable",45,NA,73802.23
"4322","Purchases  (Cost of Goods)","Invoice","2018-07-05","71089","Cole Home Builders:Phase 1 - Lot 5","Drop Opal w/Solid Oak Frame, 49 1/2 x 17, 120v HPF","Accounts Receivable",64.33,NA,73866.56
"4323","Purchases  (Cost of Goods)","Invoice","2018-07-05","71089","Cole Home Builders:Phase 1 - Lot 5","Verona Collection, Pendant, Cobblestone, Etched Alabaster Glass, 150 watt max","Accounts Receivable",70,NA,73936.56
"4324","Purchases  (Cost of Goods)","Invoice","2018-07-05","71089","Cole Home Builders:Phase 1 - Lot 5","Fluorescent Lamp, T-12, Medium Bipin  (30pack)","Accounts Receivable",6.34,NA,73942.9
"4325","Purchases  (Cost of Goods)","Invoice","2018-07-05","71089","Cole Home Builders:Phase 1 - Lot 5","Specialty Bulbs, 100 watt (6 pack)","Accounts Receivable",23.75,NA,73966.65
"4326","Purchases  (Cost of Goods)","Invoice","2018-07-05","71089","Cole Home Builders:Phase 1 - Lot 5","Specialty, Stage & Studio Bulbs  60 watt","Accounts Receivable",15,NA,73981.65
"4327","Purchases  (Cost of Goods)","Invoice","2018-07-12","71079","Cole Home Builders:Phase 1 - Lot 5","BrassGuard Lanterns, Polished Brass, 1-light Wall, (100 watt max)","Accounts Receivable",140,NA,74121.65
"4328","Purchases  (Cost of Goods)","Invoice","2018-07-12","71079","Cole Home Builders:Phase 1 - Lot 5","Die Cast Lanterns, Black, 1-100 watt, Medium Base, Clear Cracked Glass","Accounts Receivable",77.06,NA,74198.71
"4329","Purchases  (Cost of Goods)","Invoice","2018-07-12","71079","Cole Home Builders:Phase 1 - Lot 5","Sunset, Clear Glass, 1-100 watt max.","Accounts Receivable",35,NA,74233.71
"4330","Purchases  (Cost of Goods)","Invoice","2018-07-12","71079","Cole Home Builders:Phase 1 - Lot 5","Beveled Mirror, Etched Ribbed Glass (75 watt max)","Accounts Receivable",73.49,NA,74307.2
"4331","Purchases  (Cost of Goods)","Invoice","2018-07-12","71079","Cole Home Builders:Phase 1 - Lot 5","Broadway Collection, Polished Brass, 6 Light (60 watt max)","Accounts Receivable",60,NA,74367.2
"4332","Purchases  (Cost of Goods)","Invoice","2018-07-12","71079","Cole Home Builders:Phase 1 - Lot 5","Brushed Nickel, 18x7.75x6, 3-60 watt Medium Base, Satin Opal Glass","Accounts Receivable",37,NA,74404.2
"4333","Purchases  (Cost of Goods)","Invoice","2018-07-12","71079","Cole Home Builders:Phase 1 - Lot 5","Brushed Nickel, (3-60 watt, Med) Ribbed Glass","Accounts Receivable",60,NA,74464.2
"4334","Purchases  (Cost of Goods)","Invoice","2018-07-12","71079","Cole Home Builders:Phase 1 - Lot 5","Brushed Nickel, Pendant, 1-100 watt Medium Base, Satin Etched Glass","Accounts Receivable",100,NA,74564.2
"4335","Purchases  (Cost of Goods)","Invoice","2018-07-12","71079","Cole Home Builders:Phase 1 - Lot 5","Pendant Bar, Cobblestone, 50lbs. max","Accounts Receivable",11.37,NA,74575.57
"4336","Purchases  (Cost of Goods)","Invoice","2018-07-12","71079","Cole Home Builders:Phase 1 - Lot 5","Verona Collection, Pendant, Cobblestone, Etched Alabaster Glass, 150 watt max","Accounts Receivable",70,NA,74645.57
"4337","Purchases  (Cost of Goods)","Invoice","2018-07-12","71079","Cole Home Builders:Phase 1 - Lot 5","Chestnut (3/60 watt)  Marble Glass","Accounts Receivable",97.2,NA,74742.77
"4338","Purchases  (Cost of Goods)","Invoice","2018-07-12","71079","Cole Home Builders:Phase 1 - Lot 5","Frosted Taupe (3/60 watt)  Marble Glass  ","Accounts Receivable",89.21,NA,74831.98
"4339","Purchases  (Cost of Goods)","Invoice","2018-07-12","71079","Cole Home Builders:Phase 1 - Lot 5","Cand. Light, 20 watts (8 pack)","Accounts Receivable",36,NA,74867.98
"4340","Purchases  (Cost of Goods)","Invoice","2018-07-12","71079","Cole Home Builders:Phase 1 - Lot 5","Specialty Bulbs, 100 watt (6 pack)","Accounts Receivable",9.5,NA,74877.48
"4341","Purchases  (Cost of Goods)","Invoice","2018-07-12","71079","Cole Home Builders:Phase 1 - Lot 5","Specialty, Stage & Studio Bulbs  60 watt","Accounts Receivable",12.5,NA,74889.98
"4342","Purchases  (Cost of Goods)","Invoice","2018-07-13","71119","Kern Lighting Warehouse:Store #01","Golden Umber (100 watt)  Six Light Chandelier","Accounts Receivable",850,NA,75739.98
"4343","Purchases  (Cost of Goods)","Invoice","2018-07-13","71119","Kern Lighting Warehouse:Store #01","Burnished Brass (60 watt)  w/Golden Umber Accents","Accounts Receivable",750,NA,76489.98
"4344","Purchases  (Cost of Goods)","Invoice","2018-07-16","71076","Cole Home Builders:Phase 1 - Lot 5","Golden Umber (100 watt)  Six Light Chandelier","Accounts Receivable",85,NA,76574.98
"4345","Purchases  (Cost of Goods)","Invoice","2018-07-16","71076","Cole Home Builders:Phase 1 - Lot 5","Tapestry (8/60 watt)  Faux Alabaster Glass","Accounts Receivable",75,NA,76649.98
"4346","Purchases  (Cost of Goods)","Invoice","2018-07-16","71076","Cole Home Builders:Phase 1 - Lot 5","Polished Brass Pendant, 1-100 watt Medium Base, Clear Ribbed Glass","Accounts Receivable",160,NA,76809.98
"4347","Purchases  (Cost of Goods)","Invoice","2018-07-16","71076","Cole Home Builders:Phase 1 - Lot 5","Tapestry, (2-60 watt Med), Etched Cracked Glass, Finish 10","Accounts Receivable",60,NA,76869.98
"4348","Purchases  (Cost of Goods)","Invoice","2018-07-16","71076","Cole Home Builders:Phase 1 - Lot 5","Verona Collection, Pendant, Cobblestone, Etched Alabaster Glass, 150 watt max","Accounts Receivable",140,NA,77009.98
"4349","Purchases  (Cost of Goods)","Invoice","2018-07-16","71076","Cole Home Builders:Phase 1 - Lot 5","Pendant Bar, Cobblestone, 50lbs. max","Accounts Receivable",22.74,NA,77032.72
"4350","Purchases  (Cost of Goods)","Invoice","2018-07-16","71076","Cole Home Builders:Phase 1 - Lot 5","Pearl Nickle, 5 Light, Medium Base (100 watt max)","Accounts Receivable",80,NA,77112.72
"4351","Purchases  (Cost of Goods)","Invoice","2018-07-16","71076","Cole Home Builders:Phase 1 - Lot 5","White, 4.5x7.5, 1-100 watt Medium Base, Satin White Glass","Accounts Receivable",30,NA,77142.72
"4352","Purchases  (Cost of Goods)","Invoice","2018-07-16","71076","Cole Home Builders:Phase 1 - Lot 5","Solid Brass, 4-light, 25x13x10.75, 4-60 watt, Medium Base, Satin Etched Glass","Accounts Receivable",19,NA,77161.72
"4353","Purchases  (Cost of Goods)","Invoice","2018-07-16","71076","Cole Home Builders:Phase 1 - Lot 5","Acid Verde, 10x21x10, 2-60 watt cand.","Accounts Receivable",60,NA,77221.72
"4354","Purchases  (Cost of Goods)","Invoice","2018-07-16","71076","Cole Home Builders:Phase 1 - Lot 5","BrassGuard Lanterns, Polished Brass, 1-light Wall, (100 watt max)","Accounts Receivable",105,NA,77326.72
"4355","Purchases  (Cost of Goods)","Invoice","2018-07-16","71076","Cole Home Builders:Phase 1 - Lot 5","Black Finish, Solid Brass, Clear Glass, Hanging, 2-60 watt max.","Accounts Receivable",38.44,NA,77365.16
"4356","Purchases  (Cost of Goods)","Invoice","2018-07-16","71076","Cole Home Builders:Phase 1 - Lot 5","Specialty, Stage & Studio Bulbs  60 watt","Accounts Receivable",15,NA,77380.16
"4357","Purchases  (Cost of Goods)","Invoice","2018-07-16","71076","Cole Home Builders:Phase 1 - Lot 5","Specialty Bulbs, 100 watt (6 pack)","Accounts Receivable",47.5,NA,77427.66
"4358","Purchases  (Cost of Goods)","Invoice","2018-07-16","71076","Cole Home Builders:Phase 1 - Lot 5","Cand. Light, 20 watts (8 pack)","Accounts Receivable",24,NA,77451.66
"4359","Purchases  (Cost of Goods)","Invoice","2018-07-16","71115","Thompson Lighting Stores:Store #40","Acid Verde, 10x21x10, 2-60 watt cand.","Accounts Receivable",180,NA,77631.66
"4360","Purchases  (Cost of Goods)","Invoice","2018-07-16","71115","Thompson Lighting Stores:Store #40","Die Cast Lanterns, Black, 1-100 watt, Medium Base, Clear Cracked Glass","Accounts Receivable",154.13,NA,77785.79
"4361","Purchases  (Cost of Goods)","Invoice","2018-07-16","71115","Thompson Lighting Stores:Store #40","Polished Brass Pendant, 1-100 watt Medium Base, Clear Ribbed Glass","Accounts Receivable",128,NA,77913.79
"4362","Purchases  (Cost of Goods)","Invoice","2018-07-16","71115","Thompson Lighting Stores:Store #40","2032 Series, (3-60 watt, Med) Desert Stone Finish","Accounts Receivable",48,NA,77961.79
"4363","Purchases  (Cost of Goods)","Invoice","2018-07-16","71115","Thompson Lighting Stores:Store #40","Brushed Nickel, 18x7.75x6, 3-60 watt Medium Base, Satin Opal Glass","Accounts Receivable",74,NA,78035.79
"4364","Purchases  (Cost of Goods)","Invoice","2018-07-16","71115","Thompson Lighting Stores:Store #40","Tapestry (8/60 watt)  Faux Alabaster Glass","Accounts Receivable",75,NA,78110.79
"4365","Purchases  (Cost of Goods)","Invoice","2018-07-16","71115","Thompson Lighting Stores:Store #40","Frosted Taupe (3/60 watt)  Marble Glass  ","Accounts Receivable",89.21,NA,78200
"4366","Purchases  (Cost of Goods)","Invoice","2018-07-16","71115","Thompson Lighting Stores:Store #40","Roman Bronze, 1-light Lantern, w/tail, (100 watt max)","Accounts Receivable",152,NA,78352
"4367","Purchases  (Cost of Goods)","Invoice","2018-07-16","71115","Thompson Lighting Stores:Store #40","Domes, White, 59x21x6 5/8 ht, 120v HPF","Accounts Receivable",57,NA,78409
"4368","Purchases  (Cost of Goods)","Invoice","2018-07-16","71115","Thompson Lighting Stores:Store #40","Flat Glass, (25 watt max) Polished Brass, 4 light","Accounts Receivable",60.61,NA,78469.61
"4369","Purchases  (Cost of Goods)","Invoice","2018-07-16","71115","Thompson Lighting Stores:Store #40","Burnished Brass (60 watt)  w/Golden Umber Accents","Accounts Receivable",75,NA,78544.61
"4370","Purchases  (Cost of Goods)","Invoice","2018-07-16","71115","Thompson Lighting Stores:Store #40","Pearl Nickle, 5 Light, Medium Base (100 watt max)","Accounts Receivable",200,NA,78744.61
"4371","Purchases  (Cost of Goods)","Invoice","2018-07-17","71129","Kern Lighting Warehouse:Store #01","Sunset, Clear Glass, 1-100 watt max.","Accounts Receivable",612.5,NA,79357.11
"4372","Purchases  (Cost of Goods)","Invoice","2018-07-17","71129","Kern Lighting Warehouse:Store #01","Beveled Mirror, Etched Ribbed Glass (75 watt max)","Accounts Receivable",489.94,NA,79847.05
"4373","Purchases  (Cost of Goods)","Invoice","2018-07-17","71129","Kern Lighting Warehouse:Store #01","Pendant Bar, Textured White, 50lbs max","Accounts Receivable",269.23,NA,80116.28
"4374","Purchases  (Cost of Goods)","Invoice","2018-07-17","71129","Kern Lighting Warehouse:Store #01","Drop Opal w/Solid Oak Frame, 49 1/2 x 17, 120v HPF","Accounts Receivable",321.63,NA,80437.91
"4375","Purchases  (Cost of Goods)","Invoice","2018-07-17","71129","Kern Lighting Warehouse:Store #01","Flat Glass, (25 watt max) Polished Brass, 4 light","Accounts Receivable",303.07,NA,80740.98
"4376","Purchases  (Cost of Goods)","Invoice","2018-07-17","71129","Kern Lighting Warehouse:Store #01","Verona Collection, Pendant, Cobblestone, Etched Alabaster Glass, 150 watt max","Accounts Receivable",1750,NA,82490.98
"4377","Purchases  (Cost of Goods)","Invoice","2018-07-17","71129","Kern Lighting Warehouse:Store #01","Athena Collection, Pendant, Textured White, Med. Base, 100 watt max.","Accounts Receivable",1500,NA,83990.98
"4378","Purchases  (Cost of Goods)","Invoice","2018-07-17","71129","Kern Lighting Warehouse:Store #01","Golden Umber (100 watt)  Six Light Chandelier","Accounts Receivable",2125,NA,86115.98
"4379","Purchases  (Cost of Goods)","Invoice","2018-07-24","71097","Miscellaneous - Retail:Sean Martin","Black Finish, Solid Brass,Wall Mount w/Clear Glass (2x60watt max)","Accounts Receivable",400,NA,86515.98
"4380","Purchases  (Cost of Goods)","Invoice","2018-07-24","71097","Miscellaneous - Retail:Sean Martin","Golden Umber (100 watt)  Six Light Chandelier","Accounts Receivable",170,NA,86685.98
"4381","Purchases  (Cost of Goods)","Invoice","2018-07-24","71097","Miscellaneous - Retail:Sean Martin","Brushed Nickel, 18x7.75x6, 3-60 watt Medium Base, Satin Opal Glass","Accounts Receivable",55.5,NA,86741.48
"4382","Purchases  (Cost of Goods)","Invoice","2018-07-24","71097","Miscellaneous - Retail:Sean Martin","Domes, White, 59x21x6 5/8 ht, 120v HPF","Accounts Receivable",19,NA,86760.48
"4383","Purchases  (Cost of Goods)","Invoice","2018-07-24","71097","Miscellaneous - Retail:Sean Martin","Drop Opal w/Solid Oak Frame, 49 1/2 x 17, 120v HPF","Accounts Receivable",21.44,NA,86781.92
"4384","Purchases  (Cost of Goods)","Invoice","2018-07-27","71078","Cole Home Builders:Phase 1 - Lot 5","BrassGuard Lanterns, Polished Brass, 1-light Wall, (100 watt max)","Accounts Receivable",140,NA,86921.92
"4385","Purchases  (Cost of Goods)","Invoice","2018-07-27","71078","Cole Home Builders:Phase 1 - Lot 5","Die Cast Lanterns, Black, 1-100 watt, Medium Base, Clear Cracked Glass","Accounts Receivable",77.06,NA,86998.98
"4386","Purchases  (Cost of Goods)","Invoice","2018-07-27","71078","Cole Home Builders:Phase 1 - Lot 5","Sunset, Clear Glass, 1-100 watt max.","Accounts Receivable",35,NA,87033.98
"4387","Purchases  (Cost of Goods)","Invoice","2018-07-27","71078","Cole Home Builders:Phase 1 - Lot 5","Beveled Mirror, Etched Ribbed Glass (75 watt max)","Accounts Receivable",73.49,NA,87107.47
"4388","Purchases  (Cost of Goods)","Invoice","2018-07-27","71078","Cole Home Builders:Phase 1 - Lot 5","Broadway Collection, Polished Brass, 6 Light (60 watt max)","Accounts Receivable",60,NA,87167.47
"4389","Purchases  (Cost of Goods)","Invoice","2018-07-27","71078","Cole Home Builders:Phase 1 - Lot 5","Brushed Nickel, 18x7.75x6, 3-60 watt Medium Base, Satin Opal Glass","Accounts Receivable",37,NA,87204.47
"4390","Purchases  (Cost of Goods)","Invoice","2018-07-27","71078","Cole Home Builders:Phase 1 - Lot 5","Brushed Nickel, (3-60 watt, Med) Ribbed Glass","Accounts Receivable",60,NA,87264.47
"4391","Purchases  (Cost of Goods)","Invoice","2018-07-27","71078","Cole Home Builders:Phase 1 - Lot 5","Brushed Nickel, Pendant, 1-100 watt Medium Base, Satin Etched Glass","Accounts Receivable",100,NA,87364.47
"4392","Purchases  (Cost of Goods)","Invoice","2018-07-27","71078","Cole Home Builders:Phase 1 - Lot 5","Pendant Bar, Cobblestone, 50lbs. max","Accounts Receivable",11.37,NA,87375.84
"4393","Purchases  (Cost of Goods)","Invoice","2018-07-27","71078","Cole Home Builders:Phase 1 - Lot 5","Verona Collection, Pendant, Cobblestone, Etched Alabaster Glass, 150 watt max","Accounts Receivable",70,NA,87445.84
"4394","Purchases  (Cost of Goods)","Invoice","2018-07-27","71078","Cole Home Builders:Phase 1 - Lot 5","Chestnut (3/60 watt)  Marble Glass","Accounts Receivable",97.2,NA,87543.04
"4395","Purchases  (Cost of Goods)","Invoice","2018-07-27","71078","Cole Home Builders:Phase 1 - Lot 5","Frosted Taupe (3/60 watt)  Marble Glass  ","Accounts Receivable",89.21,NA,87632.25
"4396","Purchases  (Cost of Goods)","Invoice","2018-07-27","71078","Cole Home Builders:Phase 1 - Lot 5","Cand. Light, 20 watts (8 pack)","Accounts Receivable",36,NA,87668.25
"4397","Purchases  (Cost of Goods)","Invoice","2018-07-27","71078","Cole Home Builders:Phase 1 - Lot 5","Specialty Bulbs, 100 watt (6 pack)","Accounts Receivable",9.5,NA,87677.75
"4398","Purchases  (Cost of Goods)","Invoice","2018-07-27","71078","Cole Home Builders:Phase 1 - Lot 5","Specialty, Stage & Studio Bulbs  60 watt","Accounts Receivable",12.5,NA,87690.25
"4399","Purchases  (Cost of Goods)","Invoice","2018-07-31","71077","Cole Home Builders:Phase 1 - Lot 5","BrassGuard Lanterns, Polished Brass, 1-light Wall, (100 watt max)","Accounts Receivable",140,NA,87830.25
"4400","Purchases  (Cost of Goods)","Invoice","2018-07-31","71077","Cole Home Builders:Phase 1 - Lot 5","Die Cast Lanterns, Black, 1-100 watt, Medium Base, Clear Cracked Glass","Accounts Receivable",77.06,NA,87907.31
"4401","Purchases  (Cost of Goods)","Invoice","2018-07-31","71077","Cole Home Builders:Phase 1 - Lot 5","Sunset, Clear Glass, 1-100 watt max.","Accounts Receivable",35,NA,87942.31
"4402","Purchases  (Cost of Goods)","Invoice","2018-07-31","71077","Cole Home Builders:Phase 1 - Lot 5","Beveled Mirror, Etched Ribbed Glass (75 watt max)","Accounts Receivable",73.49,NA,88015.8
"4403","Purchases  (Cost of Goods)","Invoice","2018-07-31","71077","Cole Home Builders:Phase 1 - Lot 5","Broadway Collection, Polished Brass, 6 Light (60 watt max)","Accounts Receivable",60,NA,88075.8
"4404","Purchases  (Cost of Goods)","Invoice","2018-07-31","71077","Cole Home Builders:Phase 1 - Lot 5","Brushed Nickel, 18x7.75x6, 3-60 watt Medium Base, Satin Opal Glass","Accounts Receivable",37,NA,88112.8
"4405","Purchases  (Cost of Goods)","Invoice","2018-07-31","71077","Cole Home Builders:Phase 1 - Lot 5","Brushed Nickel, (3-60 watt, Med) Ribbed Glass","Accounts Receivable",60,NA,88172.8
"4406","Purchases  (Cost of Goods)","Invoice","2018-07-31","71077","Cole Home Builders:Phase 1 - Lot 5","Brushed Nickel, Pendant, 1-100 watt Medium Base, Satin Etched Glass","Accounts Receivable",100,NA,88272.8
"4407","Purchases  (Cost of Goods)","Invoice","2018-07-31","71077","Cole Home Builders:Phase 1 - Lot 5","Pendant Bar, Cobblestone, 50lbs. max","Accounts Receivable",11.37,NA,88284.17
"4408","Purchases  (Cost of Goods)","Invoice","2018-07-31","71077","Cole Home Builders:Phase 1 - Lot 5","Verona Collection, Pendant, Cobblestone, Etched Alabaster Glass, 150 watt max","Accounts Receivable",70,NA,88354.17
"4409","Purchases  (Cost of Goods)","Invoice","2018-07-31","71077","Cole Home Builders:Phase 1 - Lot 5","Chestnut (3/60 watt)  Marble Glass","Accounts Receivable",97.2,NA,88451.37
"4410","Purchases  (Cost of Goods)","Invoice","2018-07-31","71077","Cole Home Builders:Phase 1 - Lot 5","Frosted Taupe (3/60 watt)  Marble Glass  ","Accounts Receivable",89.21,NA,88540.58
"4411","Purchases  (Cost of Goods)","Invoice","2018-07-31","71077","Cole Home Builders:Phase 1 - Lot 5","Cand. Light, 20 watts (8 pack)","Accounts Receivable",36,NA,88576.58
"4412","Purchases  (Cost of Goods)","Invoice","2018-07-31","71077","Cole Home Builders:Phase 1 - Lot 5","Specialty Bulbs, 100 watt (6 pack)","Accounts Receivable",9.5,NA,88586.08
"4413","Purchases  (Cost of Goods)","Invoice","2018-07-31","71077","Cole Home Builders:Phase 1 - Lot 5","Specialty, Stage & Studio Bulbs  60 watt","Accounts Receivable",12.5,NA,88598.58
"4414","Purchases  (Cost of Goods)","Bill","2018-08-01","34566","Foster Lighting","In bound shipments","Accounts Payable",95,NA,88693.58
"4415","Purchases  (Cost of Goods)","Invoice","2018-08-07","71098","Miscellaneous - Retail:Jann Minor","Acid Verde, 10x21x10, 2-60 watt cand.","Accounts Receivable",450,NA,89143.58
"4416","Purchases  (Cost of Goods)","Invoice","2018-08-07","71098","Miscellaneous - Retail:Jann Minor","Beveled Mirror, Etched Ribbed Glass (75 watt max)","Accounts Receivable",122.49,NA,89266.07
"4417","Purchases  (Cost of Goods)","Invoice","2018-08-07","71098","Miscellaneous - Retail:Jann Minor","Chestnut (3/60 watt)  Marble Glass","Accounts Receivable",291.6,NA,89557.67
"4418","Purchases  (Cost of Goods)","Invoice","2018-08-10","71090","Cole Home Builders:Phase 2 - Lot 5","BrassGuard Lanterns, Polished Brass, 1-light Wall, (100 watt max)","Accounts Receivable",140,NA,89697.67
"4419","Purchases  (Cost of Goods)","Invoice","2018-08-10","71090","Cole Home Builders:Phase 2 - Lot 5","Die Cast Lanterns, Black, 1-100 watt, Medium Base, Clear Cracked Glass","Accounts Receivable",77.06,NA,89774.73
"4420","Purchases  (Cost of Goods)","Invoice","2018-08-10","71090","Cole Home Builders:Phase 2 - Lot 5","Sunset, Clear Glass, 1-100 watt max.","Accounts Receivable",35,NA,89809.73
"4421","Purchases  (Cost of Goods)","Invoice","2018-08-10","71090","Cole Home Builders:Phase 2 - Lot 5","Beveled Mirror, Etched Ribbed Glass (75 watt max)","Accounts Receivable",73.49,NA,89883.22
"4422","Purchases  (Cost of Goods)","Invoice","2018-08-10","71090","Cole Home Builders:Phase 2 - Lot 5","Broadway Collection, Polished Brass, 6 Light (60 watt max)","Accounts Receivable",60,NA,89943.22
"4423","Purchases  (Cost of Goods)","Invoice","2018-08-10","71090","Cole Home Builders:Phase 2 - Lot 5","Brushed Nickel, 18x7.75x6, 3-60 watt Medium Base, Satin Opal Glass","Accounts Receivable",37,NA,89980.22
"4424","Purchases  (Cost of Goods)","Invoice","2018-08-10","71090","Cole Home Builders:Phase 2 - Lot 5","Brushed Nickel, (3-60 watt, Med) Ribbed Glass","Accounts Receivable",60,NA,90040.22
"4425","Purchases  (Cost of Goods)","Invoice","2018-08-10","71090","Cole Home Builders:Phase 2 - Lot 5","Brushed Nickel, Pendant, 1-100 watt Medium Base, Satin Etched Glass","Accounts Receivable",100,NA,90140.22
"4426","Purchases  (Cost of Goods)","Invoice","2018-08-10","71090","Cole Home Builders:Phase 2 - Lot 5","Pendant Bar, Cobblestone, 50lbs. max","Accounts Receivable",11.37,NA,90151.59
"4427","Purchases  (Cost of Goods)","Invoice","2018-08-10","71090","Cole Home Builders:Phase 2 - Lot 5","Verona Collection, Pendant, Cobblestone, Etched Alabaster Glass, 150 watt max","Accounts Receivable",70,NA,90221.59
"4428","Purchases  (Cost of Goods)","Invoice","2018-08-10","71090","Cole Home Builders:Phase 2 - Lot 5","Chestnut (3/60 watt)  Marble Glass","Accounts Receivable",97.2,NA,90318.79
"4429","Purchases  (Cost of Goods)","Invoice","2018-08-10","71090","Cole Home Builders:Phase 2 - Lot 5","Frosted Taupe (3/60 watt)  Marble Glass  ","Accounts Receivable",89.21,NA,90408
"4430","Purchases  (Cost of Goods)","Invoice","2018-08-10","71090","Cole Home Builders:Phase 2 - Lot 5","Cand. Light, 20 watts (8 pack)","Accounts Receivable",36,NA,90444
"4431","Purchases  (Cost of Goods)","Invoice","2018-08-10","71090","Cole Home Builders:Phase 2 - Lot 5","Specialty Bulbs, 100 watt (6 pack)","Accounts Receivable",9.5,NA,90453.5
"4432","Purchases  (Cost of Goods)","Invoice","2018-08-10","71090","Cole Home Builders:Phase 2 - Lot 5","Specialty, Stage & Studio Bulbs  60 watt","Accounts Receivable",12.5,NA,90466
"4433","Purchases  (Cost of Goods)","Invoice","2018-08-17","71075","Cole Home Builders:Phase 1 - Lot 5","Golden Umber (100 watt)  Six Light Chandelier","Accounts Receivable",85,NA,90551
"4434","Purchases  (Cost of Goods)","Invoice","2018-08-17","71075","Cole Home Builders:Phase 1 - Lot 5","Tapestry (8/60 watt)  Faux Alabaster Glass","Accounts Receivable",75,NA,90626
"4435","Purchases  (Cost of Goods)","Invoice","2018-08-17","71075","Cole Home Builders:Phase 1 - Lot 5","Polished Brass Pendant, 1-100 watt Medium Base, Clear Ribbed Glass","Accounts Receivable",160,NA,90786
"4436","Purchases  (Cost of Goods)","Invoice","2018-08-17","71075","Cole Home Builders:Phase 1 - Lot 5","Tapestry, (2-60 watt Med), Etched Cracked Glass, Finish 10","Accounts Receivable",60,NA,90846
"4437","Purchases  (Cost of Goods)","Invoice","2018-08-17","71075","Cole Home Builders:Phase 1 - Lot 5","Verona Collection, Pendant, Cobblestone, Etched Alabaster Glass, 150 watt max","Accounts Receivable",140,NA,90986
"4438","Purchases  (Cost of Goods)","Invoice","2018-08-17","71075","Cole Home Builders:Phase 1 - Lot 5","Pendant Bar, Cobblestone, 50lbs. max","Accounts Receivable",22.74,NA,91008.74
"4439","Purchases  (Cost of Goods)","Invoice","2018-08-17","71075","Cole Home Builders:Phase 1 - Lot 5","Pearl Nickle, 5 Light, Medium Base (100 watt max)","Accounts Receivable",80,NA,91088.74
"4440","Purchases  (Cost of Goods)","Invoice","2018-08-17","71075","Cole Home Builders:Phase 1 - Lot 5","White, 4.5x7.5, 1-100 watt Medium Base, Satin White Glass","Accounts Receivable",30,NA,91118.74
"4441","Purchases  (Cost of Goods)","Invoice","2018-08-17","71075","Cole Home Builders:Phase 1 - Lot 5","Solid Brass, 4-light, 25x13x10.75, 4-60 watt, Medium Base, Satin Etched Glass","Accounts Receivable",19,NA,91137.74
"4442","Purchases  (Cost of Goods)","Invoice","2018-08-17","71075","Cole Home Builders:Phase 1 - Lot 5","Acid Verde, 10x21x10, 2-60 watt cand.","Accounts Receivable",60,NA,91197.74
"4443","Purchases  (Cost of Goods)","Invoice","2018-08-17","71075","Cole Home Builders:Phase 1 - Lot 5","BrassGuard Lanterns, Polished Brass, 1-light Wall, (100 watt max)","Accounts Receivable",105,NA,91302.74
"4444","Purchases  (Cost of Goods)","Invoice","2018-08-17","71075","Cole Home Builders:Phase 1 - Lot 5","Black Finish, Solid Brass, Clear Glass, Hanging, 2-60 watt max.","Accounts Receivable",38.44,NA,91341.18
"4445","Purchases  (Cost of Goods)","Invoice","2018-08-17","71075","Cole Home Builders:Phase 1 - Lot 5","Specialty, Stage & Studio Bulbs  60 watt","Accounts Receivable",15,NA,91356.18
"4446","Purchases  (Cost of Goods)","Invoice","2018-08-17","71075","Cole Home Builders:Phase 1 - Lot 5","Specialty Bulbs, 100 watt (6 pack)","Accounts Receivable",47.5,NA,91403.68
"4447","Purchases  (Cost of Goods)","Invoice","2018-08-17","71075","Cole Home Builders:Phase 1 - Lot 5","Cand. Light, 20 watts (8 pack)","Accounts Receivable",24,NA,91427.68
"4448","Purchases  (Cost of Goods)","Invoice","2018-08-22","71109","Dan A. North Builders:Turner Suites","Tapestry, (2-60 watt Med), Etched Cracked Glass, Finish 10","Accounts Receivable",1500,NA,92927.68
"4449","Purchases  (Cost of Goods)","Invoice","2018-08-22","71109","Dan A. North Builders:Turner Suites","Vianne Lanterns, Satin Antiqued Solid Brass, 3-light wall latern, Candelabra base (60 watt max)","Accounts Receivable",2407.14,NA,95334.82
"4450","Purchases  (Cost of Goods)","Invoice","2018-08-22","71109","Dan A. North Builders:Turner Suites","Black Finish, Solid Brass, Clear Glass, Hanging, 2-60 watt max.","Accounts Receivable",1441.56,NA,96776.38
"4451","Purchases  (Cost of Goods)","Invoice","2018-08-22","71109","Dan A. North Builders:Turner Suites","Specialty, Stage & Studio Bulbs  60 watt","Accounts Receivable",250,NA,97026.38
"4452","Purchases  (Cost of Goods)","Invoice","2018-08-24","71074","Cole Home Builders:Phase 1 - Lot 5","Golden Umber (100 watt)  Six Light Chandelier","Accounts Receivable",85,NA,97111.38
"4453","Purchases  (Cost of Goods)","Invoice","2018-08-24","71074","Cole Home Builders:Phase 1 - Lot 5","Tapestry (8/60 watt)  Faux Alabaster Glass","Accounts Receivable",75,NA,97186.38
"4454","Purchases  (Cost of Goods)","Invoice","2018-08-24","71074","Cole Home Builders:Phase 1 - Lot 5","Polished Brass Pendant, 1-100 watt Medium Base, Clear Ribbed Glass","Accounts Receivable",160,NA,97346.38
"4455","Purchases  (Cost of Goods)","Invoice","2018-08-24","71074","Cole Home Builders:Phase 1 - Lot 5","Tapestry, (2-60 watt Med), Etched Cracked Glass, Finish 10","Accounts Receivable",60,NA,97406.38
"4456","Purchases  (Cost of Goods)","Invoice","2018-08-24","71074","Cole Home Builders:Phase 1 - Lot 5","Verona Collection, Pendant, Cobblestone, Etched Alabaster Glass, 150 watt max","Accounts Receivable",140,NA,97546.38
"4457","Purchases  (Cost of Goods)","Invoice","2018-08-24","71074","Cole Home Builders:Phase 1 - Lot 5","Pendant Bar, Cobblestone, 50lbs. max","Accounts Receivable",22.74,NA,97569.12
"4458","Purchases  (Cost of Goods)","Invoice","2018-08-24","71074","Cole Home Builders:Phase 1 - Lot 5","Pearl Nickle, 5 Light, Medium Base (100 watt max)","Accounts Receivable",80,NA,97649.12
"4459","Purchases  (Cost of Goods)","Invoice","2018-08-24","71074","Cole Home Builders:Phase 1 - Lot 5","White, 4.5x7.5, 1-100 watt Medium Base, Satin White Glass","Accounts Receivable",30,NA,97679.12
"4460","Purchases  (Cost of Goods)","Invoice","2018-08-24","71074","Cole Home Builders:Phase 1 - Lot 5","Solid Brass, 4-light, 25x13x10.75, 4-60 watt, Medium Base, Satin Etched Glass","Accounts Receivable",19,NA,97698.12
"4461","Purchases  (Cost of Goods)","Invoice","2018-08-24","71074","Cole Home Builders:Phase 1 - Lot 5","Acid Verde, 10x21x10, 2-60 watt cand.","Accounts Receivable",60,NA,97758.12
"4462","Purchases  (Cost of Goods)","Invoice","2018-08-24","71074","Cole Home Builders:Phase 1 - Lot 5","BrassGuard Lanterns, Polished Brass, 1-light Wall, (100 watt max)","Accounts Receivable",105,NA,97863.12
"4463","Purchases  (Cost of Goods)","Invoice","2018-08-24","71074","Cole Home Builders:Phase 1 - Lot 5","Black Finish, Solid Brass, Clear Glass, Hanging, 2-60 watt max.","Accounts Receivable",38.44,NA,97901.56
"4464","Purchases  (Cost of Goods)","Invoice","2018-08-24","71074","Cole Home Builders:Phase 1 - Lot 5","Specialty, Stage & Studio Bulbs  60 watt","Accounts Receivable",15,NA,97916.56
"4465","Purchases  (Cost of Goods)","Invoice","2018-08-24","71074","Cole Home Builders:Phase 1 - Lot 5","Specialty Bulbs, 100 watt (6 pack)","Accounts Receivable",47.5,NA,97964.06
"4466","Purchases  (Cost of Goods)","Invoice","2018-08-24","71074","Cole Home Builders:Phase 1 - Lot 5","Cand. Light, 20 watts (8 pack)","Accounts Receivable",24,NA,97988.06
"4467","Purchases  (Cost of Goods)","Invoice","2018-08-30","71130","Kern Lighting Warehouse:Store #45","Renaissance Collection, (100 watt max) Millstone Finish, One-light","Accounts Receivable",411.93,NA,98399.99
"4468","Purchases  (Cost of Goods)","Invoice","2018-08-30","71130","Kern Lighting Warehouse:Store #45","Pearl Nickle, 5 Light, Medium Base (100 watt max)","Accounts Receivable",1600,NA,99999.99
"4469","Purchases  (Cost of Goods)","Invoice","2018-08-30","71130","Kern Lighting Warehouse:Store #45","Specialty Bulbs, 100 watt (6 pack)","Accounts Receivable",118.75,NA,100118.74
"4470","Purchases  (Cost of Goods)","Invoice","2018-08-30","71130","Kern Lighting Warehouse:Store #45","Cand. Light, 20 watts (8 pack)","Accounts Receivable",1200,NA,101318.74
"4471","Purchases  (Cost of Goods)","Invoice","2018-08-31","71073","Cole Home Builders:Phase 1 - Lot 5","Golden Umber (100 watt)  Six Light Chandelier","Accounts Receivable",85,NA,101403.74
"4472","Purchases  (Cost of Goods)","Invoice","2018-08-31","71073","Cole Home Builders:Phase 1 - Lot 5","Tapestry (8/60 watt)  Faux Alabaster Glass","Accounts Receivable",75,NA,101478.74
"4473","Purchases  (Cost of Goods)","Invoice","2018-08-31","71073","Cole Home Builders:Phase 1 - Lot 5","Polished Brass Pendant, 1-100 watt Medium Base, Clear Ribbed Glass","Accounts Receivable",160,NA,101638.74
"4474","Purchases  (Cost of Goods)","Invoice","2018-08-31","71073","Cole Home Builders:Phase 1 - Lot 5","Tapestry, (2-60 watt Med), Etched Cracked Glass, Finish 10","Accounts Receivable",60,NA,101698.74
"4475","Purchases  (Cost of Goods)","Invoice","2018-08-31","71073","Cole Home Builders:Phase 1 - Lot 5","Verona Collection, Pendant, Cobblestone, Etched Alabaster Glass, 150 watt max","Accounts Receivable",140,NA,101838.74
"4476","Purchases  (Cost of Goods)","Invoice","2018-08-31","71073","Cole Home Builders:Phase 1 - Lot 5","Pendant Bar, Cobblestone, 50lbs. max","Accounts Receivable",22.74,NA,101861.48
"4477","Purchases  (Cost of Goods)","Invoice","2018-08-31","71073","Cole Home Builders:Phase 1 - Lot 5","Pearl Nickle, 5 Light, Medium Base (100 watt max)","Accounts Receivable",80,NA,101941.48
"4478","Purchases  (Cost of Goods)","Invoice","2018-08-31","71073","Cole Home Builders:Phase 1 - Lot 5","White, 4.5x7.5, 1-100 watt Medium Base, Satin White Glass","Accounts Receivable",30,NA,101971.48
"4479","Purchases  (Cost of Goods)","Invoice","2018-08-31","71073","Cole Home Builders:Phase 1 - Lot 5","Solid Brass, 4-light, 25x13x10.75, 4-60 watt, Medium Base, Satin Etched Glass","Accounts Receivable",19,NA,101990.48
"4480","Purchases  (Cost of Goods)","Invoice","2018-08-31","71073","Cole Home Builders:Phase 1 - Lot 5","Acid Verde, 10x21x10, 2-60 watt cand.","Accounts Receivable",60,NA,102050.48
"4481","Purchases  (Cost of Goods)","Invoice","2018-08-31","71073","Cole Home Builders:Phase 1 - Lot 5","BrassGuard Lanterns, Polished Brass, 1-light Wall, (100 watt max)","Accounts Receivable",105,NA,102155.48
"4482","Purchases  (Cost of Goods)","Invoice","2018-08-31","71073","Cole Home Builders:Phase 1 - Lot 5","Black Finish, Solid Brass, Clear Glass, Hanging, 2-60 watt max.","Accounts Receivable",38.44,NA,102193.92
"4483","Purchases  (Cost of Goods)","Invoice","2018-08-31","71073","Cole Home Builders:Phase 1 - Lot 5","Specialty, Stage & Studio Bulbs  60 watt","Accounts Receivable",15,NA,102208.92
"4484","Purchases  (Cost of Goods)","Invoice","2018-08-31","71073","Cole Home Builders:Phase 1 - Lot 5","Specialty Bulbs, 100 watt (6 pack)","Accounts Receivable",47.5,NA,102256.42
"4485","Purchases  (Cost of Goods)","Invoice","2018-08-31","71073","Cole Home Builders:Phase 1 - Lot 5","Cand. Light, 20 watts (8 pack)","Accounts Receivable",24,NA,102280.42
"4486","Purchases  (Cost of Goods)","Bill","2018-09-10","H8765","Paulsen's Lighting","Domes, White, 59x21x6 5/8 ht, 120v HPF","Accounts Payable",NA,69,102211.42
"4487","Purchases  (Cost of Goods)","Bill","2018-09-10","H8765","Paulsen's Lighting","In bound shipments","Accounts Payable",125,NA,102336.42
"4488","Purchases  (Cost of Goods)","Invoice","2018-09-11","71099","Miscellaneous - Retail:Jason Helper","Sunset, Clear Glass, 1-100 watt max.","Accounts Receivable",310.06,NA,102646.48
"4489","Purchases  (Cost of Goods)","Invoice","2018-09-11","71099","Miscellaneous - Retail:Jason Helper","Black Finish, Solid Brass, Clear Glass, Hanging, 2-60 watt max.","Accounts Receivable",38.44,NA,102684.92
"4490","Purchases  (Cost of Goods)","Invoice","2018-09-11","71099","Miscellaneous - Retail:Jason Helper","White, 4.5x7.5, 1-100 watt Medium Base, Satin White Glass","Accounts Receivable",60,NA,102744.92
"4491","Purchases  (Cost of Goods)","Invoice","2018-09-11","71099","Miscellaneous - Retail:Jason Helper","Golden Umber (100 watt)  Six Light Chandelier","Accounts Receivable",170,NA,102914.92
"4492","Purchases  (Cost of Goods)","Invoice","2018-09-11","71099","Miscellaneous - Retail:Jason Helper","Brushed Nickel, Pendant, 1-100 watt Medium Base, Satin Etched Glass","Accounts Receivable",100,NA,103014.92
"4493","Purchases  (Cost of Goods)","Invoice","2018-09-11","71099","Miscellaneous - Retail:Jason Helper","Pendant Bar, Textured White, 50lbs max","Accounts Receivable",21.54,NA,103036.46
"4494","Purchases  (Cost of Goods)","Invoice","2018-09-14","71091","Cole Home Builders:Phase 2 - Lot 5","Golden Umber (100 watt)  Six Light Chandelier","Accounts Receivable",85,NA,103121.46
"4495","Purchases  (Cost of Goods)","Invoice","2018-09-14","71091","Cole Home Builders:Phase 2 - Lot 5","Tapestry (8/60 watt)  Faux Alabaster Glass","Accounts Receivable",75,NA,103196.46
"4496","Purchases  (Cost of Goods)","Invoice","2018-09-14","71091","Cole Home Builders:Phase 2 - Lot 5","Polished Brass Pendant, 1-100 watt Medium Base, Clear Ribbed Glass","Accounts Receivable",160,NA,103356.46
"4497","Purchases  (Cost of Goods)","Invoice","2018-09-14","71091","Cole Home Builders:Phase 2 - Lot 5","Tapestry, (2-60 watt Med), Etched Cracked Glass, Finish 10","Accounts Receivable",60,NA,103416.46
"4498","Purchases  (Cost of Goods)","Invoice","2018-09-14","71091","Cole Home Builders:Phase 2 - Lot 5","Verona Collection, Pendant, Cobblestone, Etched Alabaster Glass, 150 watt max","Accounts Receivable",140,NA,103556.46
"4499","Purchases  (Cost of Goods)","Invoice","2018-09-14","71091","Cole Home Builders:Phase 2 - Lot 5","Pendant Bar, Cobblestone, 50lbs. max","Accounts Receivable",22.74,NA,103579.2
"4500","Purchases  (Cost of Goods)","Invoice","2018-09-14","71091","Cole Home Builders:Phase 2 - Lot 5","Pearl Nickle, 5 Light, Medium Base (100 watt max)","Accounts Receivable",80,NA,103659.2
"4501","Purchases  (Cost of Goods)","Invoice","2018-09-14","71091","Cole Home Builders:Phase 2 - Lot 5","White, 4.5x7.5, 1-100 watt Medium Base, Satin White Glass","Accounts Receivable",30,NA,103689.2
"4502","Purchases  (Cost of Goods)","Invoice","2018-09-14","71091","Cole Home Builders:Phase 2 - Lot 5","Solid Brass, 4-light, 25x13x10.75, 4-60 watt, Medium Base, Satin Etched Glass","Accounts Receivable",19,NA,103708.2
"4503","Purchases  (Cost of Goods)","Invoice","2018-09-14","71091","Cole Home Builders:Phase 2 - Lot 5","Acid Verde, 10x21x10, 2-60 watt cand.","Accounts Receivable",60,NA,103768.2
"4504","Purchases  (Cost of Goods)","Invoice","2018-09-14","71091","Cole Home Builders:Phase 2 - Lot 5","BrassGuard Lanterns, Polished Brass, 1-light Wall, (100 watt max)","Accounts Receivable",105,NA,103873.2
"4505","Purchases  (Cost of Goods)","Invoice","2018-09-14","71091","Cole Home Builders:Phase 2 - Lot 5","Black Finish, Solid Brass, Clear Glass, Hanging, 2-60 watt max.","Accounts Receivable",38.44,NA,103911.64
"4506","Purchases  (Cost of Goods)","Invoice","2018-09-14","71091","Cole Home Builders:Phase 2 - Lot 5","Specialty, Stage & Studio Bulbs  60 watt","Accounts Receivable",15,NA,103926.64
"4507","Purchases  (Cost of Goods)","Invoice","2018-09-14","71091","Cole Home Builders:Phase 2 - Lot 5","Specialty Bulbs, 100 watt (6 pack)","Accounts Receivable",47.5,NA,103974.14
"4508","Purchases  (Cost of Goods)","Invoice","2018-09-14","71091","Cole Home Builders:Phase 2 - Lot 5","Cand. Light, 20 watts (8 pack)","Accounts Receivable",24,NA,103998.14
"4509","Purchases  (Cost of Goods)","Invoice","2018-09-19","71131","Kern Lighting Warehouse:Store #13","White, 4.5x7.5, 1-100 watt Medium Base, Satin White Glass","Accounts Receivable",240,NA,104238.14
"4510","Purchases  (Cost of Goods)","Invoice","2018-09-19","71131","Kern Lighting Warehouse:Store #13","Solid Brass, 4-light, 25x13x10.75, 4-60 watt, Medium Base, Satin Etched Glass","Accounts Receivable",304,NA,104542.14
"4511","Purchases  (Cost of Goods)","Invoice","2018-09-19","71131","Kern Lighting Warehouse:Store #13","Brushed Nickel, 18x7.75x6, 3-60 watt Medium Base, Satin Opal Glass","Accounts Receivable",462.5,NA,105004.64
"4512","Purchases  (Cost of Goods)","Invoice","2018-09-19","71131","Kern Lighting Warehouse:Store #13","River Rock (8/60 watt)  Faux Alabaster Glass","Accounts Receivable",600,NA,105604.64
"4513","Purchases  (Cost of Goods)","Invoice","2018-09-19","71131","Kern Lighting Warehouse:Store #13","Die Cast Lanterns, Black, 1-100 watt, Medium Base, Clear Cracked Glass","Accounts Receivable",770.64,NA,106375.28
"4514","Purchases  (Cost of Goods)","Invoice","2018-09-25","71100","Miscellaneous - Retail:John Huhn","Roman Bronze, 1-light Lantern, w/tail, (100 watt max)","Accounts Receivable",570,NA,106945.28
"4515","Purchases  (Cost of Goods)","Invoice","2018-09-25","71100","Miscellaneous - Retail:John Huhn","18x8x10, Solid Brass, 3-60watt Medium Base, Satin Etched Glass","Accounts Receivable",130.38,NA,107075.66
"4516","Purchases  (Cost of Goods)","Invoice","2018-09-25","71100","Miscellaneous - Retail:John Huhn","Verona Collection, Pendant, Cobblestone, Etched Alabaster Glass, 150 watt max","Accounts Receivable",280,NA,107355.66
"4517","Purchases  (Cost of Goods)","Invoice","2018-09-25","71100","Miscellaneous - Retail:John Huhn","Pendant Bar, Cobblestone, 50lbs. max","Accounts Receivable",45.48,NA,107401.14
"4518","Purchases  (Cost of Goods)","Invoice","2018-09-25","71107","Stern Commercial Contractor's:Tittle Properties","White, 4.5x7.5, 1-100 watt Medium Base, Satin White Glass","Accounts Receivable",3000,NA,110401.14
"4519","Purchases  (Cost of Goods)","Invoice","2018-09-25","71107","Stern Commercial Contractor's:Tittle Properties","Colonial, Brushed Steel Finish, Opal White Glass (60 watt)","Accounts Receivable",1000,NA,111401.14
"4520","Purchases  (Cost of Goods)","Invoice","2018-09-25","71107","Stern Commercial Contractor's:Tittle Properties","Colonial, Finished in Gold (60 watt)  ","Accounts Receivable",1000,NA,112401.14
"4521","Purchases  (Cost of Goods)","Invoice","2018-09-25","71107","Stern Commercial Contractor's:Tittle Properties","Sunset, Clear Glass, 1-100 watt max.","Accounts Receivable",3100.64,NA,115501.78
"4522","Purchases  (Cost of Goods)","Invoice","2018-09-25","71107","Stern Commercial Contractor's:Tittle Properties","Specialty Bulbs, 100 watt (6 pack)","Accounts Receivable",95,NA,115596.78
"4523","Purchases  (Cost of Goods)","Invoice","2018-09-25","71107","Stern Commercial Contractor's:Tittle Properties","Fluorescent Lamp, T-12, Medium Bipin  (30pack)","Accounts Receivable",634.29,NA,116231.07
"4524","Purchases  (Cost of Goods)","Invoice","2018-10-09","71101","Miscellaneous - Retail:Doug Jacobsen","Die Cast Lanterns, Black, 1-100 watt, Medium Base, Clear Cracked Glass","Accounts Receivable",308.26,NA,116539.33
"4525","Purchases  (Cost of Goods)","Invoice","2018-10-09","71101","Miscellaneous - Retail:Doug Jacobsen","Black Finish, Solid Brass, Clear Glass, Hanging, 2-60 watt max.","Accounts Receivable",38.44,NA,116577.77
"4526","Purchases  (Cost of Goods)","Invoice","2018-10-09","71101","Miscellaneous - Retail:Doug Jacobsen","Tapestry (8/60 watt)  Faux Alabaster Glass","Accounts Receivable",225,NA,116802.77
"4527","Purchases  (Cost of Goods)","Invoice","2018-10-09","71101","Miscellaneous - Retail:Doug Jacobsen","Broadway Collection, Polished Chrome, 4 Light (60 watt max)","Accounts Receivable",126,NA,116928.77
"4528","Purchases  (Cost of Goods)","Invoice","2018-10-09","71101","Miscellaneous - Retail:Doug Jacobsen","Flat Glass, (25 watt max) Polished Brass, 4 light","Accounts Receivable",24.25,NA,116953.02
"4529","Purchases  (Cost of Goods)","Invoice","2018-10-15","71132","Kern Lighting Warehouse:Store #34","Acid Verde, 10x21x10, 2-60 watt cand.","Accounts Receivable",1050,NA,118003.02
"4530","Purchases  (Cost of Goods)","Invoice","2018-10-15","71132","Kern Lighting Warehouse:Store #34","Die Cast Lanterns, Black, 1-100 watt, Medium Base, Clear Cracked Glass","Accounts Receivable",770.64,NA,118773.66
"4531","Purchases  (Cost of Goods)","Invoice","2018-10-15","71132","Kern Lighting Warehouse:Store #34","Polished Brass Pendant, 1-100 watt Medium Base, Clear Ribbed Glass","Accounts Receivable",32,NA,118805.66
"4532","Purchases  (Cost of Goods)","Invoice","2018-10-15","71132","Kern Lighting Warehouse:Store #34","Brushed Nickel, 18x7.75x6, 3-60 watt Medium Base, Satin Opal Glass","Accounts Receivable",185,NA,118990.66
"4533","Purchases  (Cost of Goods)","Invoice","2018-10-15","71132","Kern Lighting Warehouse:Store #34","Brushed Nickel, (3-60 watt, Med) Ribbed Glass","Accounts Receivable",120,NA,119110.66
"4534","Purchases  (Cost of Goods)","Invoice","2018-10-15","71132","Kern Lighting Warehouse:Store #34","Fluorescent Lamp, T-12, Medium Bipin  (30pack)","Accounts Receivable",320.13,NA,119430.79
"4535","Purchases  (Cost of Goods)","Invoice","2018-10-15","71132","Kern Lighting Warehouse:Store #34","Halogen Lamp, 20 watts, Luminous Intensity","Accounts Receivable",34.8,NA,119465.59
"4536","Purchases  (Cost of Goods)","Invoice","2018-10-15","71132","Kern Lighting Warehouse:Store #34","Halogen Lamp, Volts:3.5  Tubular","Accounts Receivable",50,NA,119515.59
"4537","Purchases  (Cost of Goods)","Invoice","2018-10-15","71132","Kern Lighting Warehouse:Store #34","Cand. Light, 20 watts (8 pack)","Accounts Receivable",84,NA,119599.59
"4538","Purchases  (Cost of Goods)","Invoice","2018-10-15","71132","Kern Lighting Warehouse:Store #34","Broadway Collection, Polished Chrome, 4 Light (60 watt max)","Accounts Receivable",2100,NA,121699.59
"4539","Purchases  (Cost of Goods)","Invoice","2018-10-15","71132","Kern Lighting Warehouse:Store #34","Golden Umber (100 watt)  Six Light Chandelier","Accounts Receivable",850,NA,122549.59
"4540","Purchases  (Cost of Goods)","Invoice","2018-10-25","71102","Miscellaneous - Retail:Peter Karpas","Roman Bronze, 1-light Lantern, w/tail, (100 watt max)","Accounts Receivable",304,NA,122853.59
"4541","Purchases  (Cost of Goods)","Invoice","2018-10-25","71102","Miscellaneous - Retail:Peter Karpas","Black Finish, Solid Brass, Clear Glass, Hanging, 2-60 watt max.","Accounts Receivable",57.66,NA,122911.25
"4542","Purchases  (Cost of Goods)","Invoice","2018-10-25","71102","Miscellaneous - Retail:Peter Karpas","Broadway Collection, Polished Brass, 6 Light (60 watt max)","Accounts Receivable",120,NA,123031.25
"4543","Purchases  (Cost of Goods)","Invoice","2018-10-25","71102","Miscellaneous - Retail:Peter Karpas","Frosted Taupe (3/60 watt)  Marble Glass  ","Accounts Receivable",178.42,NA,123209.67
"4544","Purchases  (Cost of Goods)","Invoice","2018-10-26","71108","Stern Commercial Contractor's:Wilson Suites","Flush Mount, Polished Brass (2, 13 watt)  White acrylic diffuser","Accounts Receivable",1235.29,NA,124444.96
"4545","Purchases  (Cost of Goods)","Invoice","2018-10-26","71108","Stern Commercial Contractor's:Wilson Suites","Sunset, Clear Glass, 1-100 watt max.","Accounts Receivable",3100.64,NA,127545.6
"4546","Purchases  (Cost of Goods)","Invoice","2018-10-26","71108","Stern Commercial Contractor's:Wilson Suites","White, 4.5x7.5, 1-100 watt Medium Base, Satin White Glass","Accounts Receivable",3000,NA,130545.6
"4547","Purchases  (Cost of Goods)","Invoice","2018-11-01","71120","Kern Lighting Warehouse:Store #13","18x8x10, Solid Brass, 3-60watt Medium Base, Satin Etched Glass","Accounts Receivable",1629.76,NA,132175.36
"4548","Purchases  (Cost of Goods)","Invoice","2018-11-01","71120","Kern Lighting Warehouse:Store #13","Burnished Brass (60 watt)  w/Golden Umber Accents","Accounts Receivable",750,NA,132925.36
"4549","Purchases  (Cost of Goods)","Invoice","2018-11-01","71120","Kern Lighting Warehouse:Store #13","2032 Series, (3-60 watt, Med) Desert Stone Finish","Accounts Receivable",540,NA,133465.36
"4550","Purchases  (Cost of Goods)","Invoice","2018-11-01","71120","Kern Lighting Warehouse:Store #13","Tapestry, (2-60 watt Med), Etched Cracked Glass, Finish 10","Accounts Receivable",300,NA,133765.36
"4551","Purchases  (Cost of Goods)","Invoice","2018-11-05","71103","Miscellaneous - Retail:Valesha Jones","Acid Verde, 10x21x10, 2-60 watt cand.","Accounts Receivable",450,NA,134215.36
"4552","Purchases  (Cost of Goods)","Invoice","2018-11-05","71103","Miscellaneous - Retail:Valesha Jones","Black Finish, Solid Brass, Clear Glass, Hanging, 2-60 watt max.","Accounts Receivable",38.44,NA,134253.8
"4553","Purchases  (Cost of Goods)","Invoice","2018-11-05","71103","Miscellaneous - Retail:Valesha Jones","Golden Umber (100 watt)  Six Light Chandelier","Accounts Receivable",255,NA,134508.8
"4554","Purchases  (Cost of Goods)","Invoice","2018-11-05","71103","Miscellaneous - Retail:Valesha Jones","18x8x10, Solid Brass, 3-60watt Medium Base, Satin Etched Glass","Accounts Receivable",130.38,NA,134639.18
"4555","Purchases  (Cost of Goods)","Invoice","2018-11-05","71103","Miscellaneous - Retail:Valesha Jones","Polished Brass Pendant, 1-100 watt Medium Base, Clear Ribbed Glass","Accounts Receivable",128,NA,134767.18
"4556","Purchases  (Cost of Goods)","Invoice","2018-11-05","71117","Lavery Lighting & Design:Store #JL-01","Chestnut (3/60 watt)  Marble Glass","Accounts Receivable",194.4,NA,134961.58
"4557","Purchases  (Cost of Goods)","Invoice","2018-11-05","71117","Lavery Lighting & Design:Store #JL-01","Tiffany Collection,Golden Baroque, 1-light lantern, medium base (100 watt max)","Accounts Receivable",336,NA,135297.58
"4558","Purchases  (Cost of Goods)","Invoice","2018-11-05","71117","Lavery Lighting & Design:Store #JL-01","Die Cast Lanterns, Black, 1-100 watt, Medium Base, Clear Cracked Glass","Accounts Receivable",577.98,NA,135875.56
"4559","Purchases  (Cost of Goods)","Invoice","2018-11-05","71117","Lavery Lighting & Design:Store #JL-01","Golden Umber (100 watt)  Six Light Chandelier","Accounts Receivable",170,NA,136045.56
"4560","Purchases  (Cost of Goods)","Invoice","2018-11-05","71117","Lavery Lighting & Design:Store #JL-01","Beveled Mirror, Etched Ribbed Glass (75 watt max)","Accounts Receivable",244.97,NA,136290.53
"4561","Purchases  (Cost of Goods)","Invoice","2018-11-05","71117","Lavery Lighting & Design:Store #JL-01","Pearl Nickle, 5 Light, Medium Base (100 watt max)","Accounts Receivable",200,NA,136490.53
"4562","Purchases  (Cost of Goods)","Invoice","2018-11-05","71117","Lavery Lighting & Design:Store #JL-01","Polished Brass Pendant, 1-100 watt Medium Base, Clear Ribbed Glass","Accounts Receivable",64,NA,136554.53
"4563","Purchases  (Cost of Goods)","Invoice","2018-11-05","71117","Lavery Lighting & Design:Store #JL-01","Athena Collection, Pendant, Textured White, Med. Base, 100 watt max.","Accounts Receivable",120,NA,136674.53
"4564","Purchases  (Cost of Goods)","Invoice","2018-11-05","71117","Lavery Lighting & Design:Store #JL-01","Verona Collection, Pendant, Cobblestone, Etched Alabaster Glass, 150 watt max","Accounts Receivable",140,NA,136814.53
"4565","Purchases  (Cost of Goods)","Invoice","2018-11-05","71117","Lavery Lighting & Design:Store #JL-01","Black Finish, Solid Brass, Clear Glass, Hanging, 2-60 watt max.","Accounts Receivable",38.44,NA,136852.97
"4566","Purchases  (Cost of Goods)","Invoice","2018-11-05","71117","Lavery Lighting & Design:Store #JL-01","Fluorescent Lamp, T-12, Medium Bipin  (30pack)","Accounts Receivable",12.81,NA,136865.78
"4567","Purchases  (Cost of Goods)","Invoice","2018-11-05","71117","Lavery Lighting & Design:Store #JL-01","Cand. Light, 20 watts (8 pack)","Accounts Receivable",120,NA,136985.78
"4568","Purchases  (Cost of Goods)","Invoice","2018-11-05","71117","Lavery Lighting & Design:Store #JL-01","Specialty Bulbs, 100 watt (6 pack)","Accounts Receivable",47.5,NA,137033.28
"4569","Purchases  (Cost of Goods)","Invoice","2018-11-05","71117","Lavery Lighting & Design:Store #JL-01","Specialty, Stage & Studio Bulbs  60 watt","Accounts Receivable",50,NA,137083.28
"4570","Purchases  (Cost of Goods)","Invoice","2018-11-16","71118","Lavery Lighting & Design:Store #JL-04","Acid Verde, 10x21x10, 2-60 watt cand.","Accounts Receivable",900,NA,137983.28
"4571","Purchases  (Cost of Goods)","Invoice","2018-11-16","71118","Lavery Lighting & Design:Store #JL-04","Die Cast Lanterns, Black, 1-100 watt, Medium Base, Clear Cracked Glass","Accounts Receivable",577.98,NA,138561.26
"4572","Purchases  (Cost of Goods)","Invoice","2018-11-16","71118","Lavery Lighting & Design:Store #JL-04","Vianne Lanterns, Satin Antiqued Solid Brass, 3-light wall latern, Candelabra base (60 watt max)","Accounts Receivable",1203.57,NA,139764.83
"4573","Purchases  (Cost of Goods)","Invoice","2018-11-16","71118","Lavery Lighting & Design:Store #JL-04","Tapestry (8/60 watt)  Faux Alabaster Glass","Accounts Receivable",375,NA,140139.83
"4574","Purchases  (Cost of Goods)","Invoice","2018-11-16","71118","Lavery Lighting & Design:Store #JL-04","Frosted Taupe (3/60 watt)  Marble Glass  ","Accounts Receivable",267.63,NA,140407.46
"4575","Purchases  (Cost of Goods)","Invoice","2018-11-16","71118","Lavery Lighting & Design:Store #JL-04","Chestnut (3/60 watt)  Marble Glass","Accounts Receivable",291.6,NA,140699.06
"4576","Purchases  (Cost of Goods)","Invoice","2018-11-16","71118","Lavery Lighting & Design:Store #JL-04","Black Finish, Solid Brass, Clear Glass, Hanging, 2-60 watt max.","Accounts Receivable",384.42,NA,141083.48
"4577","Purchases  (Cost of Goods)","Invoice","2018-11-16","71118","Lavery Lighting & Design:Store #JL-04","Tiffany Collection,Golden Baroque, 1-light lantern, medium base (100 watt max)","Accounts Receivable",480,NA,141563.48
"4578","Purchases  (Cost of Goods)","Invoice","2018-11-16","71118","Lavery Lighting & Design:Store #JL-04","Beveled Mirror, Etched Ribbed Glass (75 watt max)","Accounts Receivable",489.94,NA,142053.42
"4579","Purchases  (Cost of Goods)","Invoice","2018-11-16","71118","Lavery Lighting & Design:Store #JL-04","Specialty Bulbs, 100 watt (6 pack)","Accounts Receivable",71.25,NA,142124.67
"4580","Purchases  (Cost of Goods)","Invoice","2018-11-16","71118","Lavery Lighting & Design:Store #JL-04","Specialty, Stage & Studio Bulbs  60 watt","Accounts Receivable",25,NA,142149.67
"4581","Purchases  (Cost of Goods)","Invoice","2018-11-20","71104","Miscellaneous - Retail:Melanie Hall","Vianne Lanterns, Satin Antiqued Solid Brass, 3-light wall latern, Candelabra base (60 watt max)","Accounts Receivable",240.71,NA,142390.38
"4582","Purchases  (Cost of Goods)","Invoice","2018-11-20","71104","Miscellaneous - Retail:Melanie Hall","Broadway Collection, Polished Chrome, 4 Light (60 watt max)","Accounts Receivable",210,NA,142600.38
"4583","Purchases  (Cost of Goods)","Invoice","2018-11-20","71104","Miscellaneous - Retail:Melanie Hall","Brushed Nickel, Pendant, 1-100 watt Medium Base, Satin Etched Glass","Accounts Receivable",200,NA,142800.38
"4584","Purchases  (Cost of Goods)","Invoice","2018-11-20","71104","Miscellaneous - Retail:Melanie Hall","Pendant Bar, Textured White, 50lbs max","Accounts Receivable",43.08,NA,142843.46
"4585","Purchases  (Cost of Goods)","Invoice","2018-11-20","71104","Miscellaneous - Retail:Melanie Hall","Chestnut (3/60 watt)  Marble Glass","Accounts Receivable",97.2,NA,142940.66
"4586","Purchases  (Cost of Goods)","Invoice","2018-11-22","71133","Kern Lighting Warehouse:Store #01","Sunset, Clear Glass, 1-100 watt max.","Accounts Receivable",77.52,NA,143018.18
"4587","Purchases  (Cost of Goods)","Invoice","2018-11-22","71133","Kern Lighting Warehouse:Store #01","Beveled Mirror, Etched Ribbed Glass (75 watt max)","Accounts Receivable",857.4,NA,143875.58
"4588","Purchases  (Cost of Goods)","Invoice","2018-11-22","71133","Kern Lighting Warehouse:Store #01","Pendant Bar, Textured White, 50lbs max","Accounts Receivable",204.62,NA,144080.2
"4589","Purchases  (Cost of Goods)","Invoice","2018-11-22","71133","Kern Lighting Warehouse:Store #01","Pendant Bar, Cobblestone, 50lbs. max","Accounts Receivable",68.22,NA,144148.42
"4590","Purchases  (Cost of Goods)","Invoice","2018-11-22","71133","Kern Lighting Warehouse:Store #01","Domes, White, 59x21x6 5/8 ht, 120v HPF","Accounts Receivable",180,NA,144328.42
"4591","Purchases  (Cost of Goods)","Invoice","2018-11-22","71133","Kern Lighting Warehouse:Store #01","Flat Glass, (25 watt max) Polished Brass, 4 light","Accounts Receivable",36.37,NA,144364.79
"4592","Purchases  (Cost of Goods)","Invoice","2018-11-22","71133","Kern Lighting Warehouse:Store #01","Verona Collection, Pendant, Cobblestone, Etched Alabaster Glass, 150 watt max","Accounts Receivable",595,NA,144959.79
"4593","Purchases  (Cost of Goods)","Invoice","2018-11-22","71133","Kern Lighting Warehouse:Store #01","Burnished Brass (60 watt)  w/Golden Umber Accents","Accounts Receivable",3525,NA,148484.79
"4594","Purchases  (Cost of Goods)","Invoice","2018-11-22","71133","Kern Lighting Warehouse:Store #01","Renaissance Collection, (100 watt max) Millstone Finish, One-light","Accounts Receivable",261.78,NA,148746.57
"4595","Purchases  (Cost of Goods)","Invoice","2018-11-22","71133","Kern Lighting Warehouse:Store #01","Broadway Collection, Polished Chrome, 4 Light (60 watt max)","Accounts Receivable",84,NA,148830.57
"4596","Purchases  (Cost of Goods)","Invoice","2018-11-29","71123","Kern Lighting Warehouse:Store #13","18x8x10, Solid Brass, 3-60watt Medium Base, Satin Etched Glass","Accounts Receivable",0,NA,148830.57
"4597","Purchases  (Cost of Goods)","Invoice","2018-11-29","71123","Kern Lighting Warehouse:Store #13","Burnished Brass (60 watt)  w/Golden Umber Accents","Accounts Receivable",0,NA,148830.57
"4598","Purchases  (Cost of Goods)","Invoice","2018-11-29","71123","Kern Lighting Warehouse:Store #13","2032 Series, (3-60 watt, Med) Desert Stone Finish","Accounts Receivable",60,NA,148890.57
"4599","Purchases  (Cost of Goods)","Invoice","2018-11-29","71123","Kern Lighting Warehouse:Store #13","Tapestry, (2-60 watt Med), Etched Cracked Glass, Finish 10","Accounts Receivable",0,NA,148890.57
"4600","Purchases  (Cost of Goods)","Invoice","2018-12-03","71139","Lavery Lighting & Design:Store #JL-08","Acid Verde, 10x21x10, 2-60 watt cand.","Accounts Receivable",300,NA,149190.57
"4601","Purchases  (Cost of Goods)","Invoice","2018-12-03","71139","Lavery Lighting & Design:Store #JL-08","Brushed Nickel, Pendant, 1-100 watt Medium Base, Satin Etched Glass","Accounts Receivable",250,NA,149440.57
"4602","Purchases  (Cost of Goods)","Invoice","2018-12-03","71139","Lavery Lighting & Design:Store #JL-08","White, 4.5x7.5, 1-100 watt Medium Base, Satin White Glass","Accounts Receivable",225,NA,149665.57
"4603","Purchases  (Cost of Goods)","Invoice","2018-12-03","71139","Lavery Lighting & Design:Store #JL-08","River Rock (8/60 watt)  Faux Alabaster Glass","Accounts Receivable",375,NA,150040.57
"4604","Purchases  (Cost of Goods)","Invoice","2018-12-03","71139","Lavery Lighting & Design:Store #JL-08","Specialty, Stage & Studio Bulbs  60 watt","Accounts Receivable",25,NA,150065.57
"4605","Purchases  (Cost of Goods)","Invoice","2018-12-03","71139","Lavery Lighting & Design:Store #JL-08","Halogen Lamp, Volts:3.5  Tubular","Accounts Receivable",5,NA,150070.57
"4606","Purchases  (Cost of Goods)","Invoice","2018-12-03","71139","Lavery Lighting & Design:Store #JL-08","Cand. Light, 20 watts (8 pack)","Accounts Receivable",0,NA,150070.57
"4607","Purchases  (Cost of Goods)","Invoice","2018-12-07","71138","Baker's Professional Lighting:Store #10","Fluorescent Lamp, Medium Bipin (30pack)","Accounts Receivable",1412.32,NA,151482.89
"4608","Purchases  (Cost of Goods)","Invoice","2018-12-07","71138","Baker's Professional Lighting:Store #10","Fluorescent Lamp, Large Bipin (30 pack)","Accounts Receivable",90,NA,151572.89
"4609","Purchases  (Cost of Goods)","Invoice","2018-12-07","71138","Baker's Professional Lighting:Store #10","Halogen Lamp, 3.5 Volts, Tubular","Accounts Receivable",150,NA,151722.89
"4610","Purchases  (Cost of Goods)","Invoice","2018-12-07","71138","Baker's Professional Lighting:Store #10","Cand. Light, 20 watts (8 pack)","Accounts Receivable",384,NA,152106.89
"4611","Purchases  (Cost of Goods)","Invoice","2018-12-07","71138","Baker's Professional Lighting:Store #10","100 watt (6 pack)","Accounts Receivable",1425,NA,153531.89
"4612","Purchases  (Cost of Goods)","Invoice","2018-12-07","71138","Baker's Professional Lighting:Store #10","Stage & Studio, 60 watt (set of 4)","Accounts Receivable",750,NA,154281.89
"4613","Purchases  (Cost of Goods)","Invoice","2018-12-10","71105","Miscellaneous - Retail:Lara Gussman","Die Cast Lanterns, Black, 1-100 watt, Medium Base, Clear Cracked Glass","Accounts Receivable",423.85,NA,154705.74
"4614","Purchases  (Cost of Goods)","Invoice","2018-12-10","71105","Miscellaneous - Retail:Lara Gussman","Black Finish, Solid Brass, Clear Glass, Hanging, 2-60 watt max.","Accounts Receivable",38.44,NA,154744.18
"4615","Purchases  (Cost of Goods)","Invoice","2018-12-10","71105","Miscellaneous - Retail:Lara Gussman","Beveled Mirror, Etched Ribbed Glass (75 watt max)","Accounts Receivable",97.99,NA,154842.17
"4616","Purchases  (Cost of Goods)","Invoice","2018-12-10","71105","Miscellaneous - Retail:Lara Gussman","Chestnut (3/60 watt)  Marble Glass","Accounts Receivable",96.49,NA,154938.66
"4617","Purchases  (Cost of Goods)","Invoice","2018-12-10","71105","Miscellaneous - Retail:Lara Gussman","Brushed Nickel, (3-60 watt, Med) Ribbed Glass","Accounts Receivable",60,NA,154998.66
"4618","Purchases  (Cost of Goods)","Invoice","2018-12-10","71105","Miscellaneous - Retail:Lara Gussman","2032 Series, (3-60 watt, Med) Desert Stone Finish","Accounts Receivable",48,NA,155046.66
"4619","Purchases  (Cost of Goods)","Invoice","2018-12-10","71105","Miscellaneous - Retail:Lara Gussman","Colonial, Brushed Steel Finish, Opal White Glass (60 watt)","Accounts Receivable",20,NA,155066.66
"4620","Purchases  (Cost of Goods)","Invoice","2018-12-12","71106","Stern Commercial Contractor's:Walker Properties","Renaissance Collection, (100 watt max) Millstone Finish, One-light","Accounts Receivable",1539.89,NA,156606.55
"4621","Purchases  (Cost of Goods)","Invoice","2018-12-12","71106","Stern Commercial Contractor's:Walker Properties","Sunset, Clear Glass, 1-100 watt max.","Accounts Receivable",3100.64,NA,159707.19
"4622","Purchases  (Cost of Goods)","Invoice","2018-12-12","71106","Stern Commercial Contractor's:Walker Properties","Domes, White, 59x21x6 5/8 ht, 120v HPF","Accounts Receivable",3600,NA,163307.19
"4623","Purchases  (Cost of Goods)","Invoice","2018-12-12","71106","Stern Commercial Contractor's:Walker Properties","Flush Mount, Polished Brass (2, 13 watt)  White acrylic diffuser","Accounts Receivable",823.53,NA,164130.72
"4624","Purchases  (Cost of Goods)","Invoice","2018-12-12","71106","Stern Commercial Contractor's:Walker Properties","Fluorescent Lamp, T-12, Medium Bipin  (30pack)","Accounts Receivable",682.86,NA,164813.58
"4625","Purchases  (Cost of Goods)","Bill","2018-12-15","P0989","Dan A. North Builders:Custom Order - Suite 100A","Custom Dome lighting with purple trim, extra voltage","Accounts Payable",5400,NA,170213.58
"4626","Purchases  (Cost of Goods)","Invoice","2018-12-15","71140","Thompson Lighting Stores:Store #15","Die Cast Lanterns, Black, 1-100 watt, Medium Base, Clear Cracked Glass","Accounts Receivable",577.98,NA,170791.56
"4627","Purchases  (Cost of Goods)","Invoice","2018-12-15","71140","Thompson Lighting Stores:Store #15","Tapestry, (2-60 watt Med), Etched Cracked Glass, Finish 10","Accounts Receivable",225,NA,171016.56
"4628","Purchases  (Cost of Goods)","Invoice","2018-12-15","71140","Thompson Lighting Stores:Store #15","18x8x10, Solid Brass, 3-60watt Medium Base, Satin Etched Glass","Accounts Receivable",358.55,NA,171375.11
"4629","Purchases  (Cost of Goods)","Invoice","2018-12-15","71140","Thompson Lighting Stores:Store #15","Fluorescent Lamp, T-12, Medium Bipin  (30pack)","Accounts Receivable",0,NA,171375.11
"4630","Purchases  (Cost of Goods)","Invoice","2018-12-15","71140","Thompson Lighting Stores:Store #15","Specialty Bulbs, 100 watt (6 pack)","Accounts Receivable",47.5,NA,171422.61
"4631","Purchases  (Cost of Goods)","Invoice","2018-12-15","71140","Thompson Lighting Stores:Store #15","Golden Umber (100 watt)  Six Light Chandelier","Accounts Receivable",425,NA,171847.61
"4632","Purchases  (Cost of Goods)","Invoice","2018-12-15","71140","Thompson Lighting Stores:Store #15","Golden Umber, 6 Light","Accounts Receivable",425,NA,172272.61
"4633","Purchases  (Cost of Goods)","Invoice","2018-12-15","71140","Thompson Lighting Stores:Store #15","Frosted Taupe with Marble Glass","Accounts Receivable",624.47,NA,172897.08
"4634","Purchases  (Cost of Goods)","Invoice","2018-12-15","71140","Thompson Lighting Stores:Store #15","Tapestry with Faux Alabaster Glass","Accounts Receivable",525,NA,173422.08
"4635","Purchases  (Cost of Goods)","Invoice","2018-12-15","71140","Thompson Lighting Stores:Store #15","Beveled Mirror with Etched Ribbed Glass","Accounts Receivable",244.97,NA,173667.05
"4636","Purchases  (Cost of Goods)","Invoice","2018-12-15","71140","Thompson Lighting Stores:Store #15","Polished Brass, 6 Light","Accounts Receivable",150,NA,173817.05
"4637","Purchases  (Cost of Goods)","Invoice","2018-12-15","71140","Thompson Lighting Stores:Store #15","White with Satin White Glass","Accounts Receivable",105,NA,173922.05
"4638","Purchases  (Cost of Goods)","Invoice","2018-12-15","71140","Thompson Lighting Stores:Store #15","Steel Colonial with Opal White Glass","Accounts Receivable",100,NA,174022.05
"4639","Purchases  (Cost of Goods)","Invoice","2018-12-15","71140","Thompson Lighting Stores:Store #15","Gold Colonial","Accounts Receivable",100,NA,174122.05
"4640","Purchases  (Cost of Goods)","Invoice","2018-12-15","71140","Thompson Lighting Stores:Store #15","Copper Verde, Seeded Glass","Accounts Receivable",128.57,NA,174250.62
"4641","Purchases  (Cost of Goods)","Invoice","2018-12-15","71134","Kern Lighting Warehouse:Store #13","Acid Verde","Accounts Receivable",690,NA,174940.62
"4642","Purchases  (Cost of Goods)","Invoice","2018-12-15","71134","Kern Lighting Warehouse:Store #13","Brushed Nickel Pendant with Etched Glass","Accounts Receivable",175,NA,175115.62
"4643","Purchases  (Cost of Goods)","Invoice","2018-12-15","71134","Kern Lighting Warehouse:Store #13","Tapestry with Etched Glass","Accounts Receivable",45,NA,175160.62
"4644","Purchases  (Cost of Goods)","Invoice","2018-12-15","71134","Kern Lighting Warehouse:Store #13","Brushed Nickel with Ribbed Glass","Accounts Receivable",180,NA,175340.62
"4645","Purchases  (Cost of Goods)","Invoice","2018-12-15","71134","Kern Lighting Warehouse:Store #13","Fluorescent Lamp, Medium Bipin (30pack)","Accounts Receivable",341.43,NA,175682.05
"4646","Purchases  (Cost of Goods)","Invoice","2018-12-15","71134","Kern Lighting Warehouse:Store #13","Halogen Lamp, 3.5 Volts, Tubular","Accounts Receivable",50,NA,175732.05
"4647","Purchases  (Cost of Goods)","Invoice","2018-12-15","71134","Kern Lighting Warehouse:Store #13","Stage & Studio, 60 watt (set of 4)","Accounts Receivable",57.5,NA,175789.55
"4648","Purchases  (Cost of Goods)","Invoice","2018-12-15","71134","Kern Lighting Warehouse:Store #13","Copper Verde, Seeded Glass","Accounts Receivable",642.86,NA,176432.41
"4649","Purchases  (Cost of Goods)","Invoice","2018-12-15","71134","Kern Lighting Warehouse:Store #13","Bronze Lantern with Tail","Accounts Receivable",1216,NA,177648.41
"4650","Purchases  (Cost of Goods)","Invoice","2018-12-15","71134","Kern Lighting Warehouse:Store #13","Hanging Brass and Black Finish with Clear Glass","Accounts Receivable",480.52,NA,178128.93
"4651","Purchases  (Cost of Goods)","Invoice","2018-12-15","71136","Kern Lighting Warehouse:Store #13","Black Die Cast Lanterns with Clear Glass","Accounts Receivable",192.66,NA,178321.59
"4652","Purchases  (Cost of Goods)","Invoice","2018-12-15","71136","Kern Lighting Warehouse:Store #13","Solid Brass with Etched Glass, 2 Light","Accounts Receivable",162.98,NA,178484.57
"4653","Purchases  (Cost of Goods)","Invoice","2018-12-15","71136","Kern Lighting Warehouse:Store #13","Textured White Pendant","Accounts Receivable",150,NA,178634.57
"4654","Purchases  (Cost of Goods)","Invoice","2018-12-15","71136","Kern Lighting Warehouse:Store #13","Steel Colonial with Opal White Glass","Accounts Receivable",50,NA,178684.57
"4655","Purchases  (Cost of Goods)","Invoice","2018-12-15","71136","Kern Lighting Warehouse:Store #13","Brass with Black Finish and Clear Glass","Accounts Receivable",200,NA,178884.57
"4656","Purchases  (Cost of Goods)","Invoice","2018-12-15","71136","Kern Lighting Warehouse:Store #13","Hanging Brass and Black Finish with Clear Glass","Accounts Receivable",96.1,NA,178980.67
"4657","Purchases  (Cost of Goods)","Invoice","2018-12-15","71136","Kern Lighting Warehouse:Store #13","Drop Opal with Solid Oak Frame","Accounts Receivable",107.21,NA,179087.88
"4658","Purchases  (Cost of Goods)","Invoice","2018-12-15","71136","Kern Lighting Warehouse:Store #13","Textured White Pendant","Accounts Receivable",150,NA,179237.88
"4659","Purchases  (Cost of Goods)","Invoice","2018-12-15","71135","Baker's Professional Lighting:Store #15","Gold Colonial","Accounts Receivable",20,NA,179257.88
"4660","Purchases  (Cost of Goods)","Invoice","2018-12-15","71135","Baker's Professional Lighting:Store #15","Steel Colonial with Opal White Glass","Accounts Receivable",40,NA,179297.88
"4661","Purchases  (Cost of Goods)","Invoice","2018-12-15","71135","Baker's Professional Lighting:Store #15","Brushed Nickel with Opal Glass","Accounts Receivable",74,NA,179371.88
"4662","Purchases  (Cost of Goods)","Invoice","2018-12-15","71135","Baker's Professional Lighting:Store #15","Textured White Pendant","Accounts Receivable",150,NA,179521.88
"4663","Purchases  (Cost of Goods)","Invoice","2018-12-15","71135","Baker's Professional Lighting:Store #15","Brass Guard Lanterns, 1 Light","Accounts Receivable",140,NA,179661.88
"4664","Purchases  (Cost of Goods)","Invoice","2018-12-15","71135","Baker's Professional Lighting:Store #15","Drop Opal with Solid Oak Frame","Accounts Receivable",107.21,NA,179769.09
"4665","Purchases  (Cost of Goods)","Invoice","2018-12-15","71135","Baker's Professional Lighting:Store #15","Black Die Cast Lanterns with Clear Glass","Accounts Receivable",192.66,NA,179961.75
"4668","Sales Commission (outside reps)","Bill","2018-07-01","Commission Jan - Jun","Michael Kretchmar","Jan - June cash basis sales","Accounts Payable",3990.8,NA,3990.8
"4671","Advertising Expense","Check","2018-01-25","5018","Novello Lights Magazine","Q1 07 Ad","Company Checking Account",500,NA,500
"4672","Advertising Expense","Check","2018-04-20","5088","Novello Lights Magazine","Q2 07 Ad","Company Checking Account",500,NA,1000
"4673","Advertising Expense","Check","2018-07-23","5176","Novello Lights Magazine","Q3 07 Ad","Company Checking Account",500,NA,1500
"4674","Advertising Expense","Check","2018-10-19","5253","Novello Lights Magazine","Q4 07 Ad","Company Checking Account",500,NA,2000
"4679","Business License & Fees","Check","2018-02-22","5043","City of Bayshore","business license","Company Checking Account",354,NA,354
"4680","Business License & Fees","Check","2018-02-22","5039","County of Middlefield","Personal Property Taxes","Company Checking Account",356.23,NA,710.23
"4684","Car/Truck Expense","Check","2018-01-15","5007","Automobile Loan Company","Car lease","Company Checking Account",563,NA,563
"4685","Car/Truck Expense","Check","2018-02-15","5037","Automobile Loan Company","Car lease","Company Checking Account",563,NA,1126
"4686","Car/Truck Expense","Check","2018-03-15","5066","Automobile Loan Company","Car lease","Company Checking Account",563,NA,1689
"4687","Car/Truck Expense","Check","2018-04-16","5087","Automobile Loan Company","Car lease","Company Checking Account",563,NA,2252
"4688","Car/Truck Expense","Check","2018-05-15","5116","Automobile Loan Company","Car lease","Company Checking Account",563,NA,2815
"4689","Car/Truck Expense","Check","2018-06-15","5142","Automobile Loan Company","Car lease","Company Checking Account",563,NA,3378
"4690","Car/Truck Expense","Check","2018-07-26","5184","Automobile Loan Company","Car lease","Company Checking Account",563,NA,3941
"4691","Car/Truck Expense","Check","2018-08-15","5197","Automobile Loan Company","Car lease","Company Checking Account",563,NA,4504
"4692","Car/Truck Expense","Check","2018-09-14","5225","Automobile Loan Company","Car lease","Company Checking Account",563,NA,5067
"4693","Car/Truck Expense","Check","2018-10-15","5252","Automobile Loan Company","Car lease","Company Checking Account",563,NA,5630
"4694","Car/Truck Expense","Check","2018-11-15","5278","Automobile Loan Company","Car lease","Company Checking Account",563,NA,6193
"4695","Car/Truck Expense","Check","2018-12-14","5301","Automobile Loan Company","Car lease","Company Checking Account",563,NA,6756
"4698","Car/Truck Expense","Credit Card Charge","2018-01-25","1578932","Larsen Gas Station","gas","QuickBooks Credit Card",22.56,NA,22.56
"4699","Car/Truck Expense","Check","2018-01-31","5023","Jonathan Graham (reimbursments)","13103 Exp Rpt","Company Checking Account",127.23,NA,149.79
"4700","Car/Truck Expense","Check","2018-02-22","5038","Deborah Wood (Owner)","Petty Cash","Company Checking Account",53,NA,202.79
"4701","Car/Truck Expense","Check","2018-04-23","5093","Jonathan Graham (reimbursments)","33103 Exp Rpt","Company Checking Account",78.23,NA,281.02
"4702","Car/Truck Expense","Check","2018-04-23","5089","King, Vicki","mileage","Company Checking Account",15.63,NA,296.65
"4703","Car/Truck Expense","Check","2018-04-23","5095","Deborah Wood (Owner)","33103 Exp Report","Company Checking Account",54.68,NA,351.33
"4704","Car/Truck Expense","Check","2018-05-22","5118","Deborah Wood (Owner)","Petty Cash","Company Checking Account",21.89,NA,373.22
"4705","Car/Truck Expense","Check","2018-07-23","5170","Jonathan Graham (reimbursments)","63003 Exp Rpt","Company Checking Account",120.52,NA,493.74
"4706","Car/Truck Expense","Check","2018-07-23","5171","King, Vicki",NA,"Company Checking Account",47.95,NA,541.69
"4707","Car/Truck Expense","Check","2018-07-23","5172","Deborah Wood (Owner)","63003 Exp Report","Company Checking Account",47.23,NA,588.92
"4708","Car/Truck Expense","Check","2018-08-22","5209","Deborah Wood (Owner)","gas","Company Checking Account",47.23,NA,636.15
"4709","Car/Truck Expense","Check","2018-10-22","5255","King, Vicki","93003 Exp Rpt","Company Checking Account",10.2,NA,646.35
"4710","Car/Truck Expense","Check","2018-10-22","5257","Deborah Wood (Owner)","93007 Expense Report","Company Checking Account",58.69,NA,705.04
"4711","Car/Truck Expense","Check","2018-11-22","5279","Jonathan Graham (reimbursments)","93003 Exp Rpt","Company Checking Account",113.34,NA,818.38
"4712","Car/Truck Expense","Check","2018-11-22","5283","Deborah Wood (Owner)","Petty Cash","Company Checking Account",89.26,NA,907.64
"4715","Car/Truck Expense","Check","2018-01-31","5022","Automobile Insurance Company","Policy # 14906","Company Checking Account",120,NA,120
"4716","Car/Truck Expense","Check","2018-02-28","5056","Automobile Insurance Company","Policy # 14906","Company Checking Account",120,NA,240
"4717","Car/Truck Expense","Check","2018-03-30","5076","Automobile Insurance Company","Policy # 14906","Company Checking Account",120,NA,360
"4718","Car/Truck Expense","Check","2018-04-30","5104","Automobile Insurance Company","Policy # 14906","Company Checking Account",120,NA,480
"4719","Car/Truck Expense","Check","2018-05-31","5133","Automobile Insurance Company","Policy # 14906","Company Checking Account",120,NA,600
"4720","Car/Truck Expense","Check","2018-06-29","5158","Automobile Insurance Company","Policy # 14906","Company Checking Account",120,NA,720
"4721","Car/Truck Expense","Check","2018-07-31","5187","Automobile Insurance Company","Policy # 14906","Company Checking Account",120,NA,840
"4722","Car/Truck Expense","Check","2018-08-31","5219","Automobile Insurance Company","Policy # 14906","Company Checking Account",120,NA,960
"4723","Car/Truck Expense","Check","2018-09-28","5241","Automobile Insurance Company","Policy # 14906","Company Checking Account",120,NA,1080
"4724","Car/Truck Expense","Check","2018-10-31","5269","Automobile Insurance Company","Policy # 14906","Company Checking Account",120,NA,1200
"4725","Car/Truck Expense","Check","2018-11-30","5292","Automobile Insurance Company","Policy # 14906","Company Checking Account",120,NA,1320
"4726","Car/Truck Expense","Check","2018-12-31","5315","Automobile Insurance Company","Policy # 14906","Company Checking Account",120,NA,1440
"4732","Car/Truck Expense","Check","2018-04-23","5092","Department of Automobiles","Auto Registration","Company Checking Account",546,NA,546
"4735","Car/Truck Expense","Check","2018-04-23","5095","Deborah Wood (Owner)","Auto repairs","Company Checking Account",980.23,NA,980.23
"4736","Car/Truck Expense","Check","2018-10-22","5257","Deborah Wood (Owner)","Maintenance & Repairs","Company Checking Account",720,NA,1700.23
"4742","Conferences and Seminars","Check","2018-01-31","5025","Lawson Professional Seminars, Inc.","Spring Seminar #407","Company Checking Account",1000,NA,1000
"4743","Conferences and Seminars","Check","2018-05-15","5115","Lawson Professional Seminars, Inc.","Summer Seminar #707","Company Checking Account",350,NA,1350
"4744","Conferences and Seminars","Check","2018-08-15","5198","Lawson Professional Seminars, Inc.","Summer Seminar #907","Company Checking Account",350,NA,1700
"4745","Conferences and Seminars","Check","2018-08-22","5206","Professional Association","Convention","Company Checking Account",1000,NA,2700
"4746","Conferences and Seminars","Check","2018-08-22","5206","Professional Association","Convention","Company Checking Account",1000,NA,3700
"4747","Conferences and Seminars","Check","2018-08-22","5206","Professional Association","Convention","Company Checking Account",1000,NA,4700
"4750","Contributions","Check","2018-12-05","5298","Women's Shelter","donation","Company Checking Account",2500,NA,2500
"4753","Depreciation Expense","General Journal","2018-01-31","DEPR03",NA,"Jan07 Depr Expense","Accumulated Depreciation",76.92,NA,76.92
"4754","Depreciation Expense","General Journal","2018-02-28","DEPR03",NA,"Feb03 Depr Expense","Accumulated Depreciation",76.92,NA,153.84
"4755","Depreciation Expense","General Journal","2018-03-31","DEPR4",NA,"Mar03 Depr Expense","Accumulated Depreciation",76.92,NA,230.76
"4756","Depreciation Expense","General Journal","2018-04-30","DEPR5",NA,"Apr03 Depr Expense","Accumulated Depreciation",76.92,NA,307.68
"4757","Depreciation Expense","General Journal","2018-05-31","DEPR6",NA,"May03 Depr Expense","Accumulated Depreciation",76.92,NA,384.6
"4758","Depreciation Expense","General Journal","2018-06-30","DEPR7",NA,"June03 Depr Expense","Accumulated Depreciation",76.92,NA,461.52
"4759","Depreciation Expense","General Journal","2018-07-31","DEPR8",NA,"July03 Depr Expense","Accumulated Depreciation",76.92,NA,538.44
"4760","Depreciation Expense","General Journal","2018-08-31","DEPR9",NA,"Aug03 Depr Expense","Accumulated Depreciation",76.92,NA,615.36
"4761","Depreciation Expense","General Journal","2018-09-30","DEPR10",NA,"Sept03 Depr Expense","Accumulated Depreciation",76.92,NA,692.28
"4762","Depreciation Expense","General Journal","2018-10-31","DEPR11",NA,"Oct03 Depr Expense","Accumulated Depreciation",76.92,NA,769.2
"4763","Depreciation Expense","General Journal","2018-11-30","DEPR12",NA,"Nov03 Depr Expense","Accumulated Depreciation",76.92,NA,846.12
"4764","Depreciation Expense","General Journal","2018-12-31","DEPR13",NA,"Dec03 Depr Expense","Accumulated Depreciation",76.92,NA,923.04
"4767","Dues and Subscriptions","Check","2018-01-31","5027","Professional Association","Annual Dues","Company Checking Account",500,NA,500
"4768","Dues and Subscriptions","Check","2018-01-31","5028","Professional Association","Annual Dues","Company Checking Account",350,NA,850
"4769","Dues and Subscriptions","Check","2018-08-22","5201","Professional Subscriptions","Journal","Company Checking Account",350,NA,1200
"4770","Dues and Subscriptions","Check","2018-08-22","5204","Professional Subscriptions","Journal","Company Checking Account",350,NA,1550
"4771","Dues and Subscriptions","Check","2018-08-22","5205","Professional Subscriptions","Journal","Company Checking Account",350,NA,1900
"4777","Insurance","Check","2018-01-31","5026","Gretton Insurance Co.","Policy #14B09","Company Checking Account",230,NA,230
"4778","Insurance","Check","2018-02-05","5030","Gretton Insurance Co.","Policy #14B09","Company Checking Account",230,NA,460
"4779","Insurance","Check","2018-03-05","5061","Gretton Insurance Co.","Policy #14B09","Company Checking Account",230,NA,690
"4780","Insurance","Check","2018-04-04","5080","Gretton Insurance Co.","Policy #14B09","Company Checking Account",230,NA,920
"4781","Insurance","Check","2018-05-04","5108","Gretton Insurance Co.","Policy #14B09","Company Checking Account",230,NA,1150
"4782","Insurance","Check","2018-06-04","5137","Gretton Insurance Co.","Policy #14B09","Company Checking Account",230,NA,1380
"4783","Insurance","Check","2018-07-03","5162","Gretton Insurance Co.","Policy #14B09","Company Checking Account",230,NA,1610
"4784","Insurance","Check","2018-08-03","5192","Gretton Insurance Co.","Policy #14B09","Company Checking Account",230,NA,1840
"4785","Insurance","Check","2018-09-04","5222","Gretton Insurance Co.","Policy #14B09","Company Checking Account",230,NA,2070
"4786","Insurance","Check","2018-10-04","5246","Gretton Insurance Co.","Policy #14B09","Company Checking Account",230,NA,2300
"4787","Insurance","Check","2018-11-05","5272","Gretton Insurance Co.","Policy #14B09","Company Checking Account",230,NA,2530
"4788","Insurance","Check","2018-12-04","5297","Gretton Insurance Co.","Policy #14B09","Company Checking Account",230,NA,2760
"4793","Insurance","Check","2018-01-25","5017","Health Insurance Co.","Jan07","Company Checking Account",356,NA,356
"4794","Insurance","Check","2018-02-26","5048","Health Insurance Co.","Feb07","Company Checking Account",356,NA,712
"4795","Insurance","Check","2018-03-26","5073","Health Insurance Co.","Employee Health Insurance Policy#258BVF4","Company Checking Account",356,NA,1068
"4796","Insurance","Check","2018-04-25","5099","Health Insurance Co.","Petty Cash","Company Checking Account",356,NA,1424
"4797","Insurance","Check","2018-05-25","5125","Health Insurance Co.","July07","Company Checking Account",356,NA,1780
"4798","Insurance","Check","2018-06-25","5151","Health Insurance Co.","June07","Company Checking Account",356,NA,2136
"4799","Insurance","Check","2018-07-25","5180","Health Insurance Co.","Aug07","Company Checking Account",356,NA,2492
"4800","Insurance","Check","2018-08-24","5213","Health Insurance Co.","Employee Health Insurance Policy#258BVF4","Company Checking Account",356,NA,2848
"4801","Insurance","Check","2018-09-25","5235","Health Insurance Co.","Employee Health Insurance Policy#258BVF4","Company Checking Account",356,NA,3204
"4802","Insurance","Check","2018-10-25","5262","Health Insurance Co.","Oct07","Company Checking Account",356,NA,3560
"4803","Insurance","Check","2018-11-26","5288","Health Insurance Co.","Nov07","Company Checking Account",356,NA,3916
"4804","Insurance","Check","2018-12-27","5310","Health Insurance Co.","Dec07","Company Checking Account",356,NA,4272
"4807","Insurance","General Journal","2018-02-28","PPDIns",NA,"Feb 03  Ins. Expense","Prepaid Insurance",625,NA,625
"4808","Insurance","General Journal","2018-03-31","PPDIns",NA,"Mar 03  Ins. Expense","Prepaid Insurance",625,NA,1250
"4809","Insurance","General Journal","2018-04-30","PPDIns",NA,"Apr 03  Ins. Expense","Prepaid Insurance",625,NA,1875
"4810","Insurance","General Journal","2018-05-31","PPDIns",NA,"May 03  Ins. Expense","Prepaid Insurance",625,NA,2500
"4811","Insurance","General Journal","2018-06-30","PPDIns",NA,"June 03  Ins. Expense","Prepaid Insurance",625,NA,3125
"4812","Insurance","General Journal","2018-07-31","PPDIns",NA,"July 03  Ins. Expense","Prepaid Insurance",625,NA,3750
"4813","Insurance","General Journal","2018-08-31","PPDIns",NA,"Aug 03  Ins. Expense","Prepaid Insurance",625,NA,4375
"4814","Insurance","General Journal","2018-09-30","PPDIns",NA,"Sept 03  Ins. Expense","Prepaid Insurance",625,NA,5000
"4815","Insurance","General Journal","2018-10-31","PPDIns",NA,"Oct 03  Ins. Expense","Prepaid Insurance",625,NA,5625
"4816","Insurance","General Journal","2018-11-30","PPDIns",NA,"Nov 03  Ins. Expense","Prepaid Insurance",625,NA,6250
"4817","Insurance","General Journal","2018-12-31","PPDIns",NA,"Dec 03  Ins. Expense","Prepaid Insurance",625,NA,6875
"4820","Insurance","Check","2018-01-25","5013","Gretton Insurance Co.","Policy #87023","Company Checking Account",127.67,NA,127.67
"4821","Insurance","Check","2018-01-25","5013","Gretton Insurance Co.","Policy#87023","Company Checking Account",104.17,NA,231.84
"4822","Insurance","Check","2018-02-05","5030","Gretton Insurance Co.","Policy #87023","Company Checking Account",127.67,NA,359.51
"4823","Insurance","Check","2018-02-05","5030","Gretton Insurance Co.","Policy#87023","Company Checking Account",104.17,NA,463.68
"4824","Insurance","Check","2018-03-05","5061","Gretton Insurance Co.","Policy #87023","Company Checking Account",127.67,NA,591.35
"4825","Insurance","Check","2018-03-05","5061","Gretton Insurance Co.","Policy#87023","Company Checking Account",104.17,NA,695.52
"4826","Insurance","Check","2018-04-04","5080","Gretton Insurance Co.","Policy #87023","Company Checking Account",127.67,NA,823.19
"4827","Insurance","Check","2018-04-04","5080","Gretton Insurance Co.","Policy#87023","Company Checking Account",104.17,NA,927.36
"4828","Insurance","Check","2018-05-04","5108","Gretton Insurance Co.","Policy #87023","Company Checking Account",127.67,NA,1055.03
"4829","Insurance","Check","2018-05-04","5108","Gretton Insurance Co.","Policy#87023","Company Checking Account",104.17,NA,1159.2
"4830","Insurance","Check","2018-06-04","5137","Gretton Insurance Co.","Policy #87023","Company Checking Account",127.67,NA,1286.87
"4831","Insurance","Check","2018-06-04","5137","Gretton Insurance Co.","Policy#87023","Company Checking Account",104.17,NA,1391.04
"4832","Insurance","Check","2018-07-03","5162","Gretton Insurance Co.","Policy #87023","Company Checking Account",127.67,NA,1518.71
"4833","Insurance","Check","2018-07-03","5162","Gretton Insurance Co.","Policy#87023","Company Checking Account",104.17,NA,1622.88
"4834","Insurance","Check","2018-08-03","5192","Gretton Insurance Co.","Policy #87023","Company Checking Account",127.67,NA,1750.55
"4835","Insurance","Check","2018-08-03","5192","Gretton Insurance Co.","Policy#87023","Company Checking Account",104.17,NA,1854.72
"4836","Insurance","Check","2018-09-04","5222","Gretton Insurance Co.","Policy #87023","Company Checking Account",127.67,NA,1982.39
"4837","Insurance","Check","2018-09-04","5222","Gretton Insurance Co.","Policy#87023","Company Checking Account",104.17,NA,2086.56
"4838","Insurance","Check","2018-10-04","5246","Gretton Insurance Co.","Policy #87023","Company Checking Account",127.67,NA,2214.23
"4839","Insurance","Check","2018-10-04","5246","Gretton Insurance Co.","Policy#87023","Company Checking Account",104.17,NA,2318.4
"4840","Insurance","Check","2018-11-05","5272","Gretton Insurance Co.","Policy #87023","Company Checking Account",127.67,NA,2446.07
"4841","Insurance","Check","2018-11-05","5272","Gretton Insurance Co.","Policy#87023","Company Checking Account",104.17,NA,2550.24
"4842","Insurance","Check","2018-12-04","5297","Gretton Insurance Co.","Policy #87023","Company Checking Account",127.67,NA,2677.91
"4843","Insurance","Check","2018-12-04","5297","Gretton Insurance Co.","Policy#87023","Company Checking Account",104.17,NA,2782.08
"4849","Maintenance/Janitorial","Check","2018-01-31","5024","Jeff's Janitorial","Jan07","Company Checking Account",200,NA,200
"4850","Maintenance/Janitorial","Check","2018-02-28","5053","Jeff's Janitorial","Feb07","Company Checking Account",200,NA,400
"4851","Maintenance/Janitorial","Check","2018-03-30","5077","Jeff's Janitorial","Mar07","Company Checking Account",200,NA,600
"4852","Maintenance/Janitorial","Check","2018-04-23","5096","Jeff's Janitorial","supplies","Company Checking Account",157,NA,757
"4853","Maintenance/Janitorial","Check","2018-04-30","5106","Jeff's Janitorial","Apr07","Company Checking Account",200,NA,957
"4854","Maintenance/Janitorial","Check","2018-05-31","5131","Jeff's Janitorial","May07","Company Checking Account",200,NA,1157
"4855","Maintenance/Janitorial","Check","2018-06-29","5157","Jeff's Janitorial","June07","Company Checking Account",200,NA,1357
"4856","Maintenance/Janitorial","Check","2018-07-23","5173","Jeff's Janitorial","supplies","Company Checking Account",127.5,NA,1484.5
"4857","Maintenance/Janitorial","Check","2018-07-31","5188","Jeff's Janitorial","July07","Company Checking Account",200,NA,1684.5
"4858","Maintenance/Janitorial","Check","2018-08-31","5215","Jeff's Janitorial","Aug07","Company Checking Account",200,NA,1884.5
"4859","Maintenance/Janitorial","Check","2018-09-28","5240","Jeff's Janitorial","Sept07","Company Checking Account",200,NA,2084.5
"4860","Maintenance/Janitorial","Check","2018-10-22","5258","Jeff's Janitorial","supplies","Company Checking Account",157.45,NA,2241.95
"4861","Maintenance/Janitorial","Check","2018-10-31","5267","Jeff's Janitorial","Oct07","Company Checking Account",200,NA,2441.95
"4862","Maintenance/Janitorial","Check","2018-11-30","5293","Jeff's Janitorial","Nov07","Company Checking Account",200,NA,2641.95
"4863","Maintenance/Janitorial","Check","2018-12-31","5317","Jeff's Janitorial","Dec07","Company Checking Account",200,NA,2841.95
"4866","Marketing Expense","Bill","2018-04-02","156098","Printing Shop","Marketing materials","Accounts Payable",285,NA,285
"4867","Marketing Expense","Check","2018-08-20","5200","Winkon Public Relations","Annual Campaign","Company Checking Account",4500,NA,4785
"4868","Marketing Expense","Bill","2018-11-01","160321","Printing Shop","Marketing materials","Accounts Payable",197,NA,4982
"4871","Meals and Entertainment","Check","2018-01-25","5012","King, Vicki","Client lunch","Company Checking Account",55,NA,55
"4872","Meals and Entertainment","Check","2018-01-31","5023","Jonathan Graham (reimbursments)","13103 Expense Report","Company Checking Account",45.72,NA,100.72
"4873","Meals and Entertainment","Credit Card Charge","2018-02-12","CC","Jenny's Cafe","lunch with Jonathan","QuickBooks Credit Card",32.09,NA,132.81
"4874","Meals and Entertainment","Credit Card Charge","2018-02-18","1256935","Vin's Restaurant","Lunch with Crimson","QuickBooks Credit Card",56,NA,188.81
"4875","Meals and Entertainment","Check","2018-02-22","5038","Deborah Wood (Owner)","Petty Cash","Company Checking Account",77.47,NA,266.28
"4876","Meals and Entertainment","Credit Card Charge","2018-02-28","cc","Jenny's Cafe","lunch","QuickBooks Credit Card",35.97,NA,302.25
"4877","Meals and Entertainment","Credit Card Charge","2018-03-28","125385","Local Restaurant","Staff lunch with Society Corp","QuickBooks Credit Card",51,NA,353.25
"4878","Meals and Entertainment","Check","2018-04-23","5093","Jonathan Graham (reimbursments)","3103 Expense Report","Company Checking Account",27.08,NA,380.33
"4879","Meals and Entertainment","Check","2018-04-23","5089","King, Vicki","Client lunch","Company Checking Account",12.36,NA,392.69
"4880","Meals and Entertainment","Credit Card Charge","2018-04-28","cc","Jenny's Cafe","lunch","QuickBooks Credit Card",35.97,NA,428.66
"4881","Meals and Entertainment","Credit Card Charge","2018-05-20","cc","Jenny's Cafe","lunch brough in for everyone","QuickBooks Credit Card",80.09,NA,508.75
"4882","Meals and Entertainment","Check","2018-05-22","5118","Deborah Wood (Owner)","Petty Cash","Company Checking Account",91.47,NA,600.22
"4883","Meals and Entertainment","Check","2018-07-23","5170","Jonathan Graham (reimbursments)","63003 Expense Report","Company Checking Account",78.96,NA,679.18
"4884","Meals and Entertainment","Check","2018-07-23","5171","King, Vicki","63003 Exp Rpt","Company Checking Account",15.63,NA,694.81
"4885","Meals and Entertainment","Check","2018-07-23","5172","Deborah Wood (Owner)","63003 Exp Report","Company Checking Account",62.57,NA,757.38
"4886","Meals and Entertainment","Check","2018-08-22","5209","Deborah Wood (Owner)","Petty Cash","Company Checking Account",69.77,NA,827.15
"4887","Meals and Entertainment","Check","2018-10-22","5255","King, Vicki","93003 Exp Rpt","Company Checking Account",32.16,NA,859.31
"4888","Meals and Entertainment","Check","2018-10-22","5257","Deborah Wood (Owner)","93007 Expense Report","Company Checking Account",98.94,NA,958.25
"4889","Meals and Entertainment","Check","2018-11-22","5279","Jonathan Graham (reimbursments)","93003 Exp Rpt","Company Checking Account",58.96,NA,1017.21
"4890","Meals and Entertainment","Check","2018-11-22","5283","Deborah Wood (Owner)","Petty Cash","Company Checking Account",96.14,NA,1113.35
"4891","Meals and Entertainment","Credit Card Charge","2018-12-19","125963321","Local Restaurant","Company Holiday Party","QuickBooks Credit Card",263,NA,1376.35
"4894","Office Equipment","Check","2018-01-25","5015","Pace Shipping Supplies","postage meter rental","Company Checking Account",25,NA,25
"4895","Office Equipment","Check","2018-02-22","5042","Lincoln Office Equip.","Fax machine","Company Checking Account",450,NA,475
"4896","Office Equipment","Check","2018-02-26","5049","Pace Shipping Supplies","postage meter rental","Company Checking Account",25,NA,500
"4897","Office Equipment","Check","2018-03-26","5072","Pace Shipping Supplies","postage meter rental","Company Checking Account",25,NA,525
"4898","Office Equipment","Check","2018-04-25","5098","Pace Shipping Supplies","postage meter rental","Company Checking Account",25,NA,550
"4899","Office Equipment","Check","2018-05-25","5126","Pace Shipping Supplies","postage meter rental","Company Checking Account",25,NA,575
"4900","Office Equipment","Check","2018-06-22","5145","Lincoln Office Equip.","Printer","Company Checking Account",350,NA,925
"4901","Office Equipment","Check","2018-06-25","5153","Pace Shipping Supplies","postage meter rental","Company Checking Account",25,NA,950
"4902","Office Equipment","Check","2018-07-25","5181","Pace Shipping Supplies","postage meter rental","Company Checking Account",25,NA,975
"4903","Office Equipment","Check","2018-08-24","5211","Pace Shipping Supplies","postage meter rental","Company Checking Account",25,NA,1000
"4904","Office Equipment","Check","2018-09-25","5237","Pace Shipping Supplies","postage meter rental","Company Checking Account",25,NA,1025
"4905","Office Equipment","Check","2018-10-25","5263","Pace Shipping Supplies","postage meter rental","Company Checking Account",25,NA,1050
"4906","Office Equipment","Check","2018-11-26","5286","Pace Shipping Supplies","postage meter rental","Company Checking Account",25,NA,1075
"4907","Office Equipment","Check","2018-12-27","5311","Pace Shipping Supplies","postage meter rental","Company Checking Account",25,NA,1100
"4912","Postage and Delivery","Check","2018-01-22","5009","Fisse Fast Package Delivery","ACCT# 256044025","Company Checking Account",78,NA,78
"4913","Postage and Delivery","Check","2018-02-22","5045","Postmaster","postage","Company Checking Account",54,NA,132
"4914","Postage and Delivery","Check","2018-02-22","5046","Fisse Fast Package Delivery","ACCT# 256044025","Company Checking Account",78,NA,210
"4915","Postage and Delivery","Check","2018-03-22","5071","Fisse Fast Package Delivery","ACCT# 256044025","Company Checking Account",78,NA,288
"4916","Postage and Delivery","Check","2018-04-23","5097","Fisse Fast Package Delivery","ACCT# 256044025","Company Checking Account",78,NA,366
"4917","Postage and Delivery","Check","2018-05-22","5121","Fisse Fast Package Delivery","ACCT# 256044025","Company Checking Account",78,NA,444
"4918","Postage and Delivery","Check","2018-06-22","5146","Fisse Fast Package Delivery","ACCT# 256044025","Company Checking Account",78,NA,522
"4919","Postage and Delivery","Check","2018-07-23","5174","Fisse Fast Package Delivery","ACCT# 256044025","Company Checking Account",78,NA,600
"4920","Postage and Delivery","Check","2018-08-22","5207","Postmaster","postage","Company Checking Account",54,NA,654
"4921","Postage and Delivery","Check","2018-08-22","5208","Fisse Fast Package Delivery","ACCT# 256044025","Company Checking Account",78,NA,732
"4922","Postage and Delivery","Check","2018-09-21","5232","Fisse Fast Package Delivery","ACCT# 256044025","Company Checking Account",78,NA,810
"4923","Postage and Delivery","Check","2018-10-22","5259","Fisse Fast Package Delivery","ACCT# 256044025","Company Checking Account",78,NA,888
"4924","Postage and Delivery","Check","2018-11-22","5284","Postmaster","postage","Company Checking Account",54,NA,942
"4925","Postage and Delivery","Check","2018-11-22","5282","Fisse Fast Package Delivery","ACCT# 256044025","Company Checking Account",78,NA,1020
"4926","Postage and Delivery","Check","2018-12-21","5308","Fisse Fast Package Delivery","ACCT# 256044025","Company Checking Account",78,NA,1098
"4934","Professional Fees","Check","2018-01-01","5000","Online Accounting","Set up QuickBooks file","Company Checking Account",225,NA,225
"4935","Professional Fees","Credit Card Charge","2018-04-15","cc","Online Accounting","Quarterly checkup","QuickBooks Credit Card",255,NA,480
"4936","Professional Fees","Check","2018-05-22","5119","Accounting Firm","2006 Tax Returns","Company Checking Account",1554,NA,2034
"4937","Professional Fees","Credit Card Charge","2018-07-15","cc","Online Accounting","Quarterly checkup","QuickBooks Credit Card",255,NA,2289
"4938","Professional Fees","Credit Card Charge","2018-10-15","cc","Online Accounting","Quarterly checkup","QuickBooks Credit Card",255,NA,2544
"4941","Professional Fees","Check","2018-02-22","5040","Legal Firm","ACCT#400259","Company Checking Account",400,NA,400
"4942","Professional Fees","Check","2018-09-21","5230","Legal Firm","ACCT#400259","Company Checking Account",200,NA,600
"4945","Professional Fees","Check","2018-01-25","5014","Payroll Service Co.","Jan Payroll Fee","Company Checking Account",127.08,NA,127.08
"4946","Professional Fees","Check","2018-02-26","5050","Payroll Service Co.","Payroll Fee","Company Checking Account",132,NA,259.08
"4947","Professional Fees","Check","2018-03-26","5074","Payroll Service Co."," Payroll Fee","Company Checking Account",135.6,NA,394.68
"4948","Professional Fees","Check","2018-04-26","5101","Payroll Service Co."," Payroll Fee","Company Checking Account",142,NA,536.68
"4949","Professional Fees","Check","2018-05-25","5127","Payroll Service Co."," Payroll Fee","Company Checking Account",129,NA,665.68
"4950","Professional Fees","Check","2018-06-25","5152","Payroll Service Co."," Payroll Fee","Company Checking Account",123.08,NA,788.76
"4951","Professional Fees","Check","2018-07-25","5183","Payroll Service Co."," Payroll Fee","Company Checking Account",124.08,NA,912.84
"4952","Professional Fees","Check","2018-08-24","5212","Payroll Service Co."," Payroll Fee","Company Checking Account",123.08,NA,1035.92
"4953","Professional Fees","Check","2018-09-24","5234","Payroll Service Co."," Payroll Fee","Company Checking Account",123.08,NA,1159
"4954","Professional Fees","Check","2018-10-25","5264","Payroll Service Co."," Payroll Fee","Company Checking Account",124.08,NA,1283.08
"4955","Professional Fees","Check","2018-11-26","5289","Payroll Service Co."," Payroll Fee","Company Checking Account",123.08,NA,1406.16
"4956","Professional Fees","Check","2018-12-27","5312","Payroll Service Co."," Payroll Fee","Company Checking Account",123.08,NA,1529.24
"4962","Promotional Expense","Credit Card Charge","2018-01-07","1269875","Randy's Floral","gift for client","QuickBooks Credit Card",355,NA,355
"4963","Promotional Expense","Bill","2018-02-03","15687","Printing Shop","Promotional flyers that go in boxes","Accounts Payable",156,NA,511
"4964","Promotional Expense","Bill","2018-07-01","159087","Printing Shop","Fall marketing materials","Accounts Payable",675,NA,1186
"4965","Promotional Expense","Bill","2018-08-01","159008","Printing Shop","2nd half of fall promotional materials","Accounts Payable",835,NA,2021
"4968","Rent","Check","2018-01-01","5001","Kuver Property","January Rent","Company Checking Account",583.75,NA,583.75
"4969","Rent","Check","2018-02-01","5029","Kuver Property","Office Rent","Company Checking Account",583.75,NA,1167.5
"4970","Rent","Check","2018-03-01","5059","Kuver Property","Office Rent","Company Checking Account",583.75,NA,1751.25
"4971","Rent","Check","2018-04-02","5079","Kuver Property","Office Rent","Company Checking Account",583.75,NA,2335
"4972","Rent","Check","2018-05-01","5107","Kuver Property","Office Rent","Company Checking Account",583.75,NA,2918.75
"4973","Rent","Check","2018-06-01","5135","Kuver Property","Office Rent","Company Checking Account",583.75,NA,3502.5
"4974","Rent","Check","2018-07-02","5160","Kuver Property","Office Rent","Company Checking Account",583.75,NA,4086.25
"4975","Rent","Check","2018-08-01","5190","Kuver Property","Office Rent","Company Checking Account",583.75,NA,4670
"4976","Rent","Check","2018-09-03","5220","Kuver Property","Office Rent","Company Checking Account",583.75,NA,5253.75
"4977","Rent","Check","2018-10-01","5244","Kuver Property","Office Rent","Company Checking Account",583.75,NA,5837.5
"4978","Rent","Check","2018-11-01","5270","Kuver Property","Office Rent","Company Checking Account",583.75,NA,6421.25
"4979","Rent","Check","2018-12-03","5295","Kuver Property","Office Rent","Company Checking Account",583.75,NA,7005
"4983","Repairs","Check","2018-07-25","5178","Electronics & Computer Store","Computer repair","Company Checking Account",390,NA,390
"4991","Supplies","Check","2018-01-22","5011","Office Supply Store","INV# 1420","Company Checking Account",634.21,NA,634.21
"4992","Supplies","Credit Card Charge","2018-01-28","1256831","Business Supply Center","ink cartridges","QuickBooks Credit Card",18.15,NA,652.36
"4993","Supplies","Check","2018-02-22","5044","Office Supply Store","INV# 1781","Company Checking Account",223.56,NA,875.92
"4994","Supplies","Check","2018-02-22","5038","Deborah Wood (Owner)","Petty Cash","Company Checking Account",327.51,NA,1203.43
"4995","Supplies","Credit Card Charge","2018-03-12",NA,"Norton Discount Warehouse",NA,"QuickBooks Credit Card",631.23,NA,1834.66
"4996","Supplies","Check","2018-03-22","5069","Office Supply Store","INV# 1952","Company Checking Account",452.13,NA,2286.79
"4997","Supplies","Credit Card Charge","2018-04-12",NA,"Electronics & Computer Store","computer supplies","QuickBooks Credit Card",65.2,NA,2351.99
"4998","Supplies","Credit Card Charge","2018-04-17","1256931",NA,"paper","QuickBooks Credit Card",23.6,NA,2375.59
"4999","Supplies","Check","2018-04-23","5090","Office Supply Store","INV# 2135","Company Checking Account",120,NA,2495.59
"5000","Supplies","Check","2018-04-23","5089","King, Vicki",NA,"Company Checking Account",26.13,NA,2521.72
"5001","Supplies","Credit Card Charge","2018-04-26",NA,"Local Market","kitchen supplies","QuickBooks Credit Card",54.95,NA,2576.67
"5002","Supplies","Bill","2018-04-30","155098","Printing Shop","Business cards for new sales reps","Accounts Payable",160,NA,2736.67
"5003","Supplies","Credit Card Charge","2018-05-12","8752361","Randy's Floral","employee flowers","QuickBooks Credit Card",65,NA,2801.67
"5004","Supplies","Check","2018-05-22","5118","Deborah Wood (Owner)","Petty Cash","Company Checking Account",369.21,NA,3170.88
"5005","Supplies","Check","2018-05-23","5122","Office Supply Store","INV# 2256","Company Checking Account",327.16,NA,3498.04
"5006","Supplies","Credit Card Charge","2018-06-23",NA,"Electronics & Computer Store","computer supplies","QuickBooks Credit Card",23.6,NA,3521.64
"5007","Supplies","Check","2018-06-25","5149","Office Supply Store","INV# 2378","Company Checking Account",123.54,NA,3645.18
"5008","Supplies","Credit Card Charge","2018-07-04",NA,"Electronics & Computer Store","computer supplies","QuickBooks Credit Card",98.21,NA,3743.39
"5009","Supplies","Credit Card Charge","2018-07-12",NA,"Ken Chen Coffee","coffee","QuickBooks Credit Card",23.9,NA,3767.29
"5010","Supplies","Check","2018-07-23","5175","Office Supply Store","INV# 2421","Company Checking Account",78.65,NA,3845.94
"5011","Supplies","Credit Card Charge","2018-08-06",NA,"Ken Chen Coffee","coffee","QuickBooks Credit Card",23.9,NA,3869.84
"5012","Supplies","Credit Card Charge","2018-08-10",NA,"Electronics & Computer Store","computer supplies","QuickBooks Credit Card",42.13,NA,3911.97
"5013","Supplies","Check","2018-08-22","5202","Office Supply Store","INV# 2497","Company Checking Account",125.47,NA,4037.44
"5014","Supplies","Check","2018-08-22","5209","Deborah Wood (Owner)","Petty Cash","Company Checking Account",345.12,NA,4382.56
"5015","Supplies","Credit Card Charge","2018-09-10",NA,"Local Market","kitchen supplies","QuickBooks Credit Card",78.41,NA,4460.97
"5016","Supplies","Credit Card Charge","2018-09-10","7/15/03","Local Market","kitchen supplies","QuickBooks Credit Card",54.98,NA,4515.95
"5017","Supplies","Credit Card Charge","2018-09-12","12369523","Local Market","kitchen supplies","QuickBooks Credit Card",65.21,NA,4581.16
"5018","Supplies","Credit Card Charge","2018-09-12",NA,"Electronics & Computer Store","computer supplies","QuickBooks Credit Card",23.21,NA,4604.37
"5019","Supplies","Check","2018-09-24","5233","Office Supply Store","INV# 2641","Company Checking Account",222.36,NA,4826.73
"5020","Supplies","Credit Card Charge","2018-10-05","1236952","Office Supply Store","supplies","QuickBooks Credit Card",97.23,NA,4923.96
"5021","Supplies","Credit Card Charge","2018-10-10",NA,"Electronics & Computer Store","computer supplies","QuickBooks Credit Card",75.12,NA,4999.08
"5022","Supplies","Check","2018-10-24","5260","Office Supply Store","INV# 2725","Company Checking Account",141.67,NA,5140.75
"5023","Supplies","Credit Card Charge","2018-11-04",NA,"Electronics & Computer Store","computer supplies","QuickBooks Credit Card",39.58,NA,5180.33
"5024","Supplies","Check","2018-11-22","5283","Deborah Wood (Owner)","Petty Cash","Company Checking Account",249.86,NA,5430.19
"5025","Supplies","Check","2018-11-23","5285","Office Supply Store","INV# 2863","Company Checking Account",123.23,NA,5553.42
"5026","Supplies","Credit Card Charge","2018-11-24",NA,"Ken Chen Coffee","coffee","QuickBooks Credit Card",23.9,NA,5577.32
"5027","Supplies","Credit Card Charge","2018-11-24",NA,"Randy's Floral","holiday decorations","QuickBooks Credit Card",78,NA,5655.32
"5028","Supplies","Credit Card Charge","2018-11-26","2356289","Cecil's Lockworks","new keys","QuickBooks Credit Card",26,NA,5681.32
"5029","Supplies","Bill","2018-12-15","15789","Printing Shop","Letterhead and cards","Accounts Payable",340,NA,6021.32
"5030","Supplies","Check","2018-12-20","5306","Office Supply Store","INV# 2951","Company Checking Account",52.63,NA,6073.95
"5031","Supplies","Credit Card Charge","2018-12-27",NA,"Electronics & Computer Store","computer supplies","QuickBooks Credit Card",125.41,NA,6199.36
"5034","Telephone","Check","2018-01-22","5010","Local Phone Company","6503221414","Company Checking Account",253,NA,253
"5035","Telephone","Check","2018-01-22","5008","Cell Phone Company","cell","Company Checking Account",101.18,NA,354.18
"5036","Telephone","Check","2018-01-31","5023","Jonathan Graham (reimbursments)","13103 Expense Report","Company Checking Account",50.2,NA,404.38
"5037","Telephone","Check","2018-02-22","5041","Local Phone Company","6503221414","Company Checking Account",221.47,NA,625.85
"5038","Telephone","Check","2018-02-23","5047","Cell Phone Company","cell","Company Checking Account",98.67,NA,724.52
"5039","Telephone","Check","2018-03-22","5068","Cell Phone Company","cell","Company Checking Account",101.57,NA,826.09
"5040","Telephone","Check","2018-03-22","5070","Local Phone Company","6503221414","Company Checking Account",211.56,NA,1037.65
"5041","Telephone","Check","2018-04-23","5091","Cell Phone Company","cell","Company Checking Account",100.23,NA,1137.88
"5042","Telephone","Check","2018-04-23","5094","Local Phone Company","6503221414","Company Checking Account",203.56,NA,1341.44
"5043","Telephone","Check","2018-04-23","5093","Jonathan Graham (reimbursments)","3103 Expense Report","Company Checking Account",10.32,NA,1351.76
"5044","Telephone","Check","2018-04-23","5095","Deborah Wood (Owner)","33103 Exp Report","Company Checking Account",74.63,NA,1426.39
"5045","Telephone","Check","2018-05-22","5120","Cell Phone Company","cell","Company Checking Account",107.45,NA,1533.84
"5046","Telephone","Check","2018-05-22","5117","Local Phone Company","6503221414","Company Checking Account",197.25,NA,1731.09
"5047","Telephone","Check","2018-06-22","5148","Local Phone Company","6503221414","Company Checking Account",221.32,NA,1952.41
"5048","Telephone","Check","2018-06-25","5150","Cell Phone Company","cell","Company Checking Account",101.78,NA,2054.19
"5049","Telephone","Check","2018-07-23","5168","Cell Phone Company","cell","Company Checking Account",105.45,NA,2159.64
"5050","Telephone","Check","2018-07-23","5169","Local Phone Company","6503221414","Company Checking Account",219.45,NA,2379.09
"5051","Telephone","Check","2018-07-23","5170","Jonathan Graham (reimbursments)","63003 Expense Report","Company Checking Account",39.73,NA,2418.82
"5052","Telephone","Check","2018-07-23","5172","Deborah Wood (Owner)","63003 Exp Report","Company Checking Account",23.67,NA,2442.49
"5053","Telephone","Check","2018-08-22","5203","Local Phone Company","6503221414","Company Checking Account",213.56,NA,2656.05
"5054","Telephone","Check","2018-08-23","5210","Cell Phone Company","cell","Company Checking Account",99.63,NA,2755.68
"5055","Telephone","Check","2018-09-21","5231","Cell Phone Company","cell","Company Checking Account",102.87,NA,2858.55
"5056","Telephone","Check","2018-09-21","5229","Local Phone Company","6503221414","Company Checking Account",200.69,NA,3059.24
"5057","Telephone","Check","2018-10-22","5254","Cell Phone Company","cell","Company Checking Account",101.32,NA,3160.56
"5058","Telephone","Check","2018-10-22","5256","Local Phone Company","6503221414","Company Checking Account",211.36,NA,3371.92
"5059","Telephone","Check","2018-10-22","5257","Deborah Wood (Owner)","93007 Expense Report","Company Checking Account",21,NA,3392.92
"5060","Telephone","Check","2018-11-22","5280","Cell Phone Company","cell","Company Checking Account",100.45,NA,3493.37
"5061","Telephone","Check","2018-11-22","5281","Local Phone Company","6503221414","Company Checking Account",203.03,NA,3696.4
"5062","Telephone","Check","2018-11-22","5279","Jonathan Graham (reimbursments)","93003 Exp Rpt","Company Checking Account",15.23,NA,3711.63
"5063","Telephone","Check","2018-12-19","5305","Local Phone Company","6503221414","Company Checking Account",187.23,NA,3898.86
"5064","Telephone","Check","2018-12-20","5307","Cell Phone Company","cell","Company Checking Account",104.58,NA,4003.44
"5067","Travel","Check","2018-01-25","5016","Deborah Wood (Owner)","13103 Exp Report","Company Checking Account",55.23,NA,55.23
"5068","Travel","Check","2018-04-23","5095","Deborah Wood (Owner)","33103 Expense Report","Company Checking Account",140,NA,195.23
"5069","Travel","Check","2018-05-31","5134","Jonathan Graham (reimbursments)","Seminar Travel","Company Checking Account",191,NA,386.23
"5070","Travel","Check","2018-06-22","5147","Mullen Travel","convention","Company Checking Account",833.33,NA,1219.56
"5071","Travel","Check","2018-06-22","5147","Mullen Travel","convention","Company Checking Account",833.33,NA,2052.89
"5072","Travel","Check","2018-06-22","5147","Mullen Travel","convention","Company Checking Account",833.34,NA,2886.23
"5073","Travel","Check","2018-07-23","5172","Deborah Wood (Owner)","63003 Expense Report","Company Checking Account",75,NA,2961.23
"5074","Travel","Check","2018-09-28","5243","King, Vicki","Seminar Travel","Company Checking Account",191,NA,3152.23
"5075","Travel","Check","2018-10-22","5257","Deborah Wood (Owner)","93007 Expense Report","Company Checking Account",300,NA,3452.23
"5078","Utilities","Check","2018-01-08","5003","Gas & Electic Company","ACCT# 098703","Company Checking Account",65.08,NA,65.08
"5079","Utilities","Check","2018-02-07","5032","Gas & Electic Company","ACCT# 098703","Company Checking Account",55.08,NA,120.16
"5080","Utilities","Check","2018-03-08","5062","Gas & Electic Company","ACCT# 098703","Company Checking Account",48.08,NA,168.24
"5081","Utilities","Check","2018-04-09","5082","Gas & Electic Company","ACCT# 098703","Company Checking Account",25.12,NA,193.36
"5082","Utilities","Check","2018-05-08","5110","Gas & Electic Company","ACCT# 098703","Company Checking Account",22.1,NA,215.46
"5083","Utilities","Check","2018-06-12","5139","Gas & Electic Company","ACCT# 098703","Company Checking Account",22.07,NA,237.53
"5084","Utilities","Check","2018-07-12","5164","Gas & Electic Company","ACCT# 098703","Company Checking Account",28.47,NA,266
"5085","Utilities","Check","2018-08-07","5193","Gas & Electic Company","ACCT# 098703","Company Checking Account",29.47,NA,295.47
"5086","Utilities","Check","2018-09-07","5223","Gas & Electic Company","ACCT# 098703","Company Checking Account",30.54,NA,326.01
"5087","Utilities","Check","2018-10-08","5247","Gas & Electic Company","ACCT# 098703","Company Checking Account",32.9,NA,358.91
"5088","Utilities","Check","2018-11-07","5273","Gas & Electic Company","ACCT# 098703","Company Checking Account",67.08,NA,425.99
"5089","Utilities","Check","2018-12-07","5299","Gas & Electic Company","ACCT# 098703","Company Checking Account",75.6,NA,501.59
"5093","Wages","Check","2018-01-25","5017","Health Insurance Co.","Jan07","Company Checking Account",187.83,NA,187.83
"5094","Wages","Check","2018-02-26","5048","Health Insurance Co.","Feb07","Company Checking Account",187.83,NA,375.66
"5095","Wages","Check","2018-03-26","5073","Health Insurance Co.","Mar07","Company Checking Account",187.83,NA,563.49
"5096","Wages","Check","2018-04-25","5099","Health Insurance Co.","Apr07","Company Checking Account",187.83,NA,751.32
"5097","Wages","Check","2018-05-25","5125","Health Insurance Co.","May07","Company Checking Account",187.83,NA,939.15
"5098","Wages","Check","2018-06-25","5151","Health Insurance Co.","June07","Company Checking Account",187.83,NA,1126.98
"5099","Wages","Check","2018-07-25","5180","Health Insurance Co.","Aug07","Company Checking Account",187.83,NA,1314.81
"5100","Wages","Check","2018-08-24","5213","Health Insurance Co.","Aug07","Company Checking Account",187.83,NA,1502.64
"5101","Wages","Check","2018-09-25","5235","Health Insurance Co.","Sep07","Company Checking Account",187.83,NA,1690.47
"5102","Wages","Check","2018-10-25","5262","Health Insurance Co.","Oct07","Company Checking Account",187.83,NA,1878.3
"5103","Wages","Check","2018-11-26","5288","Health Insurance Co.","Nov07","Company Checking Account",187.83,NA,2066.13
"5104","Wages","Check","2018-12-27","5310","Health Insurance Co.","Dec07","Company Checking Account",187.83,NA,2253.96
"5110","Wages","Paycheck","2018-01-15","3003","Bolinski, Rafal",NA,"Company Checking Account",27.69,NA,27.69
"5111","Wages","Paycheck","2018-01-15","3003","Bolinski, Rafal",NA,"Company Checking Account",6.53,NA,34.22
"5112","Wages","Paycheck","2018-01-15","3003","Bolinski, Rafal",NA,"Company Checking Account",35.78,NA,70
"5113","Wages","Paycheck","2018-01-15","3003","Bolinski, Rafal",NA,"Company Checking Account",0,NA,70
"5114","Wages","Paycheck","2018-01-15","3003","Bolinski, Rafal",NA,"Company Checking Account",0,NA,70
"5115","Wages","Paycheck","2018-01-15","3004","Deen, Jeannette",NA,"Company Checking Account",21.07,NA,91.07
"5116","Wages","Paycheck","2018-01-15","3004","Deen, Jeannette",NA,"Company Checking Account",4.97,NA,96.04
"5117","Wages","Paycheck","2018-01-15","3004","Deen, Jeannette",NA,"Company Checking Account",27.23,NA,123.27
"5118","Wages","Paycheck","2018-01-15","3001","King, Vicki",NA,"Company Checking Account",21.7,NA,144.97
"5119","Wages","Paycheck","2018-01-15","3001","King, Vicki",NA,"Company Checking Account",5.08,NA,150.05
"5120","Wages","Paycheck","2018-01-15","3001","King, Vicki",NA,"Company Checking Account",28,NA,178.05
"5121","Wages","Paycheck","2018-02-01","3005","Bolinski, Rafal",NA,"Company Checking Account",0,NA,178.05
"5122","Wages","Paycheck","2018-02-01","3005","Bolinski, Rafal",NA,"Company Checking Account",0,NA,178.05
"5123","Wages","Paycheck","2018-02-01","3005","Bolinski, Rafal",NA,"Company Checking Account",0,NA,178.05
"5124","Wages","Paycheck","2018-02-01","3005","Bolinski, Rafal",NA,"Company Checking Account",0,NA,178.05
"5125","Wages","Paycheck","2018-02-01","3005","Bolinski, Rafal",NA,"Company Checking Account",0,NA,178.05
"5126","Wages","Paycheck","2018-02-01","3006","Deen, Jeannette",NA,"Company Checking Account",21.07,NA,199.12
"5127","Wages","Paycheck","2018-02-01","3006","Deen, Jeannette",NA,"Company Checking Account",4.97,NA,204.09
"5128","Wages","Paycheck","2018-02-01","3006","Deen, Jeannette",NA,"Company Checking Account",27.23,NA,231.32
"5129","Wages","Paycheck","2018-02-01","3004","King, Vicki",NA,"Company Checking Account",21.7,NA,253.02
"5130","Wages","Paycheck","2018-02-01","3004","King, Vicki",NA,"Company Checking Account",5.08,NA,258.1
"5131","Wages","Paycheck","2018-02-01","3004","King, Vicki",NA,"Company Checking Account",28,NA,286.1
"5132","Wages","Paycheck","2018-02-15","3006","King, Vicki",NA,"Company Checking Account",21.7,NA,307.8
"5133","Wages","Paycheck","2018-02-15","3006","King, Vicki",NA,"Company Checking Account",5.08,NA,312.88
"5134","Wages","Paycheck","2018-02-15","3006","King, Vicki",NA,"Company Checking Account",28,NA,340.88
"5135","Wages","Paycheck","2018-02-15","3007","Bolinski, Rafal",NA,"Company Checking Account",27.69,NA,368.57
"5136","Wages","Paycheck","2018-02-15","3007","Bolinski, Rafal",NA,"Company Checking Account",6.53,NA,375.1
"5137","Wages","Paycheck","2018-02-15","3007","Bolinski, Rafal",NA,"Company Checking Account",35.79,NA,410.89
"5138","Wages","Paycheck","2018-02-15","3007","Bolinski, Rafal",NA,"Company Checking Account",0,NA,410.89
"5139","Wages","Paycheck","2018-02-15","3007","Bolinski, Rafal",NA,"Company Checking Account",0,NA,410.89
"5140","Wages","Paycheck","2018-02-15","3008","Deen, Jeannette",NA,"Company Checking Account",105,NA,515.89
"5141","Wages","Paycheck","2018-02-15","3008","Deen, Jeannette",NA,"Company Checking Account",21.07,NA,536.96
"5142","Wages","Paycheck","2018-02-15","3008","Deen, Jeannette",NA,"Company Checking Account",27.23,NA,564.19
"5143","Wages","Paycheck","2018-03-01","3009","Bolinski, Rafal",NA,"Company Checking Account",27.69,NA,591.88
"5144","Wages","Paycheck","2018-03-01","3009","Bolinski, Rafal",NA,"Company Checking Account",6.53,NA,598.41
"5145","Wages","Paycheck","2018-03-01","3009","Bolinski, Rafal",NA,"Company Checking Account",35.79,NA,634.2
"5146","Wages","Paycheck","2018-03-01","3009","Bolinski, Rafal",NA,"Company Checking Account",0,NA,634.2
"5147","Wages","Paycheck","2018-03-01","3009","Bolinski, Rafal",NA,"Company Checking Account",0,NA,634.2
"5148","Wages","Paycheck","2018-03-01","3010","Deen, Jeannette",NA,"Company Checking Account",21.07,NA,655.27
"5149","Wages","Paycheck","2018-03-01","3010","Deen, Jeannette",NA,"Company Checking Account",4.97,NA,660.24
"5150","Wages","Paycheck","2018-03-01","3010","Deen, Jeannette",NA,"Company Checking Account",27.23,NA,687.47
"5151","Wages","Paycheck","2018-03-01","3008","King, Vicki",NA,"Company Checking Account",21.7,NA,709.17
"5152","Wages","Paycheck","2018-03-01","3008","King, Vicki",NA,"Company Checking Account",5.08,NA,714.25
"5153","Wages","Paycheck","2018-03-01","3008","King, Vicki",NA,"Company Checking Account",28,NA,742.25
"5154","Wages","Paycheck","2018-03-15","3010","King, Vicki",NA,"Company Checking Account",21.7,NA,763.95
"5155","Wages","Paycheck","2018-03-15","3010","King, Vicki",NA,"Company Checking Account",5.08,NA,769.03
"5156","Wages","Paycheck","2018-03-15","3010","King, Vicki",NA,"Company Checking Account",28,NA,797.03
"5157","Wages","Paycheck","2018-03-15","3011","Bolinski, Rafal",NA,"Company Checking Account",27.69,NA,824.72
"5158","Wages","Paycheck","2018-03-15","3011","Bolinski, Rafal",NA,"Company Checking Account",6.53,NA,831.25
"5159","Wages","Paycheck","2018-03-15","3011","Bolinski, Rafal",NA,"Company Checking Account",35.79,NA,867.04
"5160","Wages","Paycheck","2018-03-15","3011","Bolinski, Rafal",NA,"Company Checking Account",0,NA,867.04
"5161","Wages","Paycheck","2018-03-15","3011","Bolinski, Rafal",NA,"Company Checking Account",0,NA,867.04
"5162","Wages","Paycheck","2018-03-15","3012","Deen, Jeannette",NA,"Company Checking Account",21.07,NA,888.11
"5163","Wages","Paycheck","2018-03-15","3012","Deen, Jeannette",NA,"Company Checking Account",4.97,NA,893.08
"5164","Wages","Paycheck","2018-03-15","3012","Deen, Jeannette",NA,"Company Checking Account",27.23,NA,920.31
"5165","Wages","Paycheck","2018-04-02","3013","Bolinski, Rafal",NA,"Company Checking Account",27.69,NA,948
"5166","Wages","Paycheck","2018-04-02","3013","Bolinski, Rafal",NA,"Company Checking Account",6.53,NA,954.53
"5167","Wages","Paycheck","2018-04-02","3013","Bolinski, Rafal",NA,"Company Checking Account",35.79,NA,990.32
"5168","Wages","Paycheck","2018-04-02","3013","Bolinski, Rafal",NA,"Company Checking Account",0,NA,990.32
"5169","Wages","Paycheck","2018-04-02","3013","Bolinski, Rafal",NA,"Company Checking Account",0,NA,990.32
"5170","Wages","Paycheck","2018-04-02","3014","Deen, Jeannette",NA,"Company Checking Account",21.07,NA,1011.39
"5171","Wages","Paycheck","2018-04-02","3014","Deen, Jeannette",NA,"Company Checking Account",4.97,NA,1016.36
"5172","Wages","Paycheck","2018-04-02","3014","Deen, Jeannette",NA,"Company Checking Account",27.23,NA,1043.59
"5173","Wages","Paycheck","2018-04-02","3012","King, Vicki",NA,"Company Checking Account",21.7,NA,1065.29
"5174","Wages","Paycheck","2018-04-02","3012","King, Vicki",NA,"Company Checking Account",5.08,NA,1070.37
"5175","Wages","Paycheck","2018-04-02","3012","King, Vicki",NA,"Company Checking Account",28,NA,1098.37
"5176","Wages","Paycheck","2018-04-15","3015","Bolinski, Rafal",NA,"Company Checking Account",27.69,NA,1126.06
"5177","Wages","Paycheck","2018-04-15","3015","Bolinski, Rafal",NA,"Company Checking Account",6.53,NA,1132.59
"5178","Wages","Paycheck","2018-04-15","3015","Bolinski, Rafal",NA,"Company Checking Account",35.79,NA,1168.38
"5179","Wages","Paycheck","2018-04-15","3015","Bolinski, Rafal",NA,"Company Checking Account",0,NA,1168.38
"5180","Wages","Paycheck","2018-04-15","3015","Bolinski, Rafal",NA,"Company Checking Account",0,NA,1168.38
"5181","Wages","Paycheck","2018-04-15","3016","Deen, Jeannette",NA,"Company Checking Account",21.07,NA,1189.45
"5182","Wages","Paycheck","2018-04-15","3016","Deen, Jeannette",NA,"Company Checking Account",4.97,NA,1194.42
"5183","Wages","Paycheck","2018-04-15","3016","Deen, Jeannette",NA,"Company Checking Account",27.23,NA,1221.65
"5184","Wages","Paycheck","2018-04-16","3014","King, Vicki",NA,"Company Checking Account",13,NA,1234.65
"5185","Wages","Paycheck","2018-04-16","3014","King, Vicki",NA,"Company Checking Account",3.07,NA,1237.72
"5186","Wages","Paycheck","2018-04-16","3014","King, Vicki",NA,"Company Checking Account",16.8,NA,1254.52
"5187","Wages","Paycheck","2018-05-01","3017","Bolinski, Rafal",NA,"Company Checking Account",27.69,NA,1282.21
"5188","Wages","Paycheck","2018-05-01","3017","Bolinski, Rafal",NA,"Company Checking Account",6.53,NA,1288.74
"5189","Wages","Paycheck","2018-05-01","3017","Bolinski, Rafal",NA,"Company Checking Account",7.78,NA,1296.52
"5190","Wages","Paycheck","2018-05-01","3017","Bolinski, Rafal",NA,"Company Checking Account",0,NA,1296.52
"5191","Wages","Paycheck","2018-05-01","3017","Bolinski, Rafal",NA,"Company Checking Account",0,NA,1296.52
"5192","Wages","Paycheck","2018-05-01","3018","Deen, Jeannette",NA,"Company Checking Account",21.07,NA,1317.59
"5193","Wages","Paycheck","2018-05-01","3018","Deen, Jeannette",NA,"Company Checking Account",4.97,NA,1322.56
"5194","Wages","Paycheck","2018-05-01","3018","Deen, Jeannette",NA,"Company Checking Account",27.23,NA,1349.79
"5195","Wages","Paycheck","2018-05-01","3016","King, Vicki",NA,"Company Checking Account",13,NA,1362.79
"5196","Wages","Paycheck","2018-05-01","3016","King, Vicki",NA,"Company Checking Account",3.07,NA,1365.86
"5197","Wages","Paycheck","2018-05-01","3016","King, Vicki",NA,"Company Checking Account",16.8,NA,1382.66
"5198","Wages","Paycheck","2018-05-15","3019","Bolinski, Rafal",NA,"Company Checking Account",27.69,NA,1410.35
"5199","Wages","Paycheck","2018-05-15","3019","Bolinski, Rafal",NA,"Company Checking Account",6.53,NA,1416.88
"5200","Wages","Paycheck","2018-05-15","3019","Bolinski, Rafal",NA,"Company Checking Account",35.79,NA,1452.67
"5201","Wages","Paycheck","2018-05-15","3019","Bolinski, Rafal",NA,"Company Checking Account",0,NA,1452.67
"5202","Wages","Paycheck","2018-05-15","3019","Bolinski, Rafal",NA,"Company Checking Account",0,NA,1452.67
"5203","Wages","Paycheck","2018-05-15","3020","Deen, Jeannette",NA,"Company Checking Account",21.07,NA,1473.74
"5204","Wages","Paycheck","2018-05-15","3020","Deen, Jeannette",NA,"Company Checking Account",4.97,NA,1478.71
"5205","Wages","Paycheck","2018-05-15","3020","Deen, Jeannette",NA,"Company Checking Account",27.33,NA,1506.04
"5206","Wages","Paycheck","2018-05-15","3018","King, Vicki",NA,"Company Checking Account",13,NA,1519.04
"5207","Wages","Paycheck","2018-05-15","3018","King, Vicki",NA,"Company Checking Account",3.07,NA,1522.11
"5208","Wages","Paycheck","2018-05-15","3018","King, Vicki",NA,"Company Checking Account",16.8,NA,1538.91
"5209","Wages","Paycheck","2018-06-01","3020","King, Vicki",NA,"Company Checking Account",13,NA,1551.91
"5210","Wages","Paycheck","2018-06-01","3020","King, Vicki",NA,"Company Checking Account",3.07,NA,1554.98
"5211","Wages","Paycheck","2018-06-01","3020","King, Vicki",NA,"Company Checking Account",16.8,NA,1571.78
"5212","Wages","Paycheck","2018-06-01","3021","Bolinski, Rafal",NA,"Company Checking Account",27.69,NA,1599.47
"5213","Wages","Paycheck","2018-06-01","3021","Bolinski, Rafal",NA,"Company Checking Account",6.53,NA,1606
"5214","Wages","Paycheck","2018-06-01","3021","Bolinski, Rafal",NA,"Company Checking Account",35.79,NA,1641.79
"5215","Wages","Paycheck","2018-06-01","3021","Bolinski, Rafal",NA,"Company Checking Account",0,NA,1641.79
"5216","Wages","Paycheck","2018-06-01","3021","Bolinski, Rafal",NA,"Company Checking Account",0,NA,1641.79
"5217","Wages","Paycheck","2018-06-01","3022","Deen, Jeannette",NA,"Company Checking Account",21.07,NA,1662.86
"5218","Wages","Paycheck","2018-06-01","3022","Deen, Jeannette",NA,"Company Checking Account",4.97,NA,1667.83
"5219","Wages","Paycheck","2018-06-01","3022","Deen, Jeannette",NA,"Company Checking Account",27.23,NA,1695.06
"5220","Wages","Paycheck","2018-06-15","3023","Bolinski, Rafal",NA,"Company Checking Account",27.69,NA,1722.75
"5221","Wages","Paycheck","2018-06-15","3023","Bolinski, Rafal",NA,"Company Checking Account",6.53,NA,1729.28
"5222","Wages","Paycheck","2018-06-15","3023","Bolinski, Rafal",NA,"Company Checking Account",35.79,NA,1765.07
"5223","Wages","Paycheck","2018-06-15","3023","Bolinski, Rafal",NA,"Company Checking Account",0,NA,1765.07
"5224","Wages","Paycheck","2018-06-15","3023","Bolinski, Rafal",NA,"Company Checking Account",0,NA,1765.07
"5225","Wages","Paycheck","2018-06-15","3024","Deen, Jeannette",NA,"Company Checking Account",21.07,NA,1786.14
"5226","Wages","Paycheck","2018-06-15","3024","Deen, Jeannette",NA,"Company Checking Account",4.97,NA,1791.11
"5227","Wages","Paycheck","2018-06-15","3024","Deen, Jeannette",NA,"Company Checking Account",27.23,NA,1818.34
"5228","Wages","Paycheck","2018-06-15","3022","King, Vicki",NA,"Company Checking Account",13,NA,1831.34
"5229","Wages","Paycheck","2018-06-15","3022","King, Vicki",NA,"Company Checking Account",3.07,NA,1834.41
"5230","Wages","Paycheck","2018-06-15","3022","King, Vicki",NA,"Company Checking Account",16.8,NA,1851.21
"5231","Wages","Paycheck","2018-07-01","3025","Bolinski, Rafal",NA,"Company Checking Account",115,NA,1966.21
"5232","Wages","Paycheck","2018-07-01","3025","Bolinski, Rafal",NA,"Company Checking Account",27.69,NA,1993.9
"5233","Wages","Paycheck","2018-07-01","3025","Bolinski, Rafal",NA,"Company Checking Account",6.53,NA,2000.43
"5234","Wages","Paycheck","2018-07-01","3025","Bolinski, Rafal",NA,"Company Checking Account",0,NA,2000.43
"5235","Wages","Paycheck","2018-07-01","3025","Bolinski, Rafal",NA,"Company Checking Account",0,NA,2000.43
"5236","Wages","Paycheck","2018-07-01","3026","Deen, Jeannette",NA,"Company Checking Account",21.07,NA,2021.5
"5237","Wages","Paycheck","2018-07-01","3026","Deen, Jeannette",NA,"Company Checking Account",4.97,NA,2026.47
"5238","Wages","Paycheck","2018-07-01","3026","Deen, Jeannette",NA,"Company Checking Account",27.23,NA,2053.7
"5239","Wages","Paycheck","2018-07-02","3024","King, Vicki",NA,"Company Checking Account",13,NA,2066.7
"5240","Wages","Paycheck","2018-07-02","3024","King, Vicki",NA,"Company Checking Account",3.07,NA,2069.77
"5241","Wages","Paycheck","2018-07-02","3024","King, Vicki",NA,"Company Checking Account",16.8,NA,2086.57
"5242","Wages","Paycheck","2018-07-15","3027","Bolinski, Rafal",NA,"Company Checking Account",27.69,NA,2114.26
"5243","Wages","Paycheck","2018-07-15","3027","Bolinski, Rafal",NA,"Company Checking Account",6.53,NA,2120.79
"5244","Wages","Paycheck","2018-07-15","3027","Bolinski, Rafal",NA,"Company Checking Account",35.79,NA,2156.58
"5245","Wages","Paycheck","2018-07-15","3027","Bolinski, Rafal",NA,"Company Checking Account",0,NA,2156.58
"5246","Wages","Paycheck","2018-07-15","3027","Bolinski, Rafal",NA,"Company Checking Account",0,NA,2156.58
"5247","Wages","Paycheck","2018-07-15","3028","Deen, Jeannette",NA,"Company Checking Account",21.07,NA,2177.65
"5248","Wages","Paycheck","2018-07-15","3028","Deen, Jeannette",NA,"Company Checking Account",4.97,NA,2182.62
"5249","Wages","Paycheck","2018-07-15","3028","Deen, Jeannette",NA,"Company Checking Account",27.23,NA,2209.85
"5250","Wages","Paycheck","2018-07-17","3026","King, Vicki",NA,"Company Checking Account",13,NA,2222.85
"5251","Wages","Paycheck","2018-07-17","3026","King, Vicki",NA,"Company Checking Account",3.07,NA,2225.92
"5252","Wages","Paycheck","2018-07-17","3026","King, Vicki",NA,"Company Checking Account",16.8,NA,2242.72
"5253","Wages","Paycheck","2018-08-01","3029","Bolinski, Rafal",NA,"Company Checking Account",27.69,NA,2270.41
"5254","Wages","Paycheck","2018-08-01","3029","Bolinski, Rafal",NA,"Company Checking Account",6.53,NA,2276.94
"5255","Wages","Paycheck","2018-08-01","3029","Bolinski, Rafal",NA,"Company Checking Account",35.79,NA,2312.73
"5256","Wages","Paycheck","2018-08-01","3029","Bolinski, Rafal",NA,"Company Checking Account",0,NA,2312.73
"5257","Wages","Paycheck","2018-08-01","3029","Bolinski, Rafal",NA,"Company Checking Account",0,NA,2312.73
"5258","Wages","Paycheck","2018-08-01","3030","Deen, Jeannette",NA,"Company Checking Account",21.07,NA,2333.8
"5259","Wages","Paycheck","2018-08-01","3030","Deen, Jeannette",NA,"Company Checking Account",4.97,NA,2338.77
"5260","Wages","Paycheck","2018-08-01","3030","Deen, Jeannette",NA,"Company Checking Account",27.23,NA,2366
"5261","Wages","Paycheck","2018-08-03","3028","King, Vicki",NA,"Company Checking Account",13,NA,2379
"5262","Wages","Paycheck","2018-08-03","3028","King, Vicki",NA,"Company Checking Account",3.07,NA,2382.07
"5263","Wages","Paycheck","2018-08-03","3028","King, Vicki",NA,"Company Checking Account",16.8,NA,2398.87
"5264","Wages","Paycheck","2018-08-15","3031","Bolinski, Rafal",NA,"Company Checking Account",27.69,NA,2426.56
"5265","Wages","Paycheck","2018-08-15","3031","Bolinski, Rafal",NA,"Company Checking Account",6.53,NA,2433.09
"5266","Wages","Paycheck","2018-08-15","3031","Bolinski, Rafal",NA,"Company Checking Account",35.79,NA,2468.88
"5267","Wages","Paycheck","2018-08-15","3031","Bolinski, Rafal",NA,"Company Checking Account",0,NA,2468.88
"5268","Wages","Paycheck","2018-08-15","3031","Bolinski, Rafal",NA,"Company Checking Account",0,NA,2468.88
"5269","Wages","Paycheck","2018-08-15","3032","Deen, Jeannette",NA,"Company Checking Account",0,NA,2468.88
"5270","Wages","Paycheck","2018-08-15","3032","Deen, Jeannette",NA,"Company Checking Account",0,NA,2468.88
"5271","Wages","Paycheck","2018-08-15","3032","Deen, Jeannette",NA,"Company Checking Account",0,NA,2468.88
"5272","Wages","Paycheck","2018-08-17","3030","King, Vicki",NA,"Company Checking Account",13,NA,2481.88
"5273","Wages","Paycheck","2018-08-17","3030","King, Vicki",NA,"Company Checking Account",3.07,NA,2484.95
"5274","Wages","Paycheck","2018-08-17","3030","King, Vicki",NA,"Company Checking Account",16.8,NA,2501.75
"5275","Wages","Paycheck","2018-09-01","3033","Bolinski, Rafal",NA,"Company Checking Account",27.69,NA,2529.44
"5276","Wages","Paycheck","2018-09-01","3033","Bolinski, Rafal",NA,"Company Checking Account",6.53,NA,2535.97
"5277","Wages","Paycheck","2018-09-01","3033","Bolinski, Rafal",NA,"Company Checking Account",35.79,NA,2571.76
"5278","Wages","Paycheck","2018-09-01","3033","Bolinski, Rafal",NA,"Company Checking Account",0,NA,2571.76
"5279","Wages","Paycheck","2018-09-01","3033","Bolinski, Rafal",NA,"Company Checking Account",0,NA,2571.76
"5280","Wages","Paycheck","2018-09-01","3034","Deen, Jeannette",NA,"Company Checking Account",21.07,NA,2592.83
"5281","Wages","Paycheck","2018-09-01","3034","Deen, Jeannette",NA,"Company Checking Account",4.97,NA,2597.8
"5282","Wages","Paycheck","2018-09-01","3034","Deen, Jeannette",NA,"Company Checking Account",27.23,NA,2625.03
"5283","Wages","Paycheck","2018-09-03","3032","King, Vicki",NA,"Company Checking Account",13,NA,2638.03
"5284","Wages","Paycheck","2018-09-03","3032","King, Vicki",NA,"Company Checking Account",3.07,NA,2641.1
"5285","Wages","Paycheck","2018-09-03","3032","King, Vicki",NA,"Company Checking Account",16.8,NA,2657.9
"5286","Wages","Paycheck","2018-09-15","3035","Bolinski, Rafal",NA,"Company Checking Account",27.69,NA,2685.59
"5287","Wages","Paycheck","2018-09-15","3035","Bolinski, Rafal",NA,"Company Checking Account",6.53,NA,2692.12
"5288","Wages","Paycheck","2018-09-15","3035","Bolinski, Rafal",NA,"Company Checking Account",35.79,NA,2727.91
"5289","Wages","Paycheck","2018-09-15","3035","Bolinski, Rafal",NA,"Company Checking Account",0,NA,2727.91
"5290","Wages","Paycheck","2018-09-15","3035","Bolinski, Rafal",NA,"Company Checking Account",0,NA,2727.91
"5291","Wages","Paycheck","2018-09-15","3036","Deen, Jeannette",NA,"Company Checking Account",21.07,NA,2748.98
"5292","Wages","Paycheck","2018-09-15","3036","Deen, Jeannette",NA,"Company Checking Account",4.97,NA,2753.95
"5293","Wages","Paycheck","2018-09-15","3036","Deen, Jeannette",NA,"Company Checking Account",27.33,NA,2781.28
"5294","Wages","Paycheck","2018-09-17","3034","King, Vicki",NA,"Company Checking Account",13,NA,2794.28
"5295","Wages","Paycheck","2018-09-17","3034","King, Vicki",NA,"Company Checking Account",3.07,NA,2797.35
"5296","Wages","Paycheck","2018-09-17","3034","King, Vicki",NA,"Company Checking Account",16.8,NA,2814.15
"5297","Wages","Paycheck","2018-10-01","3037","Bolinski, Rafal",NA,"Company Checking Account",27.69,NA,2841.84
"5298","Wages","Paycheck","2018-10-01","3037","Bolinski, Rafal",NA,"Company Checking Account",6.53,NA,2848.37
"5299","Wages","Paycheck","2018-10-01","3037","Bolinski, Rafal",NA,"Company Checking Account",35.79,NA,2884.16
"5300","Wages","Paycheck","2018-10-01","3037","Bolinski, Rafal",NA,"Company Checking Account",0,NA,2884.16
"5301","Wages","Paycheck","2018-10-01","3037","Bolinski, Rafal",NA,"Company Checking Account",0,NA,2884.16
"5302","Wages","Paycheck","2018-10-01","3038","Deen, Jeannette",NA,"Company Checking Account",21.07,NA,2905.23
"5303","Wages","Paycheck","2018-10-01","3038","Deen, Jeannette",NA,"Company Checking Account",4.97,NA,2910.2
"5304","Wages","Paycheck","2018-10-01","3038","Deen, Jeannette",NA,"Company Checking Account",27.23,NA,2937.43
"5305","Wages","Paycheck","2018-10-03","3036","King, Vicki",NA,"Company Checking Account",13,NA,2950.43
"5306","Wages","Paycheck","2018-10-03","3036","King, Vicki",NA,"Company Checking Account",3.07,NA,2953.5
"5307","Wages","Paycheck","2018-10-03","3036","King, Vicki",NA,"Company Checking Account",16.8,NA,2970.3
"5308","Wages","Paycheck","2018-10-15","3039","Bolinski, Rafal",NA,"Company Checking Account",27.69,NA,2997.99
"5309","Wages","Paycheck","2018-10-15","3039","Bolinski, Rafal",NA,"Company Checking Account",6.53,NA,3004.52
"5310","Wages","Paycheck","2018-10-15","3039","Bolinski, Rafal",NA,"Company Checking Account",35.79,NA,3040.31
"5311","Wages","Paycheck","2018-10-15","3039","Bolinski, Rafal",NA,"Company Checking Account",0,NA,3040.31
"5312","Wages","Paycheck","2018-10-15","3039","Bolinski, Rafal",NA,"Company Checking Account",0,NA,3040.31
"5313","Wages","Paycheck","2018-10-15","3040","Deen, Jeannette",NA,"Company Checking Account",21.07,NA,3061.38
"5314","Wages","Paycheck","2018-10-15","3040","Deen, Jeannette",NA,"Company Checking Account",4.97,NA,3066.35
"5315","Wages","Paycheck","2018-10-15","3040","Deen, Jeannette",NA,"Company Checking Account",27.23,NA,3093.58
"5316","Wages","Paycheck","2018-10-17","3038","King, Vicki",NA,"Company Checking Account",13,NA,3106.58
"5317","Wages","Paycheck","2018-10-17","3038","King, Vicki",NA,"Company Checking Account",3.07,NA,3109.65
"5318","Wages","Paycheck","2018-10-17","3038","King, Vicki",NA,"Company Checking Account",16.8,NA,3126.45
"5319","Wages","Paycheck","2018-11-01","3041","Bolinski, Rafal",NA,"Company Checking Account",27.69,NA,3154.14
"5320","Wages","Paycheck","2018-11-01","3041","Bolinski, Rafal",NA,"Company Checking Account",6.53,NA,3160.67
"5321","Wages","Paycheck","2018-11-01","3041","Bolinski, Rafal",NA,"Company Checking Account",35.79,NA,3196.46
"5322","Wages","Paycheck","2018-11-01","3041","Bolinski, Rafal",NA,"Company Checking Account",0,NA,3196.46
"5323","Wages","Paycheck","2018-11-01","3041","Bolinski, Rafal",NA,"Company Checking Account",0,NA,3196.46
"5324","Wages","Paycheck","2018-11-01","3042","Deen, Jeannette",NA,"Company Checking Account",21.07,NA,3217.53
"5325","Wages","Paycheck","2018-11-01","3042","Deen, Jeannette",NA,"Company Checking Account",4.97,NA,3222.5
"5326","Wages","Paycheck","2018-11-01","3042","Deen, Jeannette",NA,"Company Checking Account",27.23,NA,3249.73
"5327","Wages","Paycheck","2018-11-02","3040","King, Vicki",NA,"Company Checking Account",13,NA,3262.73
"5328","Wages","Paycheck","2018-11-02","3040","King, Vicki",NA,"Company Checking Account",3.07,NA,3265.8
"5329","Wages","Paycheck","2018-11-02","3040","King, Vicki",NA,"Company Checking Account",16.8,NA,3282.6
"5330","Wages","Paycheck","2018-11-15","3043","Bolinski, Rafal",NA,"Company Checking Account",27.69,NA,3310.29
"5331","Wages","Paycheck","2018-11-15","3043","Bolinski, Rafal",NA,"Company Checking Account",6.53,NA,3316.82
"5332","Wages","Paycheck","2018-11-15","3043","Bolinski, Rafal",NA,"Company Checking Account",35.79,NA,3352.61
"5333","Wages","Paycheck","2018-11-15","3043","Bolinski, Rafal",NA,"Company Checking Account",0,NA,3352.61
"5334","Wages","Paycheck","2018-11-15","3043","Bolinski, Rafal",NA,"Company Checking Account",0,NA,3352.61
"5335","Wages","Paycheck","2018-11-15","3044","Deen, Jeannette",NA,"Company Checking Account",21.07,NA,3373.68
"5336","Wages","Paycheck","2018-11-15","3044","Deen, Jeannette",NA,"Company Checking Account",4.97,NA,3378.65
"5337","Wages","Paycheck","2018-11-15","3044","Deen, Jeannette",NA,"Company Checking Account",27.23,NA,3405.88
"5338","Wages","Paycheck","2018-11-16","3042","King, Vicki",NA,"Company Checking Account",13,NA,3418.88
"5339","Wages","Paycheck","2018-11-16","3042","King, Vicki",NA,"Company Checking Account",3.07,NA,3421.95
"5340","Wages","Paycheck","2018-11-16","3042","King, Vicki",NA,"Company Checking Account",16.8,NA,3438.75
"5341","Wages","Paycheck","2018-12-01","3045","Bolinski, Rafal",NA,"Company Checking Account",27.69,NA,3466.44
"5342","Wages","Paycheck","2018-12-01","3045","Bolinski, Rafal",NA,"Company Checking Account",6.53,NA,3472.97
"5343","Wages","Paycheck","2018-12-01","3045","Bolinski, Rafal",NA,"Company Checking Account",35.79,NA,3508.76
"5344","Wages","Paycheck","2018-12-01","3045","Bolinski, Rafal",NA,"Company Checking Account",0,NA,3508.76
"5345","Wages","Paycheck","2018-12-01","3045","Bolinski, Rafal",NA,"Company Checking Account",0,NA,3508.76
"5346","Wages","Paycheck","2018-12-01","3046","Deen, Jeannette",NA,"Company Checking Account",21.07,NA,3529.83
"5347","Wages","Paycheck","2018-12-01","3046","Deen, Jeannette",NA,"Company Checking Account",4.97,NA,3534.8
"5348","Wages","Paycheck","2018-12-01","3046","Deen, Jeannette",NA,"Company Checking Account",27.23,NA,3562.03
"5349","Wages","Paycheck","2018-12-03","3044","King, Vicki",NA,"Company Checking Account",13,NA,3575.03
"5350","Wages","Paycheck","2018-12-03","3044","King, Vicki",NA,"Company Checking Account",3.07,NA,3578.1
"5351","Wages","Paycheck","2018-12-03","3044","King, Vicki",NA,"Company Checking Account",16.8,NA,3594.9
"5352","Wages","Paycheck","2018-12-15","3047","Bolinski, Rafal",NA,"Company Checking Account",27.69,NA,3622.59
"5353","Wages","Paycheck","2018-12-15","3047","Bolinski, Rafal",NA,"Company Checking Account",6.53,NA,3629.12
"5354","Wages","Paycheck","2018-12-15","3047","Bolinski, Rafal",NA,"Company Checking Account",35.79,NA,3664.91
"5355","Wages","Paycheck","2018-12-15","3047","Bolinski, Rafal",NA,"Company Checking Account",0,NA,3664.91
"5356","Wages","Paycheck","2018-12-15","3047","Bolinski, Rafal",NA,"Company Checking Account",0,NA,3664.91
"5357","Wages","Paycheck","2018-12-15","3048","Deen, Jeannette",NA,"Company Checking Account",21.07,NA,3685.98
"5358","Wages","Paycheck","2018-12-15","3048","Deen, Jeannette",NA,"Company Checking Account",4.97,NA,3690.95
"5359","Wages","Paycheck","2018-12-15","3048","Deen, Jeannette",NA,"Company Checking Account",27.23,NA,3718.18
"5360","Wages","Paycheck","2018-12-15","5361","Graham, Jonathan",NA,"Company Checking Account",2.5,NA,3720.68
"5361","Wages","Paycheck","2018-12-15","5361","Graham, Jonathan",NA,"Company Checking Account",155,NA,3875.68
"5362","Wages","Paycheck","2018-12-15","5361","Graham, Jonathan",NA,"Company Checking Account",36.25,NA,3911.93
"5363","Wages","Paycheck","2018-12-15","5361","Graham, Jonathan",NA,"Company Checking Account",20,NA,3931.93
"5364","Wages","Paycheck","2018-12-15","5361","Graham, Jonathan",NA,"Company Checking Account",87.5,NA,4019.43
"5365","Wages","Paycheck","2018-12-15","5362","King, Vicki",NA,"Company Checking Account",0.48,NA,4019.91
"5366","Wages","Paycheck","2018-12-15","5362","King, Vicki",NA,"Company Checking Account",40.14,NA,4060.05
"5367","Wages","Paycheck","2018-12-15","5362","King, Vicki",NA,"Company Checking Account",8.85,NA,4068.9
"5368","Wages","Paycheck","2018-12-15","5362","King, Vicki",NA,"Company Checking Account",0,NA,4068.9
"5369","Wages","Paycheck","2018-12-15","5362","King, Vicki",NA,"Company Checking Account",16.8,NA,4085.7
"5370","Wages","Paycheck","2018-12-15","5364","Bolinski, Rafal",NA,"Company Checking Account",0,NA,4085.7
"5371","Wages","Paycheck","2018-12-15","5364","Bolinski, Rafal",NA,"Company Checking Account",0,NA,4085.7
"5372","Wages","Paycheck","2018-12-15","5364","Bolinski, Rafal",NA,"Company Checking Account",0,NA,4085.7
"5373","Wages","Paycheck","2018-12-15","5364","Bolinski, Rafal",NA,"Company Checking Account",0,NA,4085.7
"5374","Wages","Paycheck","2018-12-15","5364","Bolinski, Rafal",NA,"Company Checking Account",490,NA,4575.7
"5375","Wages","Paycheck","2018-12-15","5365","Deen, Jeannette",NA,"Company Checking Account",0,NA,4575.7
"5376","Wages","Paycheck","2018-12-15","5365","Deen, Jeannette",NA,"Company Checking Account",0,NA,4575.7
"5377","Wages","Paycheck","2018-12-15","5365","Deen, Jeannette",NA,"Company Checking Account",0,NA,4575.7
"5378","Wages","Paycheck","2018-12-17","3046","King, Vicki",NA,"Company Checking Account",13,NA,4588.7
"5379","Wages","Paycheck","2018-12-17","3046","King, Vicki",NA,"Company Checking Account",3.07,NA,4591.77
"5380","Wages","Paycheck","2018-12-17","3046","King, Vicki",NA,"Company Checking Account",16.8,NA,4608.57
"5386","Wages","Paycheck","2018-01-15","3001","King, Vicki",NA,"Company Checking Account",360,NA,360
"5387","Wages","Paycheck","2018-02-01","3004","King, Vicki",NA,"Company Checking Account",360,NA,720
"5388","Wages","Paycheck","2018-02-15","3006","King, Vicki",NA,"Company Checking Account",360,NA,1080
"5389","Wages","Paycheck","2018-03-01","3008","King, Vicki",NA,"Company Checking Account",360,NA,1440
"5390","Wages","Paycheck","2018-03-15","3010","King, Vicki",NA,"Company Checking Account",360,NA,1800
"5391","Wages","Paycheck","2018-04-02","3012","King, Vicki",NA,"Company Checking Account",360,NA,2160
"5392","Wages","Paycheck","2018-04-16","3014","King, Vicki",NA,"Company Checking Account",216,NA,2376
"5393","Wages","Paycheck","2018-05-01","3016","King, Vicki",NA,"Company Checking Account",216,NA,2592
"5394","Wages","Paycheck","2018-05-15","3018","King, Vicki",NA,"Company Checking Account",216,NA,2808
"5395","Wages","Paycheck","2018-06-01","3020","King, Vicki",NA,"Company Checking Account",216,NA,3024
"5396","Wages","Paycheck","2018-06-15","3022","King, Vicki",NA,"Company Checking Account",216,NA,3240
"5397","Wages","Paycheck","2018-07-02","3024","King, Vicki",NA,"Company Checking Account",216,NA,3456
"5398","Wages","Paycheck","2018-07-17","3026","King, Vicki",NA,"Company Checking Account",216,NA,3672
"5399","Wages","Paycheck","2018-08-03","3028","King, Vicki",NA,"Company Checking Account",216,NA,3888
"5400","Wages","Paycheck","2018-08-17","3030","King, Vicki",NA,"Company Checking Account",216,NA,4104
"5401","Wages","Paycheck","2018-09-03","3032","King, Vicki",NA,"Company Checking Account",216,NA,4320
"5402","Wages","Paycheck","2018-09-17","3034","King, Vicki",NA,"Company Checking Account",216,NA,4536
"5403","Wages","Paycheck","2018-10-03","3036","King, Vicki",NA,"Company Checking Account",216,NA,4752
"5404","Wages","Paycheck","2018-10-17","3038","King, Vicki",NA,"Company Checking Account",216,NA,4968
"5405","Wages","Paycheck","2018-11-02","3040","King, Vicki",NA,"Company Checking Account",216,NA,5184
"5406","Wages","Paycheck","2018-11-16","3042","King, Vicki",NA,"Company Checking Account",216,NA,5400
"5407","Wages","Paycheck","2018-12-03","3044","King, Vicki",NA,"Company Checking Account",216,NA,5616
"5408","Wages","Paycheck","2018-12-15","5362","King, Vicki",NA,"Company Checking Account",480,NA,6096
"5409","Wages","Paycheck","2018-12-17","3046","King, Vicki",NA,"Company Checking Account",216,NA,6312
"5424","Other Expense","General Journal","2018-01-31","Interest",NA,NA,"Line of Credit",100.13,NA,100.13
"5425","Other Expense","Check","2018-02-05","5031","Local Bank","Interest on Credit Line Feb 07","Company Checking Account",100.13,NA,200.26
"5426","Other Expense","General Journal","2018-02-28","Interest",NA,NA,"Line of Credit",80.47,NA,280.73
"5427","Other Expense","Check","2018-03-05","5060","Local Bank","Interest on Credit Line Mar 07","Company Checking Account",80.47,NA,361.2
"5428","Other Expense","General Journal","2018-03-30","Interest",NA,NA,"Line of Credit",81.56,NA,442.76
"5429","Other Expense","Check","2018-04-04","5081","Local Bank","Interest on Credit Line Apr 07","Company Checking Account",81.56,NA,524.32
"5430","Other Expense","General Journal","2018-04-30","Interest",NA,NA,"Line of Credit",82.98,NA,607.3
"5431","Other Expense","Check","2018-05-04","5109","Local Bank","Interest on Credit Line May 07","Company Checking Account",82.98,NA,690.28
"5432","Other Expense","General Journal","2018-05-31","Interest",NA,NA,"Line of Credit",125.89,NA,816.17
"5433","Other Expense","Check","2018-06-04","5136","Local Bank","Interest on Credit Line June 07","Company Checking Account",125.89,NA,942.06
"5434","Other Expense","General Journal","2018-06-29","Interest",NA,NA,"Line of Credit",156.65,NA,1098.71
"5435","Other Expense","Check","2018-07-03","5161","Local Bank","Interest on Credit Line July 07","Company Checking Account",156.65,NA,1255.36
"5436","Other Expense","General Journal","2018-07-31","Interest",NA,NA,"Line of Credit",113.25,NA,1368.61
"5437","Other Expense","Check","2018-08-03","5191","Local Bank","Interest on Credit Line Aug 07","Company Checking Account",113.25,NA,1481.86
"5438","Other Expense","General Journal","2018-08-31","Interest",NA,NA,"Line of Credit",95.65,NA,1577.51
"5439","Other Expense","Check","2018-09-04","5221","Local Bank","Interest on Credit Line Sept 03","Company Checking Account",95.65,NA,1673.16
"5440","Other Expense","General Journal","2018-09-28","Interest",NA,NA,"Line of Credit",97.25,NA,1770.41
"5441","Other Expense","Check","2018-10-04","5245","Local Bank","Interest on Credit Line Oct 07","Company Checking Account",97.25,NA,1867.66
"5442","Other Expense","General Journal","2018-10-31","Interest",NA,NA,"Line of Credit",99.56,NA,1967.22
"5443","Other Expense","Check","2018-11-05","5271","Local Bank","Interest on Credit Line Nov 07","Company Checking Account",99.56,NA,2066.78
"5444","Other Expense","General Journal","2018-11-30","Interest",NA,NA,"Line of Credit",54.21,NA,2120.99
"5445","Other Expense","Check","2018-12-04","5296","Local Bank","Interest on Credit Line Dec 07","Company Checking Account",54.21,NA,2175.2
"5446","Other Expense","General Journal","2018-12-29","Interest",NA,NA,"Line of Credit",60.27,NA,2235.47
"5447","Other Expense","General Journal","2018-12-31","Interest",NA,NA,"Line of Credit",60.98,NA,2296.45
